date,open,high,low,close,Adj Close,volume,SMA,WMA,MOM,RSI,WilliamK,MACD,CCI,acc_dist,AD21,Arronup,AroonDown,AroonOscillator,ATR,Pivot_Point,Resistance_1,Resistance_2,Resistance_3,Support_1,Support_2,Support_3,SO%k,On_Balance_Volume,y
2013-06-04,687.299988,693.799988,681.0,689.150024,652.737488,1404081.0,,,,,,12.195464005093982,,-808699.4059953677,-226249.8788781386,,,,0.0,687.9833373333335,694.9666746666669,700.7833253333333,707.7666626666669,682.1666866666669,675.1833493333335,669.3666986666669,0.6367212219261487,568450.0,-1
2013-06-05,682.0,694.400024,678.5,683.049988,657.420105,1890919.0,,,,,,12.195464005093982,,1326521.3739900864,315596.75874855276,,,,19.5,685.3166706666667,692.1333413333334,701.2166946666666,708.0333653333334,676.2333173333334,669.4166466666667,660.3332933333334,0.2861623353524483,-1322469.0,-1
2013-06-06,683.5,689.400024,678.0,687.950012,651.925232,1779103.0,,,,,,12.195464005093982,,-260195.4824913981,161453.8100440148,,,,15.90002400000003,685.1166786666666,692.2333573333333,696.5167026666668,703.6333813333333,680.8333333333333,673.7166546666666,669.4333093333332,0.8728062326886319,456634.0,+1
2013-06-07,681.75,693.400024,673.200012,682.200012,646.1437990000001,2389056.0,,,,,,12.195464005093982,,-636796.2699261873,-13384.386075124978,,,,11.40002400000003,682.9333493333334,692.6666866666667,703.1333613333334,712.8666986666667,672.4666746666667,662.7333373333333,652.2666626666667,0.4455442897756691,-1932422.0,-1
2013-06-10,681.049988,687.0,671.5,676.150024,646.334839,1592003.0,,,,,,12.195464005093982,,1517101.4736214965,272254.1626916274,,,,20.200012000000015,678.2166746666667,684.9333493333334,693.7166746666667,700.4333493333334,669.4333493333334,662.7166746666667,653.9333493333334,0.30000154838709875,-3524425.0,-1
2013-06-11,673.450012,680.900024,662.200012,676.349976,635.393066,2955215.0,,,,,,12.195464005093982,,-336487.50268855685,172698.23701818864,,,,15.5,673.150004,684.0999959999999,691.8500160000001,702.8000079999999,665.3999839999999,654.449992,646.6999719999999,0.7566820812735277,-569210.0,+1
2013-06-12,662.0,673.400024,658.450012,664.900024,634.4851679999999,2453913.0,,,,,,12.195464005093982,,3165979.15206959,610527.806901738,,,,18.700012000000015,665.5833533333333,672.7166946666666,680.5333653333334,687.6667066666666,657.7666826666666,650.6333413333333,642.8166706666666,0.4314385834606694,-3023123.0,-1
2013-06-13,657.599976,661.0,653.349976,663.950012,631.257019,1787434.0,,,,,,12.195464005093982,,-7175942.624035086,-424098.271566519,,,,17.899963999999954,659.4333293333333,665.5166826666666,667.0833533333334,673.1667066666666,657.8666586666666,651.7833053333333,650.2166346666666,1.3856212738678995,-4810557.0,-1
2013-06-14,662.0,668.450012,659.299988,655.099976,640.8449099999999,3741303.0,677.9300048000001,671.4154573818182,,,,12.195464005093982,,978933.0291718865,-252658.05572520616,,,,11.55004800000006,660.949992,662.5999959999999,670.1000160000001,671.75002,653.4499719999999,651.7999679999999,644.2999479999999,-0.45901650094032553,-8551860.0,-1
2013-06-17,665.599976,669.200012,657.349976,665.049988,643.0612179999999,3267727.0,674.3850036,669.0736361454545,-35.450012000000015,,,12.195464005093982,,2800466.310860293,93823.18663935969,,,,9.15002400000003,663.8666586666667,670.3833413333334,675.7166946666666,682.2333773333335,658.5333053333334,652.0166226666666,646.6832693333333,0.6497880681543909,-5284133.0,+1
2013-06-18,668.0,668.0,655.0,667.349976,633.5215450000001,3111642.0,672.2049988000001,667.7945402181817,-21.80004800000006,,,12.195464005093982,,-798053.731257584,-943.7546551901772,,,,14.100036000000046,663.449992,671.8999839999999,676.4499919999998,684.8999839999999,658.8999839999999,650.449992,645.8999839999999,0.9499981538461515,-2172491.0,+1
2013-06-19,656.099976,666.599976,652.849976,657.450012,640.9895019999999,2411739.0,669.6450012000001,665.1118153454545,-25.59997599999997,,,12.195464005093982,,5766513.564321334,576756.2546229864,,,,13.0,658.9666546666666,665.0833333333333,672.7166546666667,678.8333333333333,651.3333333333333,645.2166546666666,637.5833333333333,0.33454807272727605,-4584230.0,-1
2013-06-20,658.849976,658.849976,634.599976,665.200012,613.43042,3784511.0,667.3700012000002,664.3036354909091,-22.75,40.0897220582106,,9.748054542304885,,197684.536405903,540755.9704301645,,,,14.5,652.8833213333334,671.1666666666667,677.1333213333332,695.4166666666667,646.9166666666667,628.6333213333334,622.6666666666667,1.261857154639177,-799719.0,+1
2013-06-21,636.799988,642.549988,630.099976,636.599976,612.129517,4474961.0,662.8099976000001,658.7090854545454,-45.600036000000046,22.659977398672567,-10.756979651116358,6.565140112316726,,3438328.200810793,802954.4381386614,,,,24.25,636.4166466666667,642.7333173333334,648.8666586666668,655.1833293333334,630.2833053333334,623.9666346666667,617.8332933333334,0.522087850196449,-5274680.0,-1
2013-06-24,631.799988,633.849976,623.75,635.25,602.5898440000001,2692013.0,658.7199952,653.6981768,-40.90002400000003,22.135820886139683,-9.93450144704731,2.3121093514004087,,-3523189.719765357,428355.7530393736,,,,35.100036000000046,630.949992,638.1499839999999,641.0499679999998,648.2499599999999,628.0500079999999,620.850016,617.950032,1.1386165670096675,-7966693.0,-1
2013-06-25,626.0,646.400024,622.400024,625.349976,610.9250490000001,4671608.0,653.6199952000001,647.6309005818181,-51.0,18.512375141939998,-11.59725314354372,-1.9982329325694081,,1535784.8178495325,520458.8320710463,,,,12.84997599999997,631.3833413333333,640.3666586666666,655.3833413333332,664.3666586666666,616.3666586666666,607.3833413333333,592.3666586666666,0.12291466666666413,-12638301.0,-1
2013-06-26,631.5,637.650024,620.0,634.0,600.180847,2619005.0,650.5299928,644.0636287272727,-30.90002400000003,30.055164163577004,-9.993274159087186,-5.435372916471351,,-6528455.6674674135,-44481.87409936115,,,,24.0,630.550008,641.1000160000001,648.2000320000002,658.7500400000001,623.4499920000001,612.899984,605.799968,0.7932000545721624,-10019296.0,+1
2013-06-27,634.0,652.700012,622.349976,622.849976,622.9700320000001,6750890.0,646.4199892,639.0308983999998,-41.100036000000046,24.825005657490138,-11.869119305419149,-9.765027328058864,,-6407897.803636461,-537383.4074347401,,,,17.65002400000003,632.6333213333334,642.9166666666667,662.9833573333335,673.2667026666668,612.5666306666667,602.2832853333333,582.2165946666667,0.01647444503854952,-16770186.0,-1
2013-06-28,649.5,673.200012,649.099976,646.5,645.132996,5270670.0,645.5599916,639.0454458181817,-8.59997599999997,47.2786180878064,-6.887755102040815,-11.72737567519357,,92067.16871743073,-490139.0361290709,,,,30.350036000000046,656.2666626666667,663.4333493333334,680.3666986666667,687.5333853333334,639.3333133333333,632.1666266666666,615.2332773333333,-0.10788266042424023,-11499516.0,+1
2013-07-01,669.0,674.0,664.650024,669.5,644.4102780000001,2459671.0,646.0049928,643.3981746181818,4.450012000000015,60.51317007191712,-1.9591035452509329,-12.633142253910137,,2295788.0,-287048.9102105071,,,,50.350036000000046,669.3833413333333,674.1166586666666,678.7333173333332,683.4666346666666,664.7666826666666,660.0333653333333,655.4167066666666,0.5187153421570264,-9039845.0,+1
2013-07-02,668.700012,668.75,654.299988,668.75,632.6542360000001,2295788.0,646.1449952,647.5336304727273,1.4000240000000304,59.94696856703664,-0.9130434782608696,-12.392931008618007,,4462068.577184772,49907.56725153991,,,,27.5,663.9333293333333,673.5666706666666,678.3833413333334,688.0166826666666,659.1166586666666,649.4833173333333,644.6666466666666,1.0,-11335633.0,-1
2013-07-03,654.0,654.700012,643.599976,656.549988,626.969055,3346565.0,646.0549928,649.4254473454545,-0.9000240000000304,50.99189482966956,-3.0347846956521765,-14.14307202054647,,-377515.54924595123,20335.303235743224,,,,15.200012000000015,651.6166586666667,659.6333413333334,662.7166946666666,670.7333773333335,648.5333053333334,640.5166226666666,637.4332693333333,1.166663963972726,-14682198.0,-1
2013-07-04,653.799988,657.450012,645.700012,650.650024,631.305359,2397765.0,644.5999940000002,650.2609075636364,-14.549987999999985,47.06843918155908,-4.060865391304342,-16.67339753299916,,-3507645.3177577443,-218097.57851115527,,,,25.15002400000003,651.2666826666667,656.8333533333334,663.0166826666666,668.5833533333334,645.0833533333334,639.5166826666667,633.3333533333334,0.42127761702127786,-17079963.0,-1
2013-07-05,660.099976,672.75,658.5,655.150024,643.446716,2385874.0,646.4549988,652.1790948363637,18.55004800000006,50.42533920650147,-3.2782566956521686,-17.8091614426678,,1865477.095672571,-80331.15515157767,,,,11.75,662.1333413333333,665.7666826666666,676.3833413333332,680.0166826666666,651.5166826666666,647.8833413333333,637.2666826666666,-0.23508603508771717,-14694089.0,+1
2013-07-08,664.0,667.450012,652.75,667.75,636.412415,1792324.0,649.7049987999999,656.0509132363636,32.5,58.85557649984793,-1.0869565217391304,-19.55710641799817,,-2293396.4329161216,-223696.77834782025,0.0,68.0,,22.09997599999997,662.650004,672.5500079999999,677.3500159999999,687.25002,657.8499959999999,647.949992,643.1499839999999,1.0204073302797294,-12901765.0,+1
2013-07-09,662.200012,673.75,662.200012,660.450012,645.90387,1760048.0,653.2150024,658.004552,35.100036000000046,52.847880389658684,-2.3565196521739105,-17.724193812303838,,1422042.3019403073,-119104.8214464011,4.0,64.0,-68.0,14.700012000000015,665.4666746666667,668.7333373333333,677.0166626666667,680.2833253333333,657.1833493333334,653.9166866666667,645.6333613333334,-0.1515153089336545,-14661813.0,-1
2013-07-10,670.25,671.900024,656.150024,670.299988,635.304199,1784645.0,656.8450012000001,661.1109130181818,36.299987999999985,59.31377559227327,-0.6434803478260896,-13.575851049930634,,-4382264.90184263,-385225.7871985,0.0,60.0,-60.0,11.549987999999985,666.1166786666666,676.0833333333333,681.8666786666668,691.8333333333333,660.3333333333333,650.3666786666666,644.5833333333333,0.8984104126984098,-12877168.0,+1
2013-07-11,667.0,686.700012,666.049988,659.299988,658.382568,2649892.0,660.4900024000001,661.5572742545454,36.450012000000015,50.40694420228326,-4.6622466293228575,-8.363201205710538,,-3195798.257914573,-557743.8544050928,4.0,56.00000000000001,-60.0,15.75,670.6833293333333,675.3166706666666,691.3333533333332,695.9666946666666,654.6666466666666,650.0333053333333,634.0166226666665,-0.3268761334127258,-15527060.0,-1
2013-07-12,687.0,697.700012,681.799988,683.25,670.4276120000001,3908713.0,664.1650024000002,665.6954556363636,36.75,63.991232157922575,-2.413564675191624,-3.041971014469823,,1431272.4634116453,-437568.4700306902,0.0,52.0,-52.00000000000001,20.65002400000003,687.5833333333334,693.3666786666668,703.4833573333333,709.2667026666668,677.4666546666667,671.6833093333333,661.5666306666667,0.09119558561672689,-11618347.0,+1
2013-07-15,691.0,698.049988,684.0,695.75,670.1384889999999,2127972.0,666.7900024,671.4381824727272,26.25,69.09001976512715,-0.38393924481640834,4.276846572362047,,7294632.933178512,22719.13691718579,96.0,48.0,-52.0,38.40002400000003,692.5999959999999,701.1999919999998,706.6499839999999,715.2499799999998,687.1500039999999,678.5500079999999,673.1000159999999,0.8362996466616208,-9490375.0,+1
2013-07-16,679.0,684.5,669.950012,695.450012,653.9981690000001,2911846.0,669.4600036,676.6490933090909,26.700012000000015,68.82017363073314,-0.4340165348605215,8.478858837006555,,4936143.145991415,311149.2961936113,96.0,44.0,48.0,14.799987999999985,683.300008,696.6500040000001,697.8499960000001,711.1999920000001,682.1000160000001,668.7500200000001,667.5500280000001,1.7525787650134164,-12402221.0,-1
2013-07-17,677.799988,680.799988,647.900024,678.700012,638.773254,5658497.0,671.675006,678.3290948363637,22.15002400000003,54.98450786646299,-3.230110406078494,9.349211936587153,,-2127534.486703446,169864.25239057635,92.0,40.0,52.0,25.799987999999985,669.1333413333333,690.3666586666666,702.0333053333334,723.2666226666665,657.4666946666666,636.2333773333334,624.5667306666667,0.9361708724058186,-18060718.0,-1
2013-07-18,669.900024,688.5,656.950012,662.900024,659.20166,3415970.0,672.9000060000001,676.7336435636364,12.25,45.11314242261479,-5.867617845607896,9.241953782511928,50.17211606887651,513564.89552970335,189531.0847028601,88.0,36.0,52.0,47.549987999999985,669.450012,681.950012,701.0,713.5,650.400024,637.900024,618.850036,0.18858999249064748,-21476688.0,-1
2013-07-19,688.049988,691.950012,673.150024,684.099976,655.2507929999999,3114605.0,675.7950012000001,678.7700017454547,28.94995199999994,57.05077583390599,-2.3286891377084906,11.341953385482384,102.62859813751558,-440483.99999999994,153900.34654917158,84.0,32.0,52.0,31.549987999999985,683.0666706666667,692.9833173333334,701.8666586666668,711.7833053333334,674.1833293333334,664.2666826666667,655.3833413333334,0.5824446270923124,-18362083.0,+1
2013-07-22,676.0,687.0,676.0,680.0,657.226257,1615108.0,677.0200012,679.5345469818182,12.25,54.410049850821274,-3.0131021386482333,13.832527199666856,76.04907367254877,-1439462.8123796936,64776.447700853314,80.0,28.000000000000004,52.0,29.049987999999985,681.0,686.0,692.0,697.0,675.0,670.0,664.0,0.36363636363636365,-19977191.0,-1
2013-07-23,687.900024,690.0,681.049988,682.049988,658.719788,1853696.0,679.1799987999999,680.4490900363636,21.59997599999997,55.595828074560444,-2.670895638178362,16.63176238227311,74.9049139020745,6127812.193556612,400391.82517026225,76.0,24.0,52.0,11.0,684.3666586666667,687.6833293333334,693.3166706666668,696.6333413333334,678.7333173333334,675.4166466666667,669.7833053333334,0.11173169376756124,-18123495.0,+1
2013-07-24,674.0,676.0,653.5,683.599976,635.930603,3657187.0,680.5099976,681.2527222545455,13.299987999999985,56.581060038497526,-2.4121546264015645,18.08224234449483,9.42753507745931,962181.4253851254,431184.47985107894,72.0,20.0,52.0,10.0,671.0333253333333,688.5666506666666,693.5333253333333,711.0666506666666,666.0666506666666,648.5333253333333,643.5666506666666,1.3377767111111099,-14466308.0,+1
2013-07-25,660.650024,666.0,650.150024,659.950012,630.052551,4066814.0,680.5750000000002,677.5145430545455,0.6500240000000304,40.687379162769936,-6.360066232068762,19.48069216427632,-45.706432410151855,1723895.4560052524,501383.3299268444,68.0,16.0,52.0,28.549987999999985,658.700012,667.25,674.549988,683.099976,651.400024,642.850036,635.5500480000001,0.618296709092809,-18533122.0,-1
2013-07-26,656.0,656.25,638.0,653.849976,620.6574099999999,2339123.0,677.6349976,672.6554477818182,-29.40002400000003,37.54835842585643,-7.378351203639457,19.937069005338117,-80.76933094211599,4345316.96536142,708291.7929571099,64.0,12.0,52.0,33.44995199999994,649.3666586666667,660.7333173333334,667.6166586666668,678.9833173333334,642.4833173333334,631.1166586666667,624.2333173333334,0.8684918356164367,-20872245.0,-1
2013-07-29,643.0,643.0,629.650024,644.099976,609.479614,3730556.0,672.4699952,666.5581711272728,-51.65002400000003,32.871312465097915,-9.005928233154394,19.927162090176694,-110.8866696319316,2440299.4952561175,800746.9416957807,60.0,8.0,52.0,21.950012000000015,638.9166666666666,648.1833093333332,652.2666426666665,661.5332853333332,634.8333333333333,625.5666906666667,621.4833573333333,1.0823953541189866,-24602801.0,-1
2013-07-30,630.75,635.0,620.099976,632.5,602.5898440000001,3672771.0,666.174994,659.2908992727273,-62.950012000000015,28.07128843850755,-10.942323564490247,16.155371014183515,-131.94184476419454,9901665.375312312,1282736.852790869,56.00000000000001,4.0,52.0,24.19995199999994,629.199992,638.3000079999999,644.1000159999999,653.200032,623.3999839999999,614.2999679999999,608.4999599999999,0.8322150353583326,-28275572.0,-1
2013-07-31,621.0,621.799988,606.900024,625.349976,587.5576169999999,6706130.0,660.8399904,651.8681687272727,-53.350036000000046,25.43024675091621,-12.135884059144663,9.472659221400363,-151.50492707294643,-7084765.424857468,842890.586972815,52.0,0.0,52.00000000000001,24.0,618.0166626666667,629.1333013333333,632.9166266666666,644.0332653333332,614.2333373333333,603.1166986666667,599.3333733333334,1.2382548038371097,-34981702.0,-1
2013-08-01,613.900024,637.799988,612.400024,609.75,609.1905519999999,5861652.0,655.524988,642.5790795636364,-53.15002400000003,20.560458819295548,-14.740003300025103,2.4162909295437203,-126.78595174875797,1730965.4045453458,889243.505354165,48.0,96.0,52.0,25.59997599999997,619.9833373333333,627.5666506666666,645.3833013333333,652.9666146666666,602.1666866666667,594.5833733333334,576.7667226666667,-0.104331801415153,-40843354.0,-1
2013-08-02,630.0,634.799988,626.849976,632.200012,608.275085,5003962.0,650.3349916,638.3381748363636,-51.899963999999954,39.72629986841253,-10.992400854534358,-3.004396672890607,-86.08014228542771,2003179.9910378498,946995.9678801411,44.0,92.0,-48.0,25.399963999999954,631.2833253333333,635.7166746666667,639.2333373333333,643.6666866666667,627.7666626666667,623.3333133333333,619.8166506666666,0.672959487356753,-35839392.0,+1
2013-08-05,631.549988,635.450012,615.0,631.25,609.672302,3399593.0,645.4599916,634.8681763636363,-48.75,39.26376601139827,-10.236952655631283,-5.110899778010662,-94.11030942852001,5444931.334829477,1178712.2837160684,40.0,88.0,-48.0,25.049987999999985,627.2333373333333,639.4666746666667,647.6833493333334,659.9166866666667,619.0166626666667,606.7833253333333,598.5666506666666,0.7946205606138513,-39238985.0,-1
2013-08-06,631.0,631.349976,606.5,632.700012,586.497742,4911295.0,640.524994,632.5481800727273,-49.34997599999997,40.484127870195906,-9.992410624995484,-8.947568144368233,-96.65345538468755,1169569.61574072,1178244.1264401567,36.0,84.0,-48.0,20.450012000000015,623.5166626666667,640.5333253333333,648.3666386666666,665.3833013333333,615.6833493333334,598.6666866666667,590.8333733333334,1.0543274568957348,-34327690.0,+1
2013-08-07,609.950012,614.349976,600.0,608.650024,579.318848,5689114.0,633.0299988,626.7527309818182,-74.94995199999994,29.240307924590354,-14.048399749421034,-13.287499757562045,-124.35855132392604,-4413819.624646392,893535.6635358443,32.0,96.0,-48.0,24.84997599999997,607.6666666666666,615.3333333333333,622.0166426666665,629.6833093333332,600.9833573333333,593.3166906666667,586.6333813333333,0.6027901370706159,-40016804.0,-1
2013-08-08,604.0,617.5,600.0,601.200012,588.280396,5115362.0,627.1549988000002,620.9654606545455,-58.75,26.59974465963097,-15.30483146360068,-19.382848068482417,-108.34848622592378,3731386.3026586836,1037234.6444231011,28.000000000000004,96.0,-64.0,32.700012000000015,606.2333373333333,612.4666746666667,623.7333373333333,629.9666746666667,594.9666746666667,588.7333373333333,577.4666746666667,0.06857211428571515,-45132166.0,-1
2013-08-12,610.049988,610.799988,598.650024,610.5,580.2824099999999,3925217.0,622.8200012,617.9372790545455,-43.34997599999997,35.048231613039704,-13.451776649746192,-26.46941841440014,-92.07705473442316,-2558438.682799874,856100.770586387,24.0,92.0,-68.0,17.5,606.650004,614.6499839999999,618.7999679999998,626.7999479999999,602.50002,594.50004,590.350056,0.9753095564727611,-41206949.0,+1
2013-08-13,603.849976,624.799988,598.150024,602.200012,597.916382,3675598.0,618.6300047999999,614.1881901090909,-41.899963999999954,31.334220144953093,-14.856173942470384,-30.79909719218756,-74.40049189617113,2074026.2170335855,917153.9443619929,20.0,96.0,-68.0,12.149963999999954,608.3833413333333,618.6166586666666,635.0333053333334,645.2666226666665,591.9666946666666,581.7333773333334,565.3167306666667,0.1519697362442963,-44882547.0,-1
2013-08-14,622.0,623.650024,608.650024,620.5,598.735413,3575927.0,617.4300047999999,614.5281892363637,-12.0,45.91485346171018,-9.618717504332755,-33.45288131597863,-45.973314274527745,6769077.924141395,1209139.2067958144,16.0,96.0,-76.0,26.649963999999954,617.600016,626.5500079999999,632.6000159999999,641.5500079999999,611.5500079999999,602.600016,596.5500079999999,0.789998399999998,-41306620.0,+1
2013-08-16,614.0,622.0,584.900024,621.349976,566.50293,7014892.0,617.0300048,615.2409112727272,-4.0,46.52341356017566,-7.874783774250446,-35.47827449183433,-54.230009115447224,4621769.663851178,1378661.595242759,12.0,92.0,-80.0,21.450012000000015,609.4166666666666,633.9333093333332,646.5166426666665,671.0332853333332,596.8333333333333,572.3166906666667,559.7333573333333,0.9824791261320485,-34291728.0,+1
2013-08-19,587.0,588.599976,570.299988,587.900024,563.4193730000001,5004610.0,614.8450072,609.9445511272727,-21.84997599999997,30.791224292300484,-12.265585643786446,-36.33082064198584,-95.66172871499937,3573188.557413441,1487216.5527882436,8.0,96.0,-80.0,37.09997599999997,582.2666626666667,594.2333373333333,600.5666506666666,612.5333253333333,575.9333493333334,563.9666746666667,557.6333613333334,0.9617512317494449,-39296338.0,-1
2013-08-20,574.950012,589.900024,566.5,584.700012,563.467529,6431746.0,610.0950072,604.4636429090909,-47.5,29.683241710087586,-10.716909558823527,-37.14797898068309,-84.35529264788521,-9812672.902983773,930487.1324657943,4.0,96.0,-88.0,51.049987999999985,580.3666786666666,594.2333573333333,603.7667026666668,617.6333813333333,570.8333333333333,556.9666546666666,547.4333093333332,0.7777774928777847,-45728084.0,-1
2013-08-21,606.0,619.349976,590.0,584.75,571.754517,7227149.0,605.4450072000001,599.8554597818181,-46.5,29.72881866350704,-9.845951963903902,-34.396892029323794,-43.85141707684925,2917337.0988597684,1028004.4599274499,0.0,96.0,-92.0,23.40002400000003,598.0333253333333,606.0666506666666,627.3833013333333,635.4166266666666,576.7166746666667,568.6833493333334,547.3666986666667,-0.17887578511137472,-38500935.0,+1
2013-08-22,589.0,603.700012,570.0,593.349976,567.273865,7562673.0,601.5100036,597.6563632,-39.350036000000046,37.73964681685402,-8.249816813284713,-33.77906234272007,-52.33732436514479,-4976053.2046404,734381.9751953279,12.0,92.0,-96.0,34.649963999999954,589.0166626666667,608.0333253333333,622.7166746666667,641.7333373333333,574.3333133333333,555.3166506666666,540.6333013333333,0.6928773793908429,-30938262.0,+1
2013-08-23,592.0,609.150024,588.299988,588.700012,585.4376219999999,5174611.0,599.5150024000001,595.3272738181818,-19.950012000000015,35.23377099276911,-9.112839104220614,-33.33444036386834,-35.556674197106595,-1848493.6049382717,608503.220934712,8.0,88.0,-80.0,33.700012000000015,595.3833413333333,602.4666946666666,616.2333773333332,623.3167306666667,581.6166586666666,574.5333053333333,560.7666226666665,0.019185770230805813,-36112873.0,-1
2013-08-26,612.349976,622.799988,602.549988,607.549988,589.051208,3651902.0,600.15,596.788180290909,6.34997599999997,50.58193870414755,-5.200861846564751,-33.868796212359825,-2.887101186480117,20615410.7735035,1580368.7449596778,4.0,84.0,-80.0,20.850036000000046,610.9666546666666,619.3833213333332,631.2166546666665,639.6333213333332,599.1333213333332,590.7166546666666,578.8833213333332,0.24691358024691357,-32460971.0,+1
2013-08-27,597.299988,600.0,555.450012,611.299988,541.449158,13677093.0,600.2299988,598.8154508363635,0.7999879999999848,53.131454872241434,-4.501821877114625,-32.080565832418756,-41.77505642948966,5012554.07296874,1746573.4087605677,0.0,80.0,-80.0,34.09997599999997,588.9166666666666,622.3833213333332,633.4666546666665,666.9333093333332,577.8333333333333,544.3666786666666,533.2833453333333,1.253647385943179,-18783878.0,+1
2013-08-28,555.700012,572.0,528.0,561.900024,541.497375,9266888.0,596.2,591.8463645090909,-40.299987999999985,29.77921378227977,-13.045920002070208,-29.113198848059028,-107.04439234464819,-18698409.101653494,759451.1570223052,4.0,96.0,-80.0,52.09997599999997,553.9666746666667,579.9333493333334,597.9666746666667,623.9333493333334,535.9333493333334,509.9666746666667,491.93334933333335,0.7704550909090916,-28050766.0,-1
2013-08-29,568.0,582.5,568.0,561.950012,551.229736,10192751.0,590.3450012,585.6190939636364,-58.549987999999985,29.81523071873181,-11.95320985819421,-27.712234379775964,-63.32995938988388,-8280934.177015777,324194.94701734785,0.0,96.0,-92.0,83.29998799999998,570.8166706666667,573.6333413333334,585.3166706666666,588.1333413333334,559.1333413333334,556.3166706666667,544.6333413333334,-0.4172405517241369,-17858015.0,+1
2013-08-30,571.0,600.0,570.650024,572.049988,572.380859,9154229.0,585.4150024,582.2927279272727,-49.299987999999985,37.311288303500085,-10.0323319140129,-24.853179022453446,-40.67735877624233,256791.3779079737,320958.4611231773,0.0,92.0,-96.0,20.59997599999997,580.900004,591.1499839999999,610.24998,620.4999599999999,561.8000079999999,551.550028,532.450032,0.047698982786219514,-8703786.0,+1
2013-09-02,598.0,604.349976,582.5,594.0,568.044678,4878929.0,586.0250000000001,583.8536365818181,6.09997599999997,50.55415885302118,-5.8577384372249135,-23.939947605676252,-12.144841690021401,2850731.3187866583,442118.97821205773,0.0,88.0,-92.0,38.049987999999985,593.6166586666667,604.7333173333334,615.4666346666668,626.5832933333334,582.8833413333334,571.7666826666667,561.0333653333334,0.5263163675786195,-3824857.0,+1
2013-09-03,596.900024,596.900024,557.049988,589.5,542.0755,4535002.0,586.5049988000001,584.4854547636364,4.799987999999985,48.14814561362074,-6.7135771787046865,-24.920119491445348,-37.282509532490415,-3224106.520221092,266956.66003480804,0.0,84.0,-88.0,32.299987999999985,581.150004,605.25002,621.0000400000001,645.100056,565.3999839999999,541.2999679999999,525.5499479999999,0.8143032041426507,-8359859.0,-1
2013-09-04,567.450012,576.849976,559.150024,562.549988,543.520935,5235450.0,584.2849976,580.1299982545454,-22.200012000000015,36.23216546775916,-11.645865473171128,-22.464988251480122,-69.5250904942537,-16836788.701080907,-548320.2591897842,0.0,80.0,-84.0,39.850036000000046,566.1833293333333,573.2166346666666,583.8832813333333,590.9165866666665,555.5166826666666,548.4833773333334,537.8167306666667,0.19208888250092238,-13595309.0,-1
2013-09-05,584.0,622.900024,584.0,564.049988,587.316772,8311562.0,581.3549988000001,576.4509056,-29.299987999999985,37.229828146703525,-11.233066101176595,-20.097520198899247,-3.950043554141496,1749743.5789473683,-439021.2049822982,8.0,76.0,-80.0,30.34997599999997,590.3166706666667,596.6333413333334,629.2166946666666,635.5333653333334,557.7333173333334,551.4166466666667,518.8332933333334,-0.5128534625068611,-5283747.0,+1
2013-09-06,611.0,620.0,586.75,609.5,593.772888,4749304.0,583.4349976000001,581.5681785454544,20.799987999999985,59.42409891521775,-2.557744490578613,-17.246448814720566,36.754827452761994,-6062711.880755988,-705929.2855160726,4.0,72.0,-68.0,60.350036000000046,605.4166666666666,624.0833333333333,638.6666666666665,657.3333333333333,590.8333333333333,572.1666666666666,557.5833333333333,0.6842105263157895,-534443.0,+1
2013-09-10,620.549988,641.0,618.400024,616.200012,614.77948,5074709.0,584.3000000000001,587.5254538909091,8.65002400000003,61.72597121448043,-4.575643542435421,-15.723263875731732,97.92502542249362,58392.90267735031,-669726.1585169486,0.0,68.0,-68.0,55.950012000000015,625.200012,632.0,647.799988,654.599976,609.400024,602.600036,586.8000480000001,-0.09734576709285081,4540266.0,+1
2013-09-11,633.0,650.0,625.549988,638.0,623.69281,3172598.0,586.9700012,597.2890902545455,26.700012000000015,68.44631792837475,-2.1778584392014517,-13.869832207093168,137.9301208348699,5019559.032054305,-400759.87516821513,96.0,64.0,-68.0,31.5,637.849996,650.1500040000001,662.3000079999999,674.6000160000001,625.6999920000001,613.399984,601.24998,0.5092026948698433,7712864.0,+1
2013-09-12,642.5,646.0,627.599976,647.25,610.8768309999999,4419134.0,595.5049988,608.2490900363637,85.34997599999997,70.944103566961,-0.49909255898366606,-12.867302130637427,132.41623001213017,3559982.593979268,-213852.49848670722,96.0,60.0,32.0,33.799987999999985,640.2833253333333,652.9666746666667,658.6833493333334,671.3666986666667,634.5666506666666,621.8833013333333,616.1666266666666,1.067934693998225,12131998.0,+1
2013-09-13,632.450012,634.5,621.0,633.950012,606.299744,3875780.0,602.7049988,615.2390924363636,72.0,62.70860859156087,-2.9128834845735,-12.75724407288476,94.89969835898718,-2973799.328081208,-343868.71201601473,92.0,56.00000000000001,36.0,18.40002400000003,629.8166706666667,638.6333413333334,643.3166706666666,652.1333413333334,625.1333413333334,616.3166706666667,611.6333413333334,0.9592601481481493,8256218.0,-1
2013-09-16,637.5,648.900024,629.0,629.200012,619.404785,3034804.0,608.4200012,620.0563675636363,57.15002400000003,59.84576833548267,-3.7749524500907414,-5.650229128471892,103.53851725308124,1294396.7486384206,-266820.33762455103,88.0,52.0,35.99999999999999,26.25,635.700012,642.400024,655.600036,662.3000480000001,622.5,615.799988,602.599976,0.010050842149738858,5221414.0,-1
2013-09-17,638.0,645.0,633.599976,642.799988,618.8747559999999,2108022.0,613.3000000000001,626.3072742545454,48.799987999999985,65.10819257792863,-1.306717241379313,0.8841512699668783,98.1563346088302,-179309.81370072282,-262711.1533475802,84.0,48.0,36.0,19.90002400000003,640.4666546666666,647.3333333333333,651.8666786666668,658.7333573333333,635.9333093333332,629.0666306666666,624.5332853333332,0.8070168975082851,7329436.0,+1
2013-09-18,643.599976,654.900024,631.150024,642.25,626.824463,2747404.0,618.575,631.5709106181818,52.75,64.71245672097169,-2.2755933538150073,6.129447172321875,91.48118767150599,-35093938.21036287,-1895809.4464992373,80.0,44.0,36.0,15.799987999999985,642.7666826666667,654.3833413333334,666.5166826666668,678.1333413333334,630.6333413333334,619.0166826666667,606.8833413333334,0.46736741052631453,4582032.0,-1
2013-09-19,680.0,689.900024,676.299988,650.5,658.334351,7320226.0,627.3700012,637.3754560727273,87.95001200000002,68.07136928362456,-6.6677986799337186,9.575088285290121,156.87120243927788,5396772.617523137,-1554377.9118950088,96.0,40.0,36.0,23.75,672.2333373333333,668.1666866666667,685.8333733333334,681.7667226666667,654.5666506666666,658.6333013333333,640.9666146666666,-1.8970529195657937,11902258.0,+1
2013-09-20,682.5,686.450012,635.25,683.200012,635.0632929999999,6181538.0,639.2850036,647.5263671272728,119.15002400000003,77.75520717120435,-1.1338655826488873,14.340876293332371,126.77676933778251,5930109.372022863,-1204439.045401913,96.0,36.0,56.0,47.65002400000003,668.300008,701.3500160000001,719.50002,752.5500280000001,650.1500040000001,617.099996,598.9499920000001,0.9365234523773158,18083796.0,+1
2013-09-23,651.0,652.349976,633.099976,659.049988,618.585632,3496310.0,644.2400024000001,651.1200006545455,49.549987999999985,61.78624826905792,-5.220855431882677,24.04963025677796,69.72399858869443,3029216.9325348553,-1006750.6478775523,92.0,32.0,60.0,51.200012000000015,648.1666466666667,663.2333173333334,667.4166466666666,682.4833173333334,643.9833173333334,628.9166466666667,624.7333173333334,1.3480525714285723,14587486.0,-1
2013-09-24,633.049988,644.349976,629.950012,641.950012,615.213074,4543797.0,646.8150024,650.7036387636365,25.75,52.908577299393514,-8.11474192798476,34.0871053358743,44.76999568546122,4048949.4736842103,-770969.6749145869,88.0,28.000000000000004,60.0,50.100036000000046,638.75,647.549988,653.149964,661.9499519999999,633.150024,624.350036,618.7500600000001,0.8333354166718776,10043689.0,-1
2013-09-25,638.0,641.700012,613.200012,638.450012,598.012756,5245230.0,646.8600036,649.1827314181818,0.4500120000000152,51.17213171190674,-8.707058708801139,36.349054953390464,25.565615758432592,-1975997.3736600429,-827101.7886151115,84.0,24.0,60.0,29.09997599999997,631.1166786666666,649.0333453333333,659.6166786666665,677.5333453333333,620.5333453333333,602.6166786666666,592.0333453333333,0.8859649122807017,4798459.0,-1
2013-09-26,621.349976,626.0,618.0,620.599976,598.542725,5645610.0,644.1950012,644.4081809454545,-26.65002400000003,42.88891356279073,-11.727880383365843,37.29735073110328,0.9850282003144384,2871531.463384434,-655007.5068858805,80.0,20.0,60.0,28.75,621.5333253333333,625.0666506666666,629.5333253333333,633.0666506666666,617.0666506666666,613.5333253333333,609.0666506666666,0.3249969999999962,-847151.0,-1
2013-09-27,622.0,624.0,605.0,621.150024,586.738586,4102173.0,642.9150023999999,640.2181850909092,-12.799987999999985,43.21572936122516,-11.634793908893123,35.31658792352766,-12.938812120650724,2925728.9070640597,-488577.7125967522,76.0,16.0,60.0,20.450012000000015,616.7166746666667,628.4333493333334,635.7166746666667,647.4333493333334,609.4333493333334,597.7166746666667,590.4333493333334,0.8500012631578964,3255022.0,+1
2013-09-30,606.0,612.849976,587.700012,608.900024,571.465393,4265607.0,640.8850036,634.0336435636364,-20.299987999999985,37.67552996017564,-13.707902641750442,32.13967375300342,-42.30754628200421,-2289409.4667063295,-572193.2693607957,72.0,12.0,60.0,19.0,603.150004,618.5999959999999,628.299968,643.7499599999999,593.450032,578.00004,568.300068,0.8429440296614362,-1010585.0,-1
2013-10-01,598.799988,614.400024,589.349976,593.049988,589.3884889999999,3249277.0,635.9100036,625.3363680000001,-49.75,31.62309662040154,-16.390257584420073,29.91440467938378,-52.466249388268906,-2165201.4594846843,-646087.0383574056,68.0,8.0,60.0,33.450012000000015,598.9333293333333,608.5166826666666,623.9833773333335,633.5667306666667,583.4666346666666,573.8832813333332,558.4165866666665,0.14770478683314325,-4259862.0,-1
2013-10-03,615.299988,639.0,610.0,611.650024,613.044983,2443228.0,632.850006,620.9254626181818,-30.59997599999997,43.839261680633946,-13.242510885394717,29.87800678322219,-13.639579815613708,-2747651.1335784444,-743480.0911186606,64.0,4.0,60.0,25.05004800000006,620.2166746666667,630.4333493333334,649.2166746666667,659.4333493333334,601.4333493333334,591.2166746666667,572.4333493333334,0.05689737931034587,-1816634.0,+1
2013-10-04,635.5,647.400024,635.0,636.200012,617.14032,3407094.0,631.4200072000001,621.5345546181818,-14.299987999999985,55.85156266489905,-9.087833782183093,28.769545547091525,21.34805810182173,3053878.226478516,-567654.8656728633,60.0,0.0,60.0,45.950012000000015,639.5333453333334,644.0666906666668,651.9333693333333,656.4667146666668,631.6666666666667,627.1333213333334,619.2666426666667,0.0967749739839223,1590460.0,+1
2013-10-07,636.5,638.150024,618.25,640.450012,611.214111,2480500.0,627.1450072000001,623.1763736727273,-42.75,57.66050460222323,-8.368591976906064,24.652889813979073,-0.3410470924779162,-1202397.7304347828,-597019.8348547559,56.00000000000001,12.0,60.0,35.75,632.2833453333334,646.3166906666668,652.1833693333333,666.2167146666668,626.4166666666667,612.3833213333334,606.5166426666667,1.1155771470426359,4070960.0,+1
2013-10-08,650.5,654.549988,625.799988,634.299988,609.6242070000001,2942037.0,624.6700072000001,624.4772792727273,-24.75,53.96831545889628,-9.409381239084201,19.009122866184157,11.37926452096025,-668020.2851237659,-600301.8603841368,52.0,8.0,44.00000000000001,19.90002400000003,638.2166546666666,650.6333213333332,666.9666546666665,679.3833213333332,621.8833213333332,609.4666546666666,593.1333213333332,0.2956521739130435,1128923.0,-1
2013-10-09,625.200012,650.900024,623.0,632.650024,625.523682,2167190.0,623.7400084,625.9281914181819,-9.299987999999985,52.919339625161236,-9.688610200496454,8.940259154452633,2.872103264607071,2126320.711400323,-474359.67627333687,48.0,4.0,44.0,28.75,635.5166826666667,648.0333653333334,663.4167066666669,675.9333893333335,620.1333413333334,607.6166586666667,592.2333173333334,0.34587869888570777,-1038267.0,-1
2013-10-10,649.0,649.0,633.349976,649.150024,617.718445,2086321.0,624.8100096000001,630.5481942545455,10.700012000000015,61.54409910872796,-6.896259662362104,3.3606571047678244,31.284389437235948,-2881099.0513779786,-585444.83844432,44.0,0.0,44.0,27.90002400000003,643.8333333333334,654.3166906666668,659.4833573333335,669.9667146666668,638.6666666666667,628.1833093333333,623.0166426666667,1.0095861833822126,1048054.0,+1
2013-10-11,647.299988,663.75,639.349976,641.049988,637.2313839999999,3347566.0,626.8550108000001,633.5009176000001,20.450012000000015,55.75828150176956,-7.728321231185885,-0.6658737130350119,56.42361796766328,696691.9224905134,-526308.1684561583,40.0,0.0,44.0,16.34997599999997,648.049988,656.75,672.450012,681.150024,632.349976,623.649964,607.9499519999999,0.0696725544204388,-2299512.0,-1
2013-10-14,657.549988,669.299988,648.650024,661.299988,643.20575,3093930.0,630.8700072,639.7636407272727,40.149963999999954,65.1964521100967,-1.4027705011980467,-5.614567320348215,128.10887967228595,1904231.9210696465,-414278.03224253806,36.0,0.0,40.0,24.40002400000003,659.75,670.849976,680.399964,691.4999399999999,650.200012,639.100036,629.5500480000001,0.6125901236437983,794418.0,+1
2013-10-15,673.0,675.0,646.599976,667.5,628.703613,4035831.0,636.7300048,646.4236394181818,58.59997599999997,67.63560350793942,-1.3020833333333335,-7.96114967378378,148.5717065412201,501783.2222259058,-372081.2305601897,32.0,0.0,36.0,28.25,663.0333253333333,679.4666746666667,691.4333493333334,707.8666986666667,651.0666506666666,634.6333013333333,622.6666266666666,0.7359157161275641,4830249.0,+1
2013-10-17,653.0,659.950012,642.549988,652.450012,630.3898320000001,3637897.0,642.6700072,649.2818225454546,59.40002400000003,56.5376153616654,-3.9149284722222197,-7.856541875379662,76.49913441016177,-5780069.639102037,-621039.4533604627,28.000000000000004,56.00000000000001,32.0,28.40002400000003,651.650004,660.75002,669.0500279999999,678.150044,643.3499959999999,634.2499799999999,625.9499719999999,0.5689661117708811,1192352.0,-1
2013-10-18,655.25,679.549988,655.25,654.200012,651.9744870000001,5320296.0,646.9250060000002,651.3781870545454,42.549987999999985,57.47382901385807,-4.366544918436889,-5.408198354157889,137.95058378078443,2046476.9998434407,-498310.8770549459,24.0,52.0,-28.000000000000004,24.950012000000015,663.0,670.75,687.299988,695.049988,646.450012,638.700012,622.150024,-0.043209404054026096,6512648.0,+1
2013-10-21,674.0,678.799988,662.549988,676.599976,646.819336,2806356.0,650.9650024,656.7736361454546,40.399963999999954,67.73774909410398,-0.5081409113731676,1.5929595393299678,170.32858748241026,838268.8973055924,-436850.82299839036,20.0,48.0,-28.0,27.09997599999997,672.649984,682.74998,688.8999839999999,698.99998,666.49998,656.399984,650.24998,0.8646146461538452,9319004.0,+1
2013-10-22,671.0,673.950012,665.200012,671.25,644.651245,2189524.0,654.0450012,660.4618175272726,30.799987999999985,63.513263535765304,-1.4296767154527932,7.0905284904274595,136.8709500424569,3386239.0,-261146.24549007058,16.0,44.0,-28.0,24.59997599999997,670.1333413333333,675.0666706666666,678.8833413333334,683.8166706666666,666.3166706666666,661.3833413333333,657.5666706666666,0.6914271999999982,7129480.0,-1
2013-10-23,669.0,669.0,653.799988,669.0,636.171509,3386239.0,657.5150024,663.1809082181818,34.700012000000015,61.64758119392574,-1.8172402408179855,8.709230541415081,100.91609253218692,-1819925.932139497,-332749.7662061061,12.0,40.0,-28.0,11.399963999999954,663.9333293333333,674.0666706666666,679.1333413333334,689.2666826666666,658.8666586666666,648.7333173333333,643.6666466666666,1.0,3743241.0,-1
2013-10-24,656.200012,675.75,656.200012,660.200012,644.940186,3080482.0,660.2700012,663.6690917818182,27.549987999999985,54.43194550587035,-3.33304218412971,9.40305139610814,97.04502040795381,94764.90966938541,-313121.05493311654,8.0,36.0,-28.0,17.450012000000015,664.050008,671.9000040000001,683.5999960000001,691.4499920000001,652.3500160000001,644.5000200000001,632.8000280000001,0.20460370615061263,662759.0,-1
2013-10-25,665.25,674.950012,663.150024,669.299988,648.072021,2236718.0,662.2849976,665.3109075636364,20.149963999999954,60.016013778629265,-1.7655671711080976,12.20294167691975,103.34012980137744,1025924.7330351559,-251668.93145970214,4.0,32.0,-28.0,19.549987999999985,669.1333413333333,675.1166586666666,680.9333293333334,686.9166466666666,663.3166706666666,657.3333533333333,651.5166826666666,0.5211839198480509,2899477.0,+1
2013-10-28,673.0,675.0,665.400024,672.549988,643.5912480000001,2095522.0,665.4349976,667.1772694545455,31.5,61.93809516241063,-1.2057531900250422,15.5872132973102,94.16355790617233,-995512.3605414459,-285790.8034631849,0.0,28.000000000000004,-28.0,14.75,670.9833373333333,676.5666506666666,680.5833133333333,686.1666266666666,666.9666746666667,661.3833613333334,657.3666986666667,0.7447897786411108,4994999.0,+1
2013-10-29,668.0,689.0,655.549988,667.900024,661.514221,3805729.0,666.0950012000001,667.6254560727273,6.6000360000000455,57.38411137284891,-3.576267118644063,17.36900999470072,75.64655976997379,2113607.489361702,-175770.6524535532,0.0,24.0,-28.000000000000004,9.59997599999997,670.8166706666667,686.0833533333334,704.2666826666666,719.5333653333334,652.6333413333334,637.3666586666667,619.1833293333334,0.3692087165768443,1189270.0,-1
2013-10-30,686.0,687.5,675.75,686.5,654.624512,2547168.0,667.9950012,671.3354558545454,19.0,68.18159846461305,-0.423728813559322,23.03269673918976,98.33870224137999,97592.51759573328,-163241.064667862,96.0,20.0,-24.0,33.450012000000015,683.25,690.75,695.0,702.5,679.0,671.5,667.25,0.9148936170212766,3736438.0,+1
2013-10-31,676.200012,685.049988,673.400024,679.349976,656.021729,4548889.0,670.6849976,673.3999967272728,26.899963999999954,61.29336822798577,-1.6355972881355985,24.54203521038619,65.67124899505122,-1835609.5315623046,-239864.84493293145,92.0,16.0,76.0,19.59997599999997,679.2666626666667,685.1333013333333,690.9166266666666,696.7832653333332,673.4833373333333,667.6166986666667,661.8333733333334,0.5107270717746392,-812451.0,-1
2013-11-01,681.599976,688.0,678.200012,680.799988,658.912537,3910611.0,673.3449952,675.2390858909091,26.59997599999997,62.18727143794418,-1.389832542372884,24.25310288624746,62.90730150871124,2851687.270763991,-98268.98164605147,88.0,12.0,76.0,13.09997599999997,682.3333333333334,686.4666546666667,692.1333213333335,696.2666426666667,676.6666666666667,672.5333453333334,666.8666786666668,0.2653039983314238,3098160.0,+1
2013-11-05,680.450012,685.0,673.0,683.799988,651.637268,3564618.0,674.0649963999999,677.1399936727272,7.200012000000015,64.16303039434649,-0.8813579661016976,25.998504678002632,50.751052082413345,665155.2212316358,-63315.5737600748,84.0,8.0,76.0,9.799987999999985,680.599996,688.1999920000001,692.5999959999999,700.1999920000001,676.1999920000001,668.599996,664.1999920000001,0.8999989999999988,6662778.0,+1
2013-11-06,678.900024,679.200012,665.25,676.25,644.55481,1152663.0,674.5649963999999,677.5372670545455,5.0,55.71017603326863,-2.1610169491525424,26.40361509953732,26.107985286155497,321399.19652528083,-45707.21197558017,80.0,4.0,76.0,12.0,673.5666706666667,681.8833413333334,687.5166826666668,695.8333533333334,667.9333293333334,659.6166586666667,653.9833173333334,0.7885297876446262,5510115.0,-1
2013-11-07,670.0,677.5,656.900024,668.900024,641.18219,1947285.0,674.5549987999999,676.5072720727271,-0.09997599999996964,48.52882924315266,-3.406775593220334,23.602960463981617,6.132472371998482,2710805.0,80418.33774038006,76.0,0.0,76.0,18.549987999999985,667.7666826666667,678.6333413333334,688.3666586666668,699.2333173333334,658.0333653333334,647.1667066666668,637.4333893333335,0.5825249505145063,3562830.0,-1
2013-11-08,663.400024,667.650024,644.650024,665.400024,628.751709,3370190.0,675.075,674.8427312,5.200012000000015,45.31900146509506,-3.9999959322033845,20.55386105559853,-23.02020476845199,1758918.8705039981,157195.83629871687,72.0,0.0,76.0,20.59997599999997,659.2333573333334,673.8166906666668,682.2333573333335,696.8166906666668,650.8166906666668,636.2333573333334,627.8166906666668,0.9021739130434783,192640.0,-1
2013-11-11,644.0,660.700012,616.700012,652.5,630.438049,2804076.0,673.3950012,670.7381857454545,-16.799987999999985,35.36985941940121,-6.186440677966102,16.36087667272386,-74.88757269207352,239327.20563216403,160951.58770958075,68.0,0.0,72.0,24.25,643.300008,669.9000040000001,687.3000079999999,713.9000040000001,625.9000040000001,599.300008,581.9000040000001,0.8136360909090906,-2611436.0,-1
2013-11-12,652.549988,663.049988,643.349976,654.25,622.440125,2245080.0,671.5650024,667.2572764363637,-18.299987999999985,37.517010177720366,-5.889830508474576,14.451897935373154,-44.56351442993587,2225569.5303273783,255337.7818113644,64.0,96.0,68.0,48.700012000000015,653.549988,663.75,673.25,683.450012,644.049988,633.849976,624.349976,0.553300373624139,-366356.0,+1
2013-11-13,639.0,647.450012,628.349976,645.950012,610.635986,2640271.0,669.3700011999999,662.6000054545453,-21.950012000000015,31.745416038324237,-7.2966081355932175,12.541647926321275,-89.3363594665566,-5438027.477927761,-4872.38768170683,60.0,92.0,-32.0,19.700012000000015,640.5833333333334,652.8166906666668,659.6833693333333,671.9167266666668,633.7166546666667,621.4832973333333,614.6166186666667,0.9214661166083667,-3006627.0,-1
2013-11-14,638.0,649.900024,638.0,633.700012,618.826538,3156715.0,664.0900024,656.1145528727272,-52.799987999999985,25.155173348091765,-9.372879322033896,9.996761570805234,-84.87155971078037,-6150125.266501983,-285665.6019146123,56.00000000000001,88.0,-32.0,25.90002400000003,640.5333453333334,643.0666906666668,652.4333693333333,654.9667146666668,631.1666666666667,628.6333213333334,619.2666426666667,-0.361342800653173,-6163342.0,-1
2013-11-18,651.400024,670.0,649.049988,642.200012,644.458557,3718480.0,660.375006,652.1345546181818,-37.149963999999954,35.822043602491405,-7.9322013559322,7.741497570128331,-39.086297202324104,1821248.361596302,-189417.9301796793,52.0,84.0,-31.999999999999993,11.90002400000003,653.75,658.450012,674.700012,679.400024,637.5,632.799988,616.549988,-0.3269676408777219,-2444862.0,+1
2013-11-19,668.400024,668.400024,657.450012,668.799988,636.026917,1697259.0,659.1750059999999,653.6663695272728,-12.0,57.627644495373715,-3.42373084745763,3.25585391664697,-1.2049461556085248,2441274.678527002,-69270.40173180847,48.0,80.0,-32.0,36.299987999999985,664.8833413333333,672.3166706666666,675.8333533333332,683.2666826666666,661.3666586666666,653.9333293333333,650.4166466666666,1.03652635266518,-747603.0,+1
2013-11-20,656.700012,659.0,646.400024,660.049988,625.909058,2092524.0,656.8000059999999,653.8254571636363,-23.75,51.04486980715075,-4.9067816949152565,0.2910246872370408,-36.79487480514475,5613738.24244018,190224.52171127714,44.0,76.0,-32.0,26.200012000000015,655.150004,663.8999839999999,667.74998,676.4999599999999,651.3000079999999,642.550028,638.700032,1.083332539681027,-2840127.0,-1
2013-11-21,644.549988,645.599976,635.150024,649.549988,614.4422,3196914.0,654.1300047999999,652.5072720727272,-26.700012000000015,44.073961600791705,-6.5280156196944,-3.901533931513768,-82.86507619952006,-1063525.613742573,132988.20800511196,40.0,72.0,-32.0,22.399963999999954,643.4333293333333,651.7166346666666,653.8832813333333,662.1665866666665,641.2666826666666,632.9833773333334,630.8167306666667,1.3779933151846093,-6037041.0,-1
2013-11-22,642.5,646.900024,635.099976,637.650024,618.778442,1873096.0,651.0050047999999,649.5109119272728,-31.25,37.395703150086234,-8.548383022071302,-7.890574783764123,-97.5515031305188,-7515281.756096241,-216102.337972719,36.0,68.0,-32.0,24.899963999999954,639.8833413333333,644.6667066666666,651.6833893333333,656.4667546666667,632.8666586666666,628.0832933333332,621.0666106666665,0.21610488364115532,-7910137.0,-1
2013-11-25,648.049988,661.75,648.049988,642.150024,635.737854,4037635.0,648.6800048,647.9009154181817,-23.25,41.278067126820574,-7.784376230899825,-10.689498667906491,-46.73948937702159,3525188.7876354596,-45370.50088097534,32.0,64.0,-32.0,14.450012000000015,650.650004,653.25002,664.3500160000001,666.950032,639.5500079999999,636.949992,625.8499959999999,-0.43065392935421865,-3872502.0,+1
2013-11-26,657.700012,659.900024,648.400024,659.75,629.185303,3619629.0,649.4050048,649.9136418181819,7.25,54.11844266691336,-4.3088737201365195,-13.233307620550477,-21.074185831633354,447253.51754673687,-22893.90904932081,28.000000000000004,60.0,-32.0,24.09997599999997,656.0166826666667,663.6333413333334,667.5166826666668,675.1333413333334,652.1333413333334,644.5166826666667,640.6333413333334,0.986954434782606,-252873.0,+1
2013-11-27,651.099976,658.75,644.099976,652.950012,629.76355,2148253.0,649.2750060000001,650.5581885818183,-1.2999879999999848,49.31149362539205,-4.524301871265732,-15.547731165910704,-38.60378280884093,-975859.060928917,-66366.68045822061,24.0,56.00000000000001,-31.999999999999996,17.75,651.9333293333333,659.7666826666666,666.5833533333334,674.4167066666666,645.1166586666666,637.2833053333333,630.4666346666666,0.6040970308308046,-2401126.0,-1
2013-11-28,655.599976,663.0,648.049988,653.549988,629.6190190000001,3693433.0,650.0350036,651.3354580363637,7.59997599999997,49.76574663971604,-4.140019360414868,-14.78207710336926,-19.825438865603573,-2943614.311278875,-197600.6851942131,20.0,52.0,-32.00000000000001,15.65002400000003,654.8666586666667,661.6833293333334,669.8166706666668,676.6333413333334,646.7333173333334,639.9166466666667,631.7833053333334,0.3678926812901551,1292307.0,+1
2013-11-29,655.0,668.900024,655.0,653.400024,637.2313839999999,2392770.0,652.0050048,651.9472799272728,19.700012000000015,49.63745484723944,-2.907176182136597,-14.588890129104016,8.035551817270274,-111023.46669847827,-193652.43333638879,16.0,48.0,-32.0,14.950012000000015,659.100016,663.200032,673.0000399999999,677.100056,649.3000079999999,645.199992,635.3999839999999,-0.1151059883062048,-1100463.0,-1
2013-12-02,662.0,665.0,658.049988,661.299988,637.2313839999999,1714653.0,653.9150023999999,653.6372768727273,19.09997599999997,56.45995053815574,-1.5236448336252215,-13.162801891441177,25.351653961677727,2087268.4003162975,-89649.25599956773,12.0,44.0,-32.0,15.350036000000046,661.449992,664.8499959999999,668.4000039999999,671.8000079999999,657.8999839999999,654.4999799999999,650.9499719999999,0.46762509187034396,614190.0,+1
2013-12-03,660.0,662.200012,652.650024,661.299988,631.883484,2572070.0,653.1650023999999,654.9800015272727,-7.5,56.45995053815575,-1.5236448336252215,-10.422102262230396,19.212189987122237,-644056.3044838241,-114924.96052941095,8.0,40.0,-32.0,11.59997599999997,658.7166746666667,664.7833253333333,668.2666626666667,674.3333133333333,655.2333373333333,649.1666866666667,645.6833493333334,0.9057565307935432,614190.0,-1
2013-12-04,654.900024,659.549988,653.450012,655.75,633.666077,2619152.0,652.7350036,655.4500010909092,-4.299987999999985,50.11061759545054,-2.495621716287215,-8.199474171522866,12.691007667180003,-20176071.469281025,-1029398.678445868,4.0,36.0,-32.0,9.549987999999985,656.25,659.049988,662.349976,665.149964,652.950012,650.150024,646.850036,0.37704869658503515,-2004962.0,-1
2013-12-05,671.549988,689.900024,671.549988,657.599976,663.05603,8004998.0,653.5400024000002,656.3345415272727,8.049987999999985,52.17898805499908,-5.466245843306998,-9.353849221057544,140.52247938794395,2955462.230458282,-847775.0745178373,0.0,32.0,-32.0,7.84997599999997,673.0166626666667,674.4833373333333,691.3666986666667,692.8333733333334,656.1333013333333,654.6666266666666,637.7832653333332,-0.7602171461679955,6000036.0,+1
2013-12-06,684.900024,689.599976,678.25,688.099976,657.852539,4017308.0,658.5849976000001,662.6181730909091,50.44995199999994,73.26466316951971,-0.30462818190714114,-8.909455919900438,236.57539934035913,-11323760.498902913,-1325194.6468725759,96.0,28.000000000000004,-32.0,34.15002400000003,685.3166506666666,692.3833013333333,696.6666266666666,703.7332773333333,681.0333253333333,673.9666746666667,669.6833493333334,0.8678411302367508,10017344.0,+1
2013-12-09,710.0,717.400024,692.549988,682.700012,671.2949219999999,6316407.0,662.6399964,667.0027211636364,40.549987999999985,67.21061912030498,-5.611256573948648,-5.871690309407313,273.9760355985612,766792.2844603731,-1229868.2969465482,92.0,24.0,68.0,32.0,697.550008,702.5500280000001,722.4000440000002,727.4000640000002,677.6999920000001,672.699972,652.849956,-0.3963767295950779,3700937.0,-1
2013-12-10,692.349976,701.849976,690.0,696.650024,671.3430179999999,6266220.0,666.3299988000001,673.1863625454546,36.90002400000003,73.69083779319693,-3.3554332462315686,-0.9886013774763569,191.127414292301,969165.0039777339,-1129675.4296806897,96.0,20.0,68.0,29.30004800000006,696.1666666666666,702.3333333333333,708.0166426666665,714.1833093333332,690.4833573333333,684.3166906666667,678.6333813333333,0.5611845964920138,9967157.0,+1
2013-12-11,690.099976,701.799988,686.900024,696.700012,670.234863,3072444.0,670.7049988000001,678.7081831272727,43.75,73.71231846285261,-3.3473498054068664,3.7880893133378777,151.60696075737164,16000.775017039963,-1077481.4843193626,92.0,16.0,76.0,19.149963999999954,695.1333413333333,703.3666586666666,710.0333053333334,718.2666226666665,688.4666946666666,680.2333773333334,673.5667306666667,0.6577189045557436,13039601.0,+1
2013-12-12,693.200012,700.549988,690.5,695.549988,669.897583,3216924.0,674.9049988000002,683.2254538909091,42.0,72.14860284936974,-3.533317456662978,6.632072069086007,132.06908737648584,1265812.93508707,-970738.2256923661,88.0,12.0,76.0,14.899963999999954,695.5333253333333,700.5666506666666,705.5833133333333,710.6166386666666,690.5166626666667,685.4833373333333,680.4666746666667,0.5024869681436428,9822677.0,-1
2013-12-13,687.799988,702.0,685.0,695.200012,664.838745,6329020.0,679.0849976000002,686.915456290909,41.799987999999985,71.61514288675201,-3.589911244893486,10.198165497560467,109.87756120606163,4308531.938235525,-730277.095593506,84.0,8.0,76.0,10.049987999999985,694.0666706666667,703.1333413333334,711.0666706666666,720.1333413333334,686.1333413333334,677.0666706666667,669.1333413333334,0.6000007058823539,3493657.0,-1
2013-12-16,688.0,690.900024,681.200012,689.950012,659.442444,5358061.0,681.95,688.8909134545454,28.65002400000003,63.48971518164692,-4.438876283096653,13.404635290240549,70.53896618706803,8099084.1802457785,-328153.4396711477,80.0,4.0,76.0,17.0,687.350016,693.50002,697.0500279999999,703.200032,683.8000079999999,677.650004,674.0999959999999,0.9020607397186711,-1864404.0,-1
2013-12-17,675.650024,675.650024,654.049988,684.349976,633.666077,4485661.0,684.2549988000001,689.3272727272728,23.049987999999985,55.71015323898493,-5.344444811987921,16.57700518918864,7.933766812327864,-1698636.1787407638,-390565.0078690316,76.0,0.0,76.0,14.0,671.349996,688.6500040000001,692.950032,710.2500400000001,667.049968,649.74996,645.449932,1.4027748842640781,-6350065.0,-1
2013-12-18,650.5,680.650024,649.549988,657.599976,642.0012820000001,3521829.0,684.4399964,684.4809049454545,1.8499759999999696,33.25272936295855,-9.670123816165967,17.42421359348964,-25.44356200561543,-138125.72229963588,-379069.94303882075,72.0,4.0,76.0,35.90002400000003,662.599996,675.6500040000001,693.700032,706.7500400000001,644.549968,631.49996,613.449932,0.2588417582539124,-9871894.0,-1
2013-12-19,679.0,683.950012,650.400024,666.25,628.799805,2504879.0,685.3049988,681.1736328727274,8.65002400000003,41.97941129260507,-8.27134896747676,18.70839546158038,-13.894972800059554,-1051694.9656860516,-409696.0747863196,68.0,0.0,68.0,34.799987999999985,666.8666786666666,683.3333333333333,700.4166666666665,716.8833213333332,649.7833453333333,633.3166906666667,616.2333573333333,0.472428663759879,-7367015.0,+1
2013-12-20,657.799988,668.599976,650.099976,652.549988,640.411255,1430617.0,681.75,675.2181763636363,-35.549987999999985,33.8836549646347,-10.486745388612734,20.060267560188322,-52.112078282999036,66751.67070454593,-388004.0217811085,64.0,20.0,68.0,33.549987999999985,657.0833133333333,664.0666506666666,675.5833133333333,682.5666506666666,645.5666506666666,638.5833133333333,627.0666506666666,0.1324330810810819,-8797632.0,-1
2013-12-23,658.0,671.5,657.0,664.599976,640.2667849999999,1382808.0,679.9399963999999,672.0999901818182,-18.100036000000046,44.70581848168124,-8.538170431895077,20.854546184794117,-27.330314994812696,570461.05211628,-344369.57611558633,60.0,16.0,44.0,18.5,664.3666586666667,671.7333173333334,678.8666586666668,686.2333173333334,657.2333173333334,649.8666586666667,642.7333173333334,0.5241362758620669,-7414824.0,+1
2013-12-24,665.549988,666.5,655.049988,664.450012,633.3770139999999,888674.0,676.7199952,669.2836293818182,-32.200012000000015,44.60098548095646,-8.562420754369183,17.985357109123356,-35.9720655577459,-1906512.9790559432,-415481.64711344766,56.00000000000001,12.0,44.0,18.950012000000015,662.0,668.950012,673.450012,680.400024,657.5,650.549988,646.049988,0.8209619343630398,-8303498.0,-1
2013-12-26,659.849976,672.200012,656.900024,657.299988,644.699402,2011690.0,672.7799928000001,665.7527189818181,-39.40002400000003,39.50472726078529,-9.718634163571773,17.185206454251784,-36.13236927593623,-174512.28718886996,-404512.9534429597,52.0,8.0,44.00000000000001,11.450012000000015,662.1333413333333,667.3666586666666,677.4333293333334,682.6666466666666,652.0666706666666,646.8333533333333,636.7666826666666,0.026141458411598418,-10315188.0,-1
2013-12-27,664.099976,675.450012,664.099976,669.049988,645.277527,1366003.0,670.1299928000001,665.074536290909,-26.5,50.27771819997217,-7.81856955425992,14.037886046379526,-14.4638191908774,-254189.7540025377,-397670.8271509445,48.0,4.0,44.0,15.299987999999985,669.5333253333333,674.9666746666667,680.8833613333334,686.3167106666667,663.6166386666666,658.1832893333333,652.2666026666666,0.4361230219886523,-8949185.0,+1
2013-12-30,676.799988,677.0,665.150024,669.650024,645.132996,1056901.0,667.5749940000001,664.9872692363635,-25.549987999999985,50.794039352961725,-7.721539156990718,9.956891076413172,-14.129139243397427,711574.0666327254,-347185.42962672503,44.0,0.0,44.0,18.15002400000003,670.600016,676.0500079999999,682.4499919999998,687.8999839999999,664.200032,658.75004,652.350056,0.3797476045521115,-7892284.0,+1
2013-12-31,672.099976,672.299988,660.099976,669.5,641.615784,1315328.0,665.5299928000001,665.3372703272728,-20.450012000000015,50.64232946706642,-5.389718076285241,4.955178961895967,-32.46791751323501,-181685.66355176715,-339653.4313919825,40.0,8.0,44.0,11.84997599999997,667.299988,674.5,679.5,686.700012,662.299988,655.099976,650.099976,0.7704930126298252,-9207612.0,-1
2014-01-01,668.0,669.799988,663.0,665.849976,640.941284,1123109.0,663.6799928,665.3954490909091,-18.5,46.72464023471778,-5.995028855721398,-0.181729016699137,-45.151414340552044,170500.11268296142,-316437.3253994987,36.0,4.0,32.0,12.200012000000015,666.2166546666666,669.4333093333332,673.0166426666665,676.2332973333332,662.6333213333332,659.4166666666666,655.8333333333333,0.41911485726150927,-10330721.0,-1
2014-01-02,665.0,674.75,653.549988,665.150024,633.0880129999999,1807248.0,664.4349975999999,665.6627274909091,7.550048000000061,45.93829790677694,-6.111107131011603,-3.8771524213307202,-64.92972824263505,-203537.0,-311299.72388494905,32.0,0.0,32.0,6.799987999999985,664.4833373333333,675.4166866666667,685.6833493333334,696.6166986666667,654.2166746666667,643.2833253333333,633.0166626666667,0.547171199714417,-12137969.0,-1
2014-01-03,652.0,666.0,650.0,657.0,638.965881,1628296.0,663.5099975999999,664.3109097454545,-9.25,37.4669492664014,-7.462686567164178,-7.734085991399866,-115.56965664767219,1540538.2398266515,-227034.95840641006,28.000000000000004,0.0,32.0,21.200012000000015,657.6666666666666,665.3333333333333,673.6666666666665,681.3333333333333,649.3333333333333,641.6666666666666,633.3333333333333,0.4375,-13766265.0,-1
2014-01-06,663.0,663.0,657.0,663.099976,637.616943,1490855.0,664.5649964,664.2363603636363,10.549987999999985,46.05758300301373,-4.696747233110445,-7.887222365720049,-91.00540649341686,-95073.41851092878,-221030.56376876734,24.0,52.0,28.000000000000004,16.0,661.0333253333333,665.0666506666666,667.0333253333333,671.0666506666666,659.0666506666666,655.0333253333333,653.0666506666666,1.0166626666666616,-12275410.0,+1
2014-01-07,667.099976,670.950012,653.299988,661.700012,640.2186280000001,1974230.0,664.275,663.7154541090908,-2.8999639999999545,44.440863333381756,-3.803743831703691,-9.291186027797153,-74.58861367631692,309413.32839713775,-196895.90901047766,20.0,48.0,-28.0,6.0,661.9833373333333,670.6666866666667,679.6333613333334,688.3167106666667,653.0166626666667,644.3333133333333,635.3666386666666,0.4759213925148213,-14249640.0,-1
2014-01-08,665.200012,666.950012,660.0,664.400024,640.507751,1162370.0,664.2700012,663.7381857454545,-0.04998799999998482,48.46637426973209,-3.3421638770733084,-8.24723946437689,-45.4624909487239,659480.3070744555,-157933.3979401375,16.0,44.0,-28.0,17.65002400000003,663.7833453333334,667.5666906666668,670.7333573333335,674.5167026666668,660.6166786666668,656.8333333333334,653.6666666666667,0.6330958853020715,-13087270.0,+1
2014-01-09,663.200012,666.049988,657.099976,664.700012,638.82135,944368.0,665.0100036,663.8163695272729,7.40002400000003,48.940645669407495,-3.2908794948447664,-8.795047618989088,-42.34700992905982,-426187.53089408687,-170137.62685021176,12.0,40.0,-28.0,6.950012000000015,662.6166586666667,668.1333413333334,671.5666706666666,677.0833533333334,659.1833293333334,653.6666466666667,650.2333173333334,0.8491648949744461,-12142902.0,+1
2014-01-10,662.950012,674.700012,656.299988,662.950012,637.9541019999999,1537627.0,664.400006,663.4418255999999,-6.09997599999997,46.08578263765814,-2.430793771626295,-9.73950629898195,-16.03058071522238,-577780.1482325126,-188682.5834765748,8.0,36.0,-28.0,8.950012000000015,664.650004,673.00002,683.0500279999999,691.400044,654.5999959999999,646.2499799999999,636.1999719999999,0.361413876416684,-13680529.0,-1
2014-01-13,660.099976,676.950012,656.900024,662.049988,648.361023,1188145.0,663.6400024,663.0145495999999,-7.6000360000000455,44.54384354598734,-2.586507266435989,-9.608024169779014,-1.1549459385419047,162591.92919698785,-172702.60455533932,4.0,32.0,-28.0,18.40002400000003,665.300008,673.6999920000001,685.3499959999999,693.74998,653.6500040000001,645.2500200000001,633.6000160000001,0.2568562135797766,-14868674.0,-1
2014-01-14,669.049988,676.0,668.299988,672.849976,647.8311160000001,894280.0,663.975,664.6890902545455,3.3499759999999696,62.10074893633957,-0.7179972318339153,-8.901611052586986,65.14198556184614,-680044.3818261252,-195781.45489429554,0.0,28.000000000000004,-28.0,20.049987999999985,672.3833213333334,676.4666546666667,680.0833333333333,684.1666666666667,668.7666426666667,664.6833093333333,661.0666306666667,0.5909066115741087,-13974394.0,+1
2014-01-15,673.0,682.700012,669.599976,672.299988,655.780762,1156960.0,664.6200011999999,666.2027244363637,6.450012000000015,60.96660529087825,-1.7817412688352026,-8.61670519401639,86.94982014713818,441667.56996438955,-166785.07924813882,12.0,24.0,-28.000000000000004,13.950012000000015,674.8666586666667,680.1333413333334,687.9666946666666,693.2333773333335,667.0333053333334,661.7666226666666,653.9332693333333,0.20610721985802222,-15131354.0,-1
2014-01-16,684.400024,685.0,670.349976,680.549988,648.553772,1125294.0,666.1599976,669.0990856727273,15.399963999999954,70.34154348332656,-0.7593877133105829,-7.2213321293697845,113.72207679683876,8192258.63751273,213439.5627251728,8.0,20.0,-12.0,13.100036000000046,678.6333213333334,686.9166666666667,693.2833453333333,701.5666906666668,672.2666426666667,663.9832973333333,657.6166186666667,0.6962454122942047,-14006060.0,+1
2014-01-17,675.0,675.0,659.049988,673.049988,640.796692,10843714.0,667.7649964000001,670.3518111999999,16.049987999999985,56.18628955444442,-2.0392511945392515,-5.431570071555484,26.362261882697887,-1780706.5021155453,122735.50845431002,4.0,16.0,-12.0,14.65002400000003,669.0333253333333,679.0166626666667,684.9833373333333,694.9666746666667,663.0666506666666,653.0833133333333,647.1166386666666,0.8777422863380909,-24849774.0,-1
2014-01-20,668.099976,676.700012,666.400024,665.0,645.663025,1400092.0,667.9549988000001,669.8490845818181,1.9000240000000304,44.97699909909455,-3.4129692832764507,-3.7347684587100503,24.190429416380308,-1545224.0907342199,46870.42063063376,0.0,12.0,-12.0,21.5,669.3666786666666,672.3333333333333,679.6666666666665,682.6333213333332,662.0333453333333,659.0666906666667,651.7333573333333,-0.1359248185531898,-26249866.0,-1
2014-01-21,672.950012,678.799988,670.0,670.049988,651.492676,1562981.0,668.7899964,670.2299917090909,8.34997599999997,51.920112135451184,-2.551196587030719,-0.6924751133913105,51.86984872908831,-1250970.2300197976,-12158.537730933991,0.0,8.0,-12.0,10.299987999999985,672.949992,675.8999839999999,681.74998,684.6999719999999,667.0999959999999,664.150004,658.3000079999999,0.005680462291537774,-24686885.0,+1
2014-01-22,675.5,684.700012,674.650024,676.099976,652.456421,1758334.0,669.9599916000001,671.5590789090909,11.69995199999994,59.06109875678724,-1.5187754266211657,1.5013079624451393,94.0496969200286,57450.08770803175,-8992.65597120393,84.0,4.0,-8.0,13.799987999999985,678.4833373333333,682.3166506666666,688.5333253333333,692.3666386666666,672.2666626666667,668.4333493333334,662.2166746666667,0.1442740031132317,-22928551.0,+1
2014-01-23,675.0,681.099976,672.75,677.099976,654.769043,1370685.0,671.199988,672.8572578909091,12.399963999999954,60.188798424385425,-1.348126962457343,3.7098339163641185,74.66135765339047,3998951.1726755495,173288.46729363565,80.0,0.0,80.0,14.65002400000003,676.9833173333333,681.2166346666666,685.3332933333331,689.5666106666665,672.8666586666666,668.6333413333333,664.5166826666666,0.5209567069414314,-21557866.0,+1
2014-01-24,670.0,674.950012,663.700012,679.5,648.891052,2210725.0,672.8549868,674.3663509818182,16.549987999999985,63.01042841455228,-0.938566552901024,4.065785410567287,39.268823771569714,8021937.060745952,530235.6164679589,76.0,40.0,80.0,8.34997599999997,672.7166746666667,681.7333373333333,683.9666746666667,692.9833373333333,670.4833373333333,661.4666746666667,659.2333373333333,1.4044433777777765,-19347141.0,+1
2014-01-27,664.900024,664.900024,645.599976,673.400024,625.571838,4265112.0,673.9899904,674.4654486545454,11.350036000000046,52.16732099996398,-1.9795180887371964,4.844434075389131,-69.8308205831421,1004359.1632453064,551797.6651517414,72.0,36.0,36.0,13.399963999999954,661.300008,677.0000400000001,680.6000560000002,696.3000880000002,657.6999920000001,641.99996,638.399944,1.4404134124433252,-23612253.0,-1
2014-01-28,648.0,656.0,638.599976,649.200012,620.994751,4598856.0,671.624994,669.9581798545455,-23.649963999999954,29.180781127917612,-6.1092129692832735,4.466223649435619,-203.91106946945342,-675739.7884633375,495973.3770396921,68.0,96.0,36.0,33.90002400000003,647.9333293333333,657.2666826666666,665.3333533333334,674.6667066666666,639.8666586666666,630.5333053333333,622.4666346666666,0.6091966309931542,-28211109.0,-1
2014-01-29,647.5,650.900024,640.549988,644.450012,621.958313,2742731.0,668.8399963999999,665.0172740363637,-27.84997599999997,26.53297074305911,-6.919793174061431,4.844968949446411,-192.4761507874546,5444575.852835911,721014.2537429886,64.0,96.0,-28.0,34.80004800000006,645.300008,650.0500280000001,655.6500440000002,660.4000640000002,639.6999920000001,634.949972,629.349956,0.3768126023909495,-30953840.0,-1
2014-01-30,637.5,639.900024,627.650024,645.450012,608.805054,2856365.0,665.3299988,660.7645496,-35.09997599999997,28.117382827234238,-6.7491447098976085,3.708393107854363,-218.3482546320132,472461.1065552456,709711.3781537984,60.0,92.0,-32.0,10.350036000000046,637.6666866666667,647.6833493333334,649.9166866666667,659.9333493333334,635.4333493333334,625.4166866666667,623.1833493333334,1.453060244897958,-28097475.0,+1
2014-01-31,630.0,636.299988,625.099976,631.799988,605.625183,2405246.0,661.2049988,654.668184,-41.25,20.98829275012777,-9.078500341296932,1.7195021487365238,-214.76705275647856,-281774.7276951113,664624.7696786838,56.00000000000001,96.0,-32.0,16.799987999999985,631.0666506666666,637.0333253333333,642.2666626666667,648.2333373333333,625.8333133333333,619.8666386666666,614.6333013333333,0.5982147161985188,-30502721.0,-1
2014-02-03,629.950012,634.0,625.099976,628.5,603.6979980000001,1194205.0,657.5549988,648.7218205818182,-36.5,19.60190610841626,-9.641638225255972,-0.9964118117900398,-176.22553075357206,69339.55057954117,637555.428461444,52.0,96.0,-39.99999999999999,20.350036000000046,629.199992,633.3000079999999,638.1000159999999,642.200032,624.3999839999999,620.2999679999999,615.4999599999999,0.3820241383618762,-31696926.0,-1
2014-02-04,621.650024,635.5,616.799988,626.5,607.648743,1852326.0,653.2,643.0754571636363,-43.549987999999985,18.73642132342721,-9.982935153583618,-2.9664615683750526,-159.42008104812774,-434523.51713400095,588805.7914683261,48.0,92.0,-44.0,8.90002400000003,626.2666626666667,635.7333373333333,644.9666746666667,654.4333493333334,617.0333253333333,607.5666506666666,598.3333133333333,0.5187168863848861,-33549252.0,-1
2014-02-05,631.0,639.799988,625.099976,630.599976,614.249451,1726346.0,648.65,638.9663618909092,-45.5,26.42090672841144,-9.28328054607509,-3.937436662057962,-112.10785840643818,-703489.8746481994,530043.4759144643,44.0,96.0,-44.0,18.700012000000015,631.8333133333333,638.5666506666666,646.5333253333333,653.2666626666667,623.8666386666666,617.1333013333333,609.1666266666666,0.37414935443590075,-31822906.0,+1
2014-02-06,638.75,649.599976,629.5,637.450012,623.451904,3366736.0,644.6850036000001,636.9300004363637,-39.649963999999954,37.76595442306737,-8.06726976812833,-5.838589659770037,-73.02230309227704,-211219.7543482144,496337.864397315,40.0,92.0,-52.0,14.700012000000015,638.849996,648.1999920000001,658.9499719999999,668.299968,628.1000160000001,618.7500200000001,608.0000400000001,0.39552345734144295,-28456170.0,+1
2014-02-07,652.400024,654.5,642.099976,647.0,624.174561,1007367.0,641.4350036000001,637.3509088727272,-32.5,50.13430186825521,-6.43674427652223,-8.627447348701025,-31.834873196439403,1037551.5310136521,520946.72906023444,36.0,88.0,-52.0,20.09997599999997,647.8666586666667,653.6333413333334,660.2666826666668,666.0333653333334,641.2333173333334,635.4666346666667,628.8332933333334,0.3951624609758835,-27448803.0,+1
2014-02-10,647.650024,650.150024,636.0,647.75,620.464783,1570205.0,638.8700011999999,638.4990900363637,-25.65002400000003,51.01644745681614,-6.3086923754408275,-12.350074162996975,-39.17104860159476,191964.60802269468,505988.21326013596,32.0,84.0,-52.0,17.049987999999985,644.6333413333333,653.2666826666666,658.7833653333332,667.4167066666666,639.1166586666666,630.4833173333333,624.9666346666666,0.8303872841487743,-25878598.0,+1
2014-02-11,646.0,647.150024,639.299988,643.900024,621.331909,1116214.0,638.3400023999999,639.4136396363637,-5.299987999999985,46.177877788948614,-6.9660213699978515,-16.487652157203456,-37.533437989403836,-1204742.6561066392,428203.9780122099,28.000000000000004,80.0,-52.0,14.15002400000003,643.450012,647.600036,651.3000480000001,655.4500720000001,639.75,635.599976,631.899964,0.5859891597949384,-26994812.0,-1
2014-02-12,646.599976,652.799988,643.650024,644.799988,621.958313,1609240.0,638.3749999999999,640.5881824727272,0.34997599999996964,47.52037240257038,-6.236040112807011,-20.23796911399154,-19.555751094597305,548629.1899223895,433679.44653073524,24.0,76.0,-52.0,8.450012000000015,647.0833333333334,650.5166426666667,656.2332973333332,659.6666066666667,641.3666786666668,637.9333693333334,632.2167146666668,0.12567962016024983,-25385572.0,+1
2014-02-13,646.0,648.0,631.25,645.450012,609.479614,788800.0,638.3750000000001,641.8745482909092,0.0,48.58908090155117,-5.1219722867199104,-20.71319336340889,-33.106746477575825,-600733.0076314438,386647.6189708827,20.0,72.0,-52.0,9.149963999999954,641.5666706666667,651.8833413333334,658.3166706666666,668.6333413333334,635.1333413333334,624.8166706666667,618.3833413333334,0.8477619104477621,-24596772.0,+1
2014-02-14,634.0,643.849976,629.349976,632.5,618.441101,1062278.0,638.4450012000001,640.8063664727273,0.7000120000000152,33.09612335236554,-5.7253971772229555,-20.901167545112685,-49.03529934900581,-795322.5607576622,332907.43578981893,16.0,68.0,-52.0,16.75,635.2333173333333,641.1166586666666,649.7333173333332,655.6166586666666,626.6166586666666,620.7333173333333,612.1166586666666,0.21724303448276072,-25659050.0,-1
2014-02-17,642.0,652.0,641.099976,641.799988,626.728149,912530.0,639.7750000000001,641.4163640727272,13.299987999999985,47.07867621807409,-2.5493737881508105,-21.171363930945972,-9.726506413527842,-812005.7647058824,280852.73629903,12.0,64.0,-52.0,16.100036000000046,644.9666546666666,648.8333333333333,655.8666786666668,659.7333573333333,637.9333093333332,634.0666306666666,627.0332853333332,0.06422114299931939,-24746520.0,+1
2014-02-18,648.5,664.400024,647.400024,650.400024,636.3642580000001,1254918.0,642.1650024000002,643.3481866181819,23.90002400000003,56.72820100064088,-2.4761229935851574,-19.381353586655337,26.787122433349335,-379607.53151443123,250824.55191905462,8.0,60.0,-52.0,19.5,654.0666906666667,660.7333573333333,671.0666906666665,677.7333573333333,643.7333573333333,637.0666906666667,626.7333573333333,0.17647058823529413,-23491602.0,+1
2014-02-19,656.200012,672.25,655.0,660.400024,645.663025,1015237.0,645.1450072000001,646.6636450909091,29.80004800000006,65.23340953084426,-2.067156737897945,-16.03156782928795,64.5674854448882,1541336.419178913,309497.7288428421,4.0,56.00000000000001,-52.0,22.600036000000046,662.550008,670.1000160000001,679.8000080000002,687.3500160000001,652.8500160000001,645.300008,635.6000160000001,0.31304486956521915,-22476365.0,+1
2014-02-20,665.799988,667.450012,660.849976,670.049988,638.628662,862109.0,648.4050048000001,651.1918234181819,32.59997599999997,71.47599053843484,-0.3837788050588775,-11.911216285603928,84.35103844835368,-292088.8670286076,282146.85578320676,0.0,52.0,-52.00000000000001,21.84997599999997,666.1166586666667,671.3833413333334,672.7166946666666,677.9833773333335,664.7833053333334,659.5166226666666,658.1832693333333,1.3939336088469747,-21614256.0,+1
2014-02-21,659.849976,669.599976,659.700012,662.75,640.2186280000001,760968.0,649.9800048,653.8000043636364,15.75,61.791530779615044,-1.6572176188399477,-7.691888160200847,81.73391461249744,3640.436394671083,269484.8093694839,12.0,48.0,-52.0,7.049987999999985,664.0166626666667,668.3333133333333,673.9166266666666,678.2332773333333,658.4333493333334,654.1166986666667,648.5333853333334,0.3080807162531095,-22375224.0,-1
2014-02-24,662.099976,673.0,655.75,664.400024,646.57843,1254746.0,651.6450072,656.4218260363637,16.65002400000003,63.09562535511713,-1.49825365853658,-4.559970027184136,88.20514081710091,0.0,257233.0396030723,8.0,44.0,-36.0,10.34997599999997,664.3833413333333,673.0166826666666,681.6333413333332,690.2666826666666,655.7666826666666,647.1333413333333,638.5166826666666,0.5014506666666684,-21120478.0,+1
2014-02-25,674.0,676.0,666.0,671.0,646.674744,1005140.0,654.3550048000001,659.9409156363637,27.09997599999997,68.11785916747404,-0.8665511265164645,-2.888129687690025,122.09847894793253,-592960.0596280394,218580.4898054724,4.0,40.0,-36.0,17.25,671.0,676.0,681.0,686.0,666.0,661.0,656.0,0.5,-20115338.0,+1
2014-02-26,670.0,679.200012,668.549988,671.099976,652.745544,1137835.0,656.9850036000001,662.9854558545454,26.299987999999985,68.19351389587104,-1.3960764964617143,-0.8616999213032841,126.21661246973468,466185.8028169014,229837.33639581176,0.0,36.0,-36.0,11.59997599999997,672.949992,677.3499959999999,683.6000160000001,688.00002,666.6999719999999,662.2999679999999,656.0499479999999,0.23943495338601842,-18977503.0,+1
2014-02-28,682.0,682.900024,665.150024,677.400024,645.229309,1225896.0,660.1800048000001,666.6972777454546,31.950012000000015,72.87381071875876,-0.9419420746590002,2.4175821369025243,123.33456066495222,417997.93630626955,238391.58494220072,0.0,32.0,-36.0,10.65002400000003,675.150024,685.150024,692.900024,702.900024,667.400024,657.400024,649.650024,0.6901408450704225,-17751607.0,+1
2014-03-03,665.200012,672.0,663.200012,669.599976,641.9530639999999,919608.0,663.8900024000001,668.4099997818182,37.09997599999997,60.215702947105136,-2.277795419306244,5.690699703392966,74.54870697609338,-956505.9926799745,184069.00246153137,96.0,28.000000000000004,-32.0,17.75,668.2666626666667,673.3333133333333,677.0666506666666,682.1333013333333,664.5333253333333,659.4666746666667,655.7333373333333,0.7272696280949434,-18671215.0,-1
2014-03-04,666.0,673.849976,664.25,666.200012,647.252869,1610967.0,666.3300048000001,668.8300015272728,24.40002400000003,55.37779174766216,-2.860080718201857,9.179932881160198,63.3490196924888,472826.0353523224,197196.41115753836,92.0,24.0,68.0,14.200012000000015,668.099996,671.9499920000001,677.6999719999999,681.549968,662.3500160000001,658.5000200000001,652.7500400000001,0.20312675781689676,-20282182.0,-1
2014-03-05,673.5,675.0,662.5,671.700012,645.3739009999999,1001746.0,668.4600036,669.8063664727273,21.299987999999985,61.196834706675304,-1.9181386435428567,14.533138631962856,59.853611645203856,-811888.2214566637,151321.9594914956,88.0,20.0,68.0,9.59997599999997,669.7333373333333,676.9666746666667,682.2333373333333,689.4666746666667,664.4666746666667,657.2333373333333,651.9666746666667,0.7360009600000013,-19280436.0,+1
2014-03-06,673.0,677.700012,668.099976,669.75,651.010864,1237170.0,669.3950012,670.0409112727273,9.34997599999997,58.09741889560765,-2.2521019797046677,17.428479185230003,58.054855173674596,-5868395.310030615,-122341.23288455307,84.0,16.0,68.0,12.5,671.849996,675.6000160000001,681.4500320000002,685.2000520000001,665.99998,662.24996,656.399944,0.17187685546179438,-20517606.0,-1
2014-03-07,679.599976,714.900024,676.200012,675.599976,685.556213,5691892.0,669.95,671.1690885090909,5.549987999999985,64.34774400832038,-6.380913536057934,19.23987762373781,114.7112081701659,-2477870.5292982985,-229425.567415647,80.0,12.0,68.0,9.600036000000046,688.9000040000001,701.5999960000001,727.6000160000001,740.3000080000002,662.8999840000001,650.1999920000001,624.1999720000001,-0.015504801393861203,-14825714.0,+1
2014-03-10,706.5,736.900024,700.0,711.450012,707.719116,6530963.0,674.8200012000001,678.7145452363636,48.700012000000015,82.64877163810438,-3.989655281781274,20.825625712261854,196.86213157528678,1486000.120892258,-151441.36966384275,96.0,8.0,68.0,45.15002400000003,716.1166786666666,732.2333573333333,753.0167026666668,769.1333813333333,695.3333333333333,679.2166546666666,658.4333093333332,0.3102982263642974,-8294751.0,+1
2014-03-11,734.5,740.0,719.549988,734.450012,698.757507,3250118.0,681.825,689.5563653818182,70.04998799999998,87.42657445015641,-0.86583276131045,20.999711419574965,198.0340254879437,86189.60742982473,-140638.5992862967,96.0,4.0,88.0,61.30004800000006,731.3333333333334,743.1166786666668,751.7833453333335,763.5666906666668,722.6666666666667,710.8833213333334,702.2166546666667,0.7286071030178378,-5044633.0,+1
2014-03-12,721.25,733.0,716.5,725.150024,699.142944,1777554.0,687.2400024,697.4336424727272,54.15002400000003,77.47357354264905,-2.3166889235569377,21.954226209935882,139.07417967106662,-3369490.6995778223,-287422.2732063564,96.0,0.0,92.0,28.549987999999985,724.8833413333333,733.2666826666666,741.3833413333332,749.7666826666666,716.7666826666666,708.3833413333333,700.2666826666666,0.5242438787878806,-6822187.0,-1
2014-03-13,727.5,749.5,727.5,725.549988,715.331604,2862113.0,692.6850036,704.3990944,54.450012000000015,77.600117885796,-3.681785088393546,22.820250181258643,137.91717038122323,3992690.592628011,-92849.33095132574,92.0,0.0,96.0,17.950012000000015,734.1833293333333,740.8666586666666,756.1833293333334,762.8666586666666,718.8666586666666,712.1833293333333,696.8666586666666,-0.08863690909090978,-3960074.0,+1
2014-03-14,735.0,739.900024,724.0,742.349976,705.502808,3052120.0,699.1799988,713.4290893818182,64.94995199999994,82.39365086022718,-1.0991581860107655,23.703025293901987,118.41556352383282,-1080354.3606647162,-137740.84701323838,96.0,24.0,92.0,24.34997599999997,735.4166666666666,746.8333333333333,751.3166906666665,762.7333573333333,730.9333093333332,719.5166426666666,715.0332853333332,1.1540847988657084,-907954.0,+1
2014-03-18,735.400024,744.799988,728.299988,732.150024,707.285461,2025681.0,705.4350036000001,719.4236394181819,62.55004800000006,71.65190676423377,-2.667175403535737,25.02583094311956,98.67583785325995,-2215539.287558074,-232196.11982853332,92.0,20.0,72.0,15.90002400000003,735.0833333333334,741.8666786666668,751.5833333333333,758.3666786666668,725.3666786666668,718.5833333333334,708.8666786666668,0.2333355151515179,-2933635.0,-1
2014-03-19,740.0,743.299988,735.75,734.0,711.573486,1513784.0,712.2150024,724.6172751272728,67.79998799999998,72.4047950701129,-2.382782475019216,26.39602240324598,88.86004633013503,1298771.0,-162599.74998647056,88.0,16.0,72.0,16.5,737.6833293333333,739.6166586666666,745.2333173333332,747.1666466666666,732.0666706666666,730.1333413333333,724.5166826666666,-0.2317884478756792,-1419851.0,+1
2014-03-20,738.450012,738.450012,728.0,738.450012,703.623779,1298771.0,718.8900024,729.3872768727273,66.75,74.2992955559924,-1.698691468101458,29.32702430982806,72.79778065289723,-2478668.344007006,-267885.6389294582,84.0,12.0,72.0,11.149963999999954,734.9666746666667,741.9333493333334,745.4166866666667,752.3833613333334,731.4833373333333,724.5166626666667,721.0333253333333,1.0,-121080.0,+1
2014-03-21,735.150024,737.5,731.200012,730.200012,707.1408690000001,1881398.0,724.9350036,731.4436422545455,60.450012000000015,64.78500773099816,-2.9669466564181377,32.72739177650794,61.04786227358081,-1097992.4773069993,-305621.20410870283,80.0,8.0,72.0,10.450012000000015,732.9666746666667,734.7333373333333,739.2666626666667,741.0333253333333,728.4333493333334,726.6666866666667,722.1333613333334,-0.1587304610738945,-2002478.0,-1
2014-03-25,750.0,760.549988,747.75,750.650024,722.847717,2007773.0,732.4400084,736.1191005090909,75.05004800000006,74.22509784502775,-1.4964801117946591,36.4171556210199,87.01725215960954,694230.7889170402,-260169.43557909943,76.0,4.0,72.0,7.25,752.9833373333335,758.2166746666669,765.7833253333333,771.0166626666669,745.4166866666669,740.1833493333335,732.6166986666669,0.22656458740430332,5295.0,+1
2014-03-26,752.799988,756.299988,744.099976,750.150024,718.896851,2352328.0,736.3100096,739.3391033454545,38.700012000000015,73.66797417067446,-1.5720601902573013,40.96323560831945,70.38584497135952,-1293599.3135838697,-307147.41866061714,96.0,0.0,60.0,0.0,750.1833293333333,756.2666826666666,762.3833413333332,768.4666946666666,744.0666706666666,737.9833173333333,731.8666586666666,0.4959050859950017,-2347033.0,-1
2014-03-27,750.0,760.75,742.0,746.049988,719.57135,6138733.0,737.4700071999999,741.1100085090909,11.59997599999997,68.78315491048681,-2.2213845107669083,44.3831167921976,59.554398995029295,1102334.142857143,-243075.00056647818,92.0,0.0,60.0,0.0,749.5999959999999,757.1999919999998,768.3499959999999,775.9499919999998,738.4499919999998,730.8499959999999,719.6999919999998,0.2159993599999992,-8485766.0,-1
2014-03-28,749.950012,754.099976,735.049988,746.75,717.836853,3040225.0,739.6300047999999,742.7972799272727,21.59997599999997,69.18567554168115,-2.1156025689459765,43.846527776894504,45.335644830370335,895321.3572687289,-191325.79944748394,96.0,0.0,72.0,0.0,745.2999880000001,755.5499880000002,764.3499760000002,774.5999760000002,736.5000000000002,726.2500000000001,717.4500120000002,0.6141742451491321,-5445541.0,+1
2014-03-31,747.950012,753.0,743.099976,744.950012,721.5468139999999,2065607.0,741.5700072,743.7645539636363,19.40002400000003,66.63636656115469,-2.387606800151112,40.68886164747164,41.31513202261253,-53225.53051505665,-185048.06148470932,92.0,0.0,96.0,12.200012000000015,747.0166626666665,750.9333493333331,756.9166866666665,760.8333733333332,741.0333253333331,737.1166386666665,731.1333013333331,0.1868718702096116,-7511148.0,-1
2014-04-01,751.5,753.549988,732.549988,748.799988,711.2362059999999,2012958.0,742.2150084,745.0790959272726,6.450012000000015,69.41746341139546,-1.8058197204382342,39.501507391076984,33.305723110185745,651965.9466551816,-146999.34935404427,88.0,8.0,92.0,18.75,744.9666546666667,757.3833213333335,765.9666546666667,778.3833213333335,736.3833213333335,723.9666546666667,715.3833213333335,0.7738095238095238,-5498190.0,+1
2014-04-02,744.950012,746.0,721.900024,738.099976,705.261841,2599688.0,742.8100036,744.3309082181818,5.949951999999939,54.77539479063461,-3.4227463543634347,38.66282082295379,15.19026829880454,-1384229.1888345222,-203240.7672319457,84.0,4.0,96.0,19.049987999999985,735.3333333333334,748.7666426666667,759.4333093333335,772.8666186666667,724.6666666666667,711.2333573333334,700.5666906666668,0.67219784783188,-8097878.0,-1
2014-04-03,736.0,738.0,726.25,731.900024,702.274719,1389926.0,742.600006,742.3472755636363,-2.0999759999999696,48.005571791608325,-4.35964880997355,34.86356439016015,5.858867104697039,-1812102.681488027,-276375.4443107644,80.0,0.0,92.0,9.90002400000003,732.050008,737.8500160000001,743.8000080000002,749.6000160000001,726.1000160000001,720.300008,714.3500160000001,0.4808531063829813,-9487804.0,-1
2014-04-04,725.549988,733.0,720.049988,728.799988,699.046692,1855602.0,741.6350035999999,739.8381813818182,-9.65002400000003,44.81038130955502,-4.828109104646773,32.359856571616206,-7.517911349070331,-140722.8955657449,-270209.0499450872,76.0,20.0,80.0,21.0,727.2833253333333,734.5166626666667,740.2333373333333,747.4666746666667,721.5666506666666,714.3333133333333,708.6166386666666,0.6756750495675209,-11343406.0,-1
2014-04-07,725.0,732.0,723.099976,725.450012,698.950195,2933289.0,741.1600036,736.8954556363636,-4.75,41.37652596543108,-5.334338949754437,29.851701418395805,-14.889586916754318,11949.183645749641,-257382.94221851032,72.0,16.0,80.0,26.899963999999954,726.8499959999999,730.6000159999999,735.75002,739.5000399999999,721.6999919999998,717.9499719999999,712.7999679999998,0.26404827672375236,-14276695.0,-1
2014-04-09,728.049988,744.900024,721.75,725.349976,714.8497309999999,2630096.0,738.6299988,734.0209051636364,-25.30004800000006,41.26756405241134,-5.349455836796378,26.619904350169236,-12.671567869872359,1961531.9840987625,-156517.66695447284,68.0,12.0,80.0,11.84997599999997,730.6666666666666,739.5833333333333,753.8166906666665,762.7333573333333,716.4333093333332,707.5166426666666,693.2832853333332,0.15550636146208596,-16906791.0,-1
2014-04-10,744.650024,748.650024,736.0,741.849976,712.488892,1873698.0,737.799994,734.6063555636364,-8.30004800000006,60.87589548642706,-2.856067094824334,25.241339307949033,11.745040574704802,-417330.037958829,-168373.39247388658,64.0,8.0,56.0,12.950012000000015,742.1666666666666,748.3333333333333,754.8166906666665,760.9833573333333,735.6833093333332,729.5166426666666,723.0332853333332,0.46244781828081555,-15033093.0,+1
2014-04-11,734.049988,744.799988,733.900024,739.400024,711.284363,1301988.0,737.1349976000001,734.8972701090909,-6.6499639999999545,57.582279106943204,-3.2262902908953484,20.40467369619273,4.079021833190576,5118657.73056687,71958.15737560675,60.0,4.0,56.0,8.90002400000003,739.3666786666666,744.8333333333333,750.2666426666665,755.7332973333332,733.9333693333333,728.4667146666667,723.0334053333333,0.5045888224951957,-16335081.0,-1
2014-04-15,734.299988,738.799988,718.099976,738.150024,697.601196,2092967.0,736.275,735.0818203636363,-8.59997599999997,55.804819647622004,-3.4151833774083826,15.122140037070494,-21.56614481363527,-271742.8054435516,56334.644594334444,56.00000000000001,0.0,56.0,23.15002400000003,731.6833293333333,745.2666826666666,752.3833413333332,765.9666946666666,724.5666706666666,710.9833173333333,703.8666586666666,0.9686007911493021,-18428048.0,-1
2014-04-16,723.200012,731.799988,721.099976,723.950012,699.528381,893098.0,734.1750000000001,732.8409134545456,-21.0,39.72973872348253,-5.561010653570077,10.112411371027747,-44.355905189214376,-3292653.2190500516,-95898.97542355325,52.0,0.0,56.0,23.30004800000006,725.6166586666667,730.1333413333334,736.3166706666666,740.8333533333334,719.4333293333334,714.9166466666667,708.7333173333334,0.26635820595341775,-19321146.0,-1
2014-04-17,716.25,721.299988,707.299988,725.950012,692.542297,3075582.0,731.8900024000001,731.3454610909091,-22.84997599999997,42.42502208343176,-5.258781715149223,4.634106398900485,-80.04934582609731,-2168042.74341206,-190091.40311032298,48.0,0.0,56.0,10.899963999999954,718.1833293333333,729.0666706666666,732.1833293333332,743.0666706666666,715.0666706666666,704.1833293333333,701.0666706666666,1.3321445714285736,-16245564.0,+1
2014-04-21,722.700012,726.5,713.0,718.700012,690.3742070000001,1746938.0,729.950006,728.9472810181818,-19.399963999999954,35.73988361116325,-6.354361616924818,-0.7292047821177903,-80.55632316194095,0.0,-181450.52798868594,44.0,0.0,56.00000000000001,21.30004800000006,719.4000040000001,725.8000080000002,732.9000040000001,739.3000080000002,712.3000080000002,705.9000040000001,698.8000080000002,0.4222231111111122,-17992502.0,-1
2014-04-22,721.900024,729.599976,717.400024,716.450012,701.07019,2848956.0,728.4050048000001,726.4927366545454,-15.450012000000015,33.83093286952045,-5.747208880984596,-4.774330303117154,-76.77040907806665,358410.2307692308,-156910.43534217487,40.0,92.0,52.0,17.05004800000006,721.1500040000001,724.8999840000001,733.349956,737.0999360000001,712.7000320000002,708.9500520000001,700.5000800000003,-0.07787014243990631,-20841458.0,-1
2014-04-23,724.900024,739.450012,722.599976,727.549988,706.321899,5256336.0,728.2800048,726.3372790545454,-1.25,49.2583603433129,-3.9721947103603035,-5.875561809798228,-31.339153696013682,420944.0450082237,-130643.33434040144,36.0,88.0,48.0,16.65002400000003,729.8666586666667,737.1333413333334,746.7166946666666,753.9833773333335,720.2833053333334,713.0166226666666,703.4332693333333,0.2937686305239942,-15585122.0,+1
2014-04-24,733.0,733.0,733.0,733.0,706.321899,0.0,729.0350036,727.1954599999999,7.549987999999985,55.17869581328769,-3.139559755060294,-6.645502291899106,-14.910763493360138,1151150.2298277367,-72377.89801170064,32.0,84.0,44.0,13.5,733.0,733.0,733.0,733.0,733.0,733.0,733.0,,-15585122.0,+1
2014-04-25,733.150024,738.0,725.0,733.0,699.962097,1553111.0,729.8000059999999,727.9163684363637,7.65002400000003,55.17869581328769,-2.408993061162425,-6.9870888423844235,-17.263474126887058,-1197677.899427956,-123529.65160204217,28.000000000000004,80.0,-52.0,12.19995199999994,732.0,739.0,745.0,752.0,726.0,719.0,713.0,0.6153846153846154,-15585122.0,-1
2014-04-28,722.25,729.25,720.549988,726.400024,698.805725,1220715.0,728.2550107999999,727.2981898909092,-15.44995199999994,46.442233151912276,-3.424920984840909,-5.9590737414229125,-66.32984046642099,-61617.625,-120715.37648417485,24.0,76.0,-52.0,23.0,725.4000040000001,730.2500200000002,734.1000160000001,738.9500320000002,721.5500080000002,716.6999920000001,712.8499960000001,0.6724170035627578,-16805837.0,-1
2014-04-29,726.400024,727.5,712.5,725.200012,689.7478639999999,1660309.0,726.8350096,726.7427355636364,-14.200012000000015,44.949173884722455,-3.609637671621176,-5.525994914074886,-83.45876291471446,-413678.6793661931,-134032.30620908807,20.0,72.0,-52.0,5.450012000000015,721.7333373333335,730.9666746666669,736.7333373333336,745.9666746666669,715.9666746666669,706.7333373333335,700.9666746666669,0.8466674666666677,-18466146.0,-1
2014-04-30,716.0,729.900024,711.650024,715.799988,695.0476070000001,2196730.0,724.6000060000001,724.7363680000001,-22.350036000000046,34.82885078495187,-5.056574276367616,-7.542354457860824,-90.05001361530577,-780421.969325701,-163414.53057711,16.0,68.0,-52.0,13.0,719.1166786666666,726.5833333333333,737.3666786666668,744.8333333333333,708.3333333333333,700.8666786666666,690.0833333333333,0.22739528767123038,-20662876.0,-1
2014-05-02,723.5,727.549988,715.549988,721.299988,691.000488,1478823.0,724.3350036,724.1363647272728,-2.6500240000000304,43.428005931931644,-4.209964594721549,-8.994369407278555,-58.518397083464144,206871.47770609392,-146582.86934977287,12.0,64.0,-52.0,12.450012000000015,721.4666546666667,727.3833213333335,733.4666546666667,739.3833213333335,715.3833213333335,709.4666546666667,703.3833213333335,0.4791666666666667,-19184053.0,+1
2014-05-05,719.849976,723.099976,714.0,717.099976,690.6151120000001,1298081.0,723.4499999999999,722.8209051636364,-8.850036000000046,38.90486549697557,-4.856468380581489,-11.061795604076792,-73.63598307997596,-1829982.8460181486,-223103.1289001044,8.0,60.0,-52.0,15.0,718.0666506666666,722.1333013333333,727.1666266666666,731.2332773333333,713.0333253333333,708.9666746666667,703.9333493333334,0.34065760173433207,-20482134.0,-1
2014-05-06,720.200012,724.599976,714.099976,716.700012,693.987732,1546140.0,723.25,721.5936346181818,-2.0,38.464665112294064,-4.3511886841348115,-10.015520694726092,-61.47188457269204,-4442112.891466603,-414881.27306338394,4.0,56.00000000000001,-52.0,18.25,718.4666546666667,722.8333333333335,728.9666546666667,733.3333333333335,712.3333333333335,707.9666546666667,701.8333333333335,0.24762247619048053,-22028274.0,-1
2014-05-07,718.5,727.0,711.450012,720.200012,689.555115,1649656.0,723.625,721.0390913454545,3.75,44.774020295060765,-3.005699061490532,-9.173331205848513,-46.165704826053044,-3889832.673010763,-572837.5193167626,0.0,52.0,-52.0,12.0,719.550008,727.6500040000001,735.0999960000001,743.1999920000001,712.1000160000001,704.0000200000001,696.5500280000001,0.5627013988692473,-20378618.0,+1
2014-05-08,717.150024,723.0,715.5,715.599976,692.1568599999999,1880107.0,722.4299988,719.5799960727275,-11.950012000000015,38.74895814696916,-3.723949653076132,-7.662634006051917,-53.692915035495,325685.66757669667,-531994.5912447269,0.0,48.0,-52.0,9.09997599999997,718.0333253333333,720.5666506666666,725.5333253333333,728.0666506666666,713.0666506666666,710.5333253333333,705.5666506666666,0.013330133333329285,-22258725.0,-1
2014-05-09,720.0,760.0,720.0,718.299988,729.255615,4094111.0,720.9599976,718.8290850181818,-14.700012000000015,43.86486448929601,-6.3086251134644495,-5.639306486861869,50.71166687532613,749834.8063512335,-473728.3044960882,4.0,44.0,-52.00000000000001,10.5,732.7666626666665,745.5333253333331,772.7666626666664,785.5333253333331,705.5333253333331,692.7666626666665,665.5333253333331,-0.04250030000000038,-18164614.0,+1
2014-05-12,755.099976,794.849976,754.5,756.799988,763.319031,4390340.0,723.3399964,725.3454469090909,23.799987999999985,76.35625549464645,-5.468130963907655,-4.202756452501603,332.9821614978146,-593991.885168449,-479194.9485800291,96.0,40.0,-52.0,15.549987999999985,768.7166546666667,782.9333093333335,809.0666306666667,823.2832853333334,742.5833333333335,728.3666786666668,702.2333573333335,0.05700097566352918,-13774274.0,+1
2014-05-13,800.0,800.0,782.5,792.150024,759.4646,3166304.0,729.9149964000001,737.8563610181818,65.75,85.34368320875333,-1.1198253922967147,-2.273830034734374,412.0412599907652,-8043721.3275047,-823044.122855824,96.0,36.0,-48.0,7.5,791.550008,800.6000160000001,809.0500080000002,818.1000160000001,783.1000160000001,774.050008,765.6000160000001,0.5514299428571446,-10607970.0,+1
2014-05-14,785.0,794.799988,774.25,788.150024,747.226868,2125375.0,736.2099976000001,748.4445478545455,62.950012000000015,81.308412525114,-1.690438801711836,-0.9305233515985947,266.8950069776778,-3273758.9060435523,-934442.4345566009,96.0,32.0,-40.0,44.40002400000003,785.7333373333335,797.2166746666669,806.2833253333333,817.7666626666669,776.6666866666669,765.1833493333335,756.1166986666669,0.6764005896256504,-12733345.0,-1
2014-05-15,769.0,791.150024,766.049988,775.450012,759.6572269999999,2366547.0,742.1750000000001,755.5790959272728,59.65002400000003,69.30374726382529,-3.502138088445076,0.8088556939146656,170.39442797554827,-198072.58731778592,-900970.4511214887,92.0,28.000000000000004,56.0,76.54998799999998,777.550008,789.0500280000001,802.6500440000002,814.1500640000002,763.9499920000001,752.449972,738.849956,0.37450241107223964,-15099892.0,-1
2014-05-16,800.0,854.0,787.650024,788.349976,775.4122309999999,8217092.0,748.8799988000001,763.9745461090909,67.04998799999998,73.83188195578626,-8.695367417218547,3.0725918745636136,241.2546475209345,1207736.8784917865,-805118.4047667456,88.0,24.0,60.0,43.200012000000015,810.0,832.349976,876.349976,898.6999519999999,766.0,743.650024,699.650024,0.010549393416509142,-6882800.0,+1
2014-05-19,815.900024,835.0,808.0,804.700012,782.35022,2630701.0,757.6400024000002,774.1236394181818,87.60003600000005,78.4754004262524,-6.529799735099336,7.187345618892891,195.6247142792706,688804.9411764706,-737211.6395852454,96.0,20.0,64.0,20.549987999999985,815.9000040000001,823.8000080000002,842.9000040000001,850.8000080000002,796.8000080000002,788.9000040000001,769.8000080000002,-0.12222177777777722,-4252099.0,+1
2014-05-20,816.0,821.599976,804.349976,811.900024,786.349121,1589258.0,767.1600036000001,783.9890978909091,95.20001200000002,80.25564643329228,-5.5761557615893995,11.19728332629927,146.49203204264458,2357989.8527999055,-596518.3714174209,92.0,16.0,64.0,25.100036000000046,812.6166586666667,820.8833413333334,829.8666586666668,838.1333413333334,803.6333413333334,795.3666586666667,786.3833413333334,0.437683942028989,-2662841.0,+1
2014-05-21,812.349976,814.5,805.0,816.049988,780.037537,910597.0,776.7450012,792.8781859636363,95.84997599999997,81.28506563210021,-5.026491655629141,17.465210992675566,118.57000880950552,-4565459.918650446,-776927.6098660262,88.0,12.0,64.0,78.54998799999998,811.8499959999999,818.6999919999998,821.3499959999999,828.1999919999998,809.1999919999998,802.3499959999999,799.6999919999998,1.1631566315789457,-1752244.0,+1
2014-05-22,812.0,815.0,798.0,809.5,773.388733,1951614.0,786.1350036000001,798.833640290909,93.90002400000003,74.23634931012312,-5.894039735099338,24.142486605960926,92.40393083073462,-401472.1970872825,-759861.201499397,84.0,8.0,76.0,46.65002400000003,807.5,817.0,824.5,834.0,800.0,790.5,783.0,0.6764705882352942,-3703858.0,-1
2014-05-23,799.0,803.0,782.700012,802.599976,760.910034,2454734.0,794.5650024000001,801.8272716363635,84.29998799999998,67.15766029707979,-6.807950198675501,30.77957251508974,60.62288710377934,-2166498.52048557,-823800.1670877852,80.0,4.0,76.0,17.25,796.0999959999999,809.4999799999998,816.3999839999999,829.7999679999998,789.1999919999998,775.8000079999999,768.9000039999999,0.9802943725878049,-6158592.0,-1
2014-05-26,799.0,804.049988,790.0,789.650024,768.137024,4348808.0,797.8500060000001,800.9336392,32.850036000000046,55.66361075065891,-8.52317562913907,37.55907463923484,50.34100658653651,1281961.3818875034,-728082.4389181323,76.0,0.0,76.0,9.5,794.5666706666667,799.1333413333334,808.6166586666668,813.1833293333334,785.0833533333334,780.5166826666667,771.0333653333334,-0.024909345118299748,-10507400.0,-1
2014-05-27,800.0,810.650024,788.349976,797.150024,775.60498,1904881.0,798.3500060000001,800.8063697454546,5.0,60.214002337585754,-7.52979814569536,45.035520800174595,49.16660599984951,5983489.789057217,-423007.0368076004,72.0,44.0,76.0,18.049987999999985,798.7166746666667,809.0833733333334,821.0167226666667,831.3834213333334,786.7833253333333,776.4166266666666,764.4832773333333,0.39462013714051364,-8602519.0,+1
2014-05-28,799.900024,826.75,799.5,804.900024,793.479858,3588891.0,800.025006,801.997282109091,16.75,64.55181506855044,-6.503308079470195,47.57446855642877,57.95378201667115,-2125849.7945096386,-500409.9338695882,68.0,40.0,76.0,26.799987999999985,810.3833413333333,821.2666826666666,837.6333413333332,848.5166826666666,794.0166826666666,783.1333413333333,766.7666826666666,0.19816601834862496,-5013628.0,+1
2014-05-29,822.599976,830.75,807.400024,823.450012,780.760254,3421002.0,804.825006,806.256374109091,48.0,72.75550367123836,-4.046356026490064,45.79139569542008,62.388493398598825,-199520.0291564349,-486732.9591901844,64.0,36.0,76.0,14.049987999999985,820.5333453333333,833.6666666666665,843.8833213333332,857.0166426666665,810.3166906666665,797.1833693333333,786.9667146666666,0.6873663596056804,-1592626.0,+1
2014-05-30,815.0,822.799988,730.0,810.25,763.897217,8201886.0,807.0150084,807.2427366545455,21.90002400000003,61.138175935936644,-5.7947019867549665,44.97374149133543,10.554968532639917,191280.74211186593,-455913.80865327915,60.0,32.0,28.0,22.30004800000006,787.6833293333333,845.3666586666666,880.4833173333332,938.1666466666666,752.5666706666666,694.8833413333333,659.7666826666666,0.8647630428572902,-9794512.0,-1
2014-06-02,793.5,822.349976,793.5,792.75,789.577271,2020783.0,805.8200072,804.6490987636364,-11.950012000000015,49.1361814687546,-8.112582781456954,45.94662942333605,26.49200132339488,2265031.363836611,-332233.1574695859,56.00000000000001,28.000000000000004,28.0,29.59997599999997,802.8666586666667,812.2333173333334,831.7166346666668,841.0832933333334,783.3833413333334,774.0166826666667,754.5333653333334,-0.02599655542174457,-11815295.0,-1
2014-06-03,823.0,827.849976,814.0,819.400024,794.347046,906037.0,806.5700072000001,807.1181927272728,7.5,62.181455754544245,-4.582778278145691,45.97454104666372,47.04301480979407,-1465928.875417196,-383765.30805062735,52.0,24.0,28.0,25.84997599999997,820.4166666666666,826.8333333333333,834.2666426666665,840.6833093333332,812.9833573333333,806.5666906666667,799.1333813333333,0.38989410523166557,-10909258.0,+1
2014-06-04,822.400024,829.700012,815.099976,824.349976,786.975525,716085.0,807.4000060000001,810.3509143272727,8.299987999999985,64.15188939942065,-3.927155496688746,43.533375814002284,44.79987583093587,-2257147.3333333335,-468919.8677924328,48.0,20.0,28.0,93.45001200000002,823.0499880000001,831.0000000000002,837.650024,845.6000360000003,816.3999640000002,808.449952,801.7999280000001,0.6335600816326734,-10193173.0,+1
2014-06-05,811.799988,815.400024,801.0,816.700012,782.699768,1918618.0,808.1200072,812.0418245090909,7.200012000000015,58.69822641571276,-4.940395761589402,39.75002852931266,19.253964614532663,487073.7119042041,-425465.2092275018,44.0,16.0,28.000000000000004,28.84997599999997,811.0333453333333,821.0666906666665,825.4333693333333,835.4667146666666,806.6666666666665,796.6333213333332,792.2666426666665,1.09027679398312,-12111791.0,-1
2014-06-06,813.0,821.0,801.0,805.450012,792.222961,2641319.0,808.4050108,811.5563708363635,2.8500360000000455,51.29836768514251,-4.014944021739129,34.326093369481896,11.283620615347562,-638806.1759925474,-435162.61215853394,40.0,12.0,28.0,35.09997599999997,809.1500040000001,817.3000080000002,829.1500040000001,837.3000080000002,797.3000080000002,789.1500040000001,777.3000080000002,0.22250060000000077,-14753110.0,-1
2014-06-09,821.900024,830.0,815.0,815.25,796.304443,2334980.0,810.9650084,812.8009143272727,25.59997599999997,56.77545660987868,-2.118209771096686,30.14971658312595,29.863835449101494,-1665872.3810732083,-491104.4402835127,36.0,8.0,28.0,14.600036000000046,820.0833333333334,825.1666666666667,835.0833333333335,840.1666666666667,810.1666666666667,805.0833333333334,795.1666666666667,0.016666666666666666,-12418130.0,+1
2014-06-10,821.150024,823.599976,810.0,819.450012,793.583496,1249836.0,813.1950072,814.3436422545454,22.299987999999985,59.05267510802294,-1.544241612572598,26.635063355557804,25.02306482875753,-996852.1850663141,-514093.1604581448,32.0,4.0,28.0,23.34997599999997,817.6833293333333,825.3666586666666,831.2833053333334,838.9666346666666,811.7666826666666,804.0833533333333,798.1667066666666,0.6948550497442081,-11168294.0,+1
2014-06-11,817.0,829.849976,810.0,816.650024,797.324646,1935943.0,814.3700072,814.9718271272727,11.75,56.75274465396022,-1.9268843184147548,24.799948222910302,27.010138804681798,-244246.8337728002,-501827.3234417001,28.000000000000004,0.0,28.0,20.0,818.8333333333334,827.6666666666667,838.6833093333335,847.5166426666667,807.8166906666668,798.9833573333334,787.9667146666668,0.3350142085814129,-13104237.0,-1
2014-06-12,824.5,844.9500119999999,812.849976,820.5,816.128113,3183012.0,814.075006,816.0863712727273,-2.950012000000015,59.269519802719714,-3.2777011336786335,22.299907143258224,44.32557473145212,150679.09486856518,-472167.721760404,24.0,0.0,28.0,24.549987999999985,826.0999959999999,839.3500159999999,858.2000319999997,871.4500519999998,807.2499799999999,793.99996,775.149944,0.23831823740010905,-9921225.0,+1
2014-06-13,844.0,856.0,831.650024,839.849976,811.803833,3053221.0,817.0350036,820.7727294545454,29.59997599999997,69.54699319759604,-2.133424570673716,18.928327341191675,92.90767906846969,768224.071394547,-415785.87917311874,20.0,0.0,28.0,13.59997599999997,842.5,853.349976,866.849976,877.6999519999999,829.0,818.150024,804.650024,0.33675400747828044,-6868004.0,+1
2014-06-16,831.0,842.7999880000001,830.299988,835.400024,815.302124,1327470.0,821.3000060000002,824.1118240727274,42.65002400000003,65.18262408569012,-2.721264993394976,12.950786293900364,70.50635105764611,502016.6181449061,-374067.30312740867,96.0,56.00000000000001,28.000000000000004,19.84997599999997,836.1666666666666,842.0333453333333,848.6666666666667,854.5333453333334,829.5333453333332,823.6666666666665,817.033345333333,0.40800287999999996,-8195474.0,-1
2014-06-17,836.0,848.7999880000001,827.349976,839.0,822.638916,1747030.0,823.2600036000001,827.3300048,19.59997599999997,67.10929894860234,-2.2457067371202113,11.135278624088755,75.62311127104535,23951.132562970994,-355975.4398487152,92.0,52.0,24.0,32.10003599999993,838.3833213333334,849.4166666666667,859.8333333333335,870.8666786666669,827.9666546666666,816.9333093333332,806.5166426666665,0.5431243581588654,-6448444.0,+1
2014-06-18,847.099976,851.400024,828.75,846.5499880000001,811.269348,1343657.0,825.4800048000001,831.5645474181817,22.20001200000013,70.99350461241765,-1.2483503302509777,14.282483897077668,87.62658839129965,266089.1235669412,-327699.60451809654,88.0,48.0,20.0,35.5,842.2333373333335,855.7166746666669,864.8833613333336,878.3666986666669,833.0666506666669,819.5833133333334,810.4166266666668,0.7858706021680186,-5104787.0,+1
2014-06-19,837.099976,839.9500119999999,822.200012,834.849976,802.426453,1180249.0,827.2950012000001,833.2681785454545,18.149963999999954,58.61599715122145,-2.7939265521796606,13.452695060293536,53.604409467441755,-2426880.8003427046,-423117.49001052434,84.0,44.0,39.99999999999999,12.500000000000114,832.3333333333334,842.4666546666667,850.0833333333333,860.2166546666666,824.7166546666668,814.5833333333335,806.966654666667,0.712674028169016,-6285036.0,-1
2014-06-20,826.0,831.75,819.349976,825.75,798.7337650000001,742442.0,829.3250000000002,832.9872692363637,20.299987999999985,50.68550396105368,-3.9960369881109647,10.898729427959324,23.480131565682633,279290.0447693563,-391189.69643692847,80.0,40.0,40.0,21.45001200000013,825.6166586666667,831.8833413333334,838.0166826666668,844.2833653333334,819.4833173333334,813.2166346666667,807.0832933333334,0.5161299687807067,-7027478.0,-1
2014-06-23,824.0,826.549988,815.299988,821.950012,798.2478639999999,1460211.0,829.9950012000002,831.6463623272726,6.700012000000015,47.58358073705507,-4.498016908850724,10.051618606230363,3.7265404924162127,3933380.601844055,-194617.27105519842,76.0,36.0,40.0,22.65002400000003,821.2666626666665,827.2333373333331,832.5166626666667,838.4833373333331,815.9833373333331,810.0166626666665,804.7333373333331,0.5911132444444471,-8487689.0,-1
2014-06-24,825.349976,832.75,825.0,821.450012,805.584595,1266556.0,830.1950012000001,830.0927279272728,2.0,47.14553093119258,-4.5640671070013195,11.849464574545323,19.85411381718979,-1800028.2855599902,-267590.8704186323,72.0,32.0,40.0,24.349976000000083,826.4000040000001,827.8000080000002,834.1500040000001,835.5500080000002,820.0500080000002,818.6500040000001,812.3000080000002,-0.4580629677419335,-9754245.0,-1
2014-06-25,829.0,833.200012,823.0,829.0,800.8229980000001,1582656.0,831.4299988,829.8754549818182,12.34997599999997,54.45130843377538,-3.5667107001321003,13.104844927990825,27.361904322218436,-2436668.185024866,-366185.7728411567,68.0,28.000000000000004,40.0,15.5,828.4000040000001,833.8000080000002,838.6000160000001,844.0000200000002,823.5999960000001,818.1999920000001,813.3999840000001,0.5882346020769379,-8171589.0,+1
2014-06-26,820.0,826.599976,808.650024,824.099976,789.453552,5452066.0,831.7899964,828.5427235636363,3.5999759999999696,49.34371389966991,-4.214005812417441,14.040711075375384,-13.078761232776182,22122.193991164848,-348535.328854306,64.0,24.0,40.0,11.25,819.7833253333333,830.9166266666666,837.7332773333333,848.8665786666666,812.9666746666667,801.8333733333334,795.0167226666667,0.8607238615457017,-13623655.0,-1
2014-06-27,817.849976,822.0,814.0,812.400024,793.146179,1285740.0,829.0450012,825.0172740363636,-27.44995199999994,39.210554821721836,-5.7595741083223215,14.759728527196216,-38.224069425453024,-2415132.0400208523,-442471.95884915575,60.0,20.0,40.0,10.799987999999985,816.1333413333333,818.2666826666666,824.1333413333332,826.2666826666666,810.2666826666666,808.1333413333333,802.2666826666666,-0.1999969999999962,-14909395.0,-1
2014-06-30,819.900024,832.700012,819.900024,816.200012,798.3450320000001,1544025.0,827.125,822.6818214545455,-19.200012000000015,43.55453777474531,-5.257594187582561,14.675137631533516,-10.144478252374897,342260.2839008271,-406802.16072134156,56.00000000000001,16.0,40.0,11.75,822.9333493333334,825.9666746666667,835.7333373333333,838.7666626666667,813.1666866666667,810.1333613333334,800.3666986666667,-0.28906370849722823,-13365370.0,+1
2014-07-01,823.0,827.950012,815.0,821.549988,800.045532,1910343.0,825.3799988000001,821.668182909091,-17.450012000000015,49.425497090996814,-4.550860237780715,11.17631690723124,-18.63872344961285,-1207275.1397928265,-443187.4428983988,52.0,12.0,40.0,20.34997599999997,821.5,828.0,834.450012,840.950012,815.049988,808.549988,802.099976,0.5057901104647607,-11455027.0,+1
2014-07-02,830.799988,842.0,825.5,823.299988,816.176697,1906681.0,823.0549988000001,821.2899991272727,-23.250000000000114,51.33589104313623,-4.319684544253635,8.5997104178997,27.50281790858155,1370329.5230445734,-360754.5361474254,48.0,8.0,40.0,10.09997599999997,830.2666626666665,835.0333253333331,846.7666626666664,851.5333253333331,818.5333253333331,813.7666626666665,802.0333253333331,-0.13333406060606154,-9548346.0,+1
2014-07-03,841.0,845.2999880000001,831.349976,839.900024,813.164307,1515685.0,823.5600036000001,824.3527309818181,5.050048000000061,65.57039273720983,-2.126813210039626,6.259218590717296,72.15131204486435,745065.3287065831,-310489.81209949293,44.0,4.0,40.00000000000001,20.299987999999985,838.849996,846.3500160000001,852.8000080000002,860.3000280000002,832.400004,824.8999839999999,818.4499919999998,0.6129061394355777,-8032661.0,+1
2014-07-04,836.799988,858.9500119999999,835.099976,836.799988,832.453552,1407997.0,824.6650023999999,826.7600008727272,11.049987999999985,61.6826111658199,-2.9146685505940777,3.7809091248145705,101.98049949486835,485831.6696303935,-274293.2541265933,40.0,0.0,40.0,12.950012000000015,843.6166586666665,852.133341333333,867.4666946666664,875.9833773333329,828.283305333333,819.7666226666665,804.4332693333331,0.07127922154918424,-9440658.0,-1
2014-07-07,859.900024,860.7000119999999,835.849976,856.650024,816.711182,2032992.0,828.1350036,832.5754593454544,34.700012000000015,73.35486017156498,-0.53170381202513,2.434706752690886,149.89132962406856,24125.201531074832,-260728.73344527523,96.0,0.0,40.0,20.450012000000015,851.0666706666666,866.2833653333332,875.9167066666664,891.1334013333332,841.4333293333333,826.2166346666667,816.5832933333334,0.8370228517978854,-7407666.0,+1
2014-07-08,844.0,848.349976,820.0,840.4500119999999,805.827576,1683068.0,830.0350036000001,834.8145517818182,18.999999999999886,57.003259522583726,-2.658526937242585,0.8230600194510771,38.738834871151724,654874.4656800294,-219110.27317758903,96.0,8.0,40.0,22.000000000000114,836.2666626666665,852.5333253333331,864.6166386666664,880.8833013333331,824.1833493333331,807.9166866666666,795.8333733333332,0.7213414219468801,-9090734.0,-1
2014-07-09,828.0,834.849976,818.0,829.25,806.8479,1448888.0,830.0600036000001,834.6718238545454,0.25,48.39722813411327,-4.128923658202582,1.120852244225489,-34.562093224658035,-339921.73676402855,-224601.72009630175,92.0,4.0,40.0,23.850035999999932,827.3666586666667,836.7333173333334,844.2166346666668,853.5832933333334,819.8833413333334,810.5166826666667,803.0333653333334,0.6676567373152353,-10539622.0,-1
2014-07-10,830.299988,848.0,812.25,830.299988,800.094177,2464386.0,830.6800048000001,834.7154573818182,6.200012000000015,49.22641951777482,-3.991075688731894,1.8836393121192714,-13.289912891353891,-1287744.245903,-272926.52110825997,88.0,0.0,96.0,24.850035999999932,830.1833293333333,848.1166586666666,865.9333293333334,883.8666586666666,812.3666586666666,794.4333293333333,776.6166586666666,0.5048947692307688,-8075236.0,+1
2014-07-11,821.099976,831.450012,808.799988,823.349976,788.870361,2299695.0,831.7750000000001,833.3827248727272,10.94995199999994,43.84550655345366,-4.903509966073092,0.9854225327923132,-94.74723590207928,-325855.9656380257,-275332.4116392678,84.0,0.0,88.0,36.65002400000003,821.199992,833.5999959999999,843.8500160000001,856.25002,810.9499719999999,798.5499679999999,788.2999479999999,0.6423828954883212,-10374931.0,-1
2014-07-14,815.0,820.0,807.150024,811.799988,794.360901,1230402.0,831.3349976000002,829.7509045090909,-4.40002400000003,36.247789277493425,-6.419853384484379,-0.27547501555750387,-152.83908530458962,397823.6842105263,-244734.32608177373,80.0,52.0,88.0,22.4500119999999,812.9833373333335,818.8166506666669,825.8333133333335,831.6666266666668,805.9666746666669,800.1333613333335,793.1166986666669,0.36186557858162266,-11605333.0,-1
2014-07-15,820.75,828.799988,816.5,817.450012,803.446655,1523009.0,830.9250000000001,827.2263616727272,-4.09997599999997,41.9277264545964,-5.678088396826741,0.8396435583988477,-63.208365866387474,590952.9477121185,-206748.44468513463,76.0,96.0,88.0,35.75,820.9166666666666,825.3333333333333,833.2166546666667,837.6333213333332,813.0333453333333,808.6166786666666,800.7333573333333,0.07723682332047936,-10082324.0,+1
2014-07-16,829.5,838.5,817.900024,826.799988,812.143921,2397325.0,831.2750000000001,826.4763594909091,3.5,50.370685286101875,-4.450574171712094,2.053181632923838,-0.06182155769631024,-825340.2237303724,-234866.32081295017,72.0,92.0,84.0,22.65002400000003,827.7333373333335,837.5666506666669,848.3333133333335,858.1666266666668,816.9666746666669,807.1333613333335,796.3666986666669,0.4320375907234051,-7684999.0,+1
2014-07-17,838.700012,839.0,829.5,835.75,808.305481,1259775.0,830.8599976000002,827.2899958545454,-4.15002400000003,57.23742682597033,-3.2755693326679247,2.6983634987465166,58.20924245371128,-1642372.7529107912,-298844.0335754899,68.0,88.0,28.0,16.19995199999994,834.75,840.0,844.25,849.5,830.5,825.25,821.0,0.6578947368421053,-6425224.0,+1
2014-07-18,828.900024,836.799988,822.0,831.799988,808.937195,1822108.0,830.3599976000002,827.4609031999998,-5.0,53.46999606929279,-3.7941477674546658,3.345195446302796,17.969686984193782,-58883.30982241191,-287936.70391943346,64.0,84.0,-20.0,17.0,830.199992,838.3999839999999,844.99998,853.1999719999999,823.5999959999999,815.400004,808.8000079999999,0.6621618882393685,-8247332.0,-1
2014-07-21,841.7000119999999,846.9500119999999,825.25,832.450012,804.0783690000001,2453414.0,827.9399964000002,827.8409058181819,-24.200012000000015,54.044354410715194,-3.7088091840544553,2.9469347485631943,52.0146564521525,-427862.33378182113,-294296.9731982,60.0,80.0,-20.0,21.049987999999985,834.8833413333332,844.5166826666664,856.583353333333,866.2166946666663,822.8166706666665,813.1833293333333,801.1166586666666,0.3317976045358891,-5793918.0,+1
2014-07-22,829.900024,842.650024,827.0,827.450012,816.128113,1742588.0,826.6399964000002,827.7518177454546,-12.999999999999886,48.70806650160913,-4.365235588311884,2.514876836246458,27.399338812310493,93708.61186285477,-276660.3202906944,56.00000000000001,76.0,-20.0,12.200012000000015,832.3666786666666,837.7333573333333,848.0167026666668,853.3833813333333,822.0833333333333,816.7166546666666,806.4333093333332,0.02875471628669798,-7536506.0,-1
2014-07-23,843.099976,845.0,835.0,839.849976,812.678406,1962463.0,827.6999940000002,830.1536322181819,10.59997599999997,60.00768520300747,-2.737302832023578,-0.2776209615847165,86.88717404150357,263387.8318228695,-252112.62997442338,52.0,72.0,-20.0,14.799987999999985,839.949992,844.8999839999999,849.9499919999998,854.8999839999999,834.8999839999999,829.949992,824.8999839999999,0.484997599999997,-5574043.0,+1
2014-07-24,836.0,844.0,833.0,836.299988,818.460388,1069650.0,828.2999940000002,831.7172674909091,6.0,55.93699355336823,-3.20336400362298,-0.6497791098311154,61.906840562737976,-751061.2167004378,-274792.15267244325,48.0,68.0,-20.0,21.7000119999999,837.7666626666665,842.5333253333331,848.7666626666664,853.5333253333331,831.5333253333331,826.7666626666665,820.5333253333331,0.2999989090909077,-6643693.0,-1
2014-07-25,841.0,849.7999880000001,834.150024,842.25,811.901001,2666488.0,830.1899964,834.2536322181817,18.90002400000003,61.04720448332032,-2.422215007133268,-0.08855455791501754,94.55811961912693,2398601.8447786206,-153274.03153128643,44.0,64.0,-19.999999999999993,15.65002400000003,842.0666706666667,849.9833173333334,857.7166346666668,865.6332813333335,834.3333533333333,826.4167066666666,818.6833893333333,0.5175715420176005,-3977205.0,+1
2014-07-28,838.5,839.7999880000001,828.0,835.5,806.1190190000001,971238.0,832.5599976000001,835.2190874181819,23.700012000000015,53.001136129986115,-1.904633488086856,-0.3792832936941295,20.880220548351684,3046879.749869435,-7812.25358636046,40.0,60.0,-20.0,17.549987999999985,834.4333293333334,840.8666586666668,846.2333173333336,852.6666466666669,829.0666706666667,822.6333413333333,817.2666826666666,0.6355938667056219,-4948443.0,-1
2014-07-30,831.0,841.900024,826.849976,829.549988,815.107849,1171345.0,833.7699952000002,834.6718129454546,12.09997599999997,46.73598804534126,-2.6971231118346943,-0.07858819291163854,-2.3131860040127203,129801.19836877799,-1557.0867283003427,36.0,56.00000000000001,-20.0,11.0,832.7666626666665,838.6833493333331,847.8167106666665,853.7333973333332,823.6333013333331,817.7166146666665,808.583253333333,0.17940221851784155,-6119788.0,-1
2014-07-31,837.900024,839.900024,828.549988,838.799988,810.443359,2975336.0,834.9699951999999,835.586357090909,12.0,56.05424866883062,-1.4651039126015692,2.136422214966842,28.05616398803397,-800233.5929946796,-37860.61941404805,32.0,52.0,-20.0,15.649964000000068,835.75,842.950012,847.100036,854.3000480000001,831.599976,824.399964,820.2499399999999,0.9030808360431596,-3144452.0,+1
2014-08-01,826.049988,827.799988,812.0,834.0,792.417419,1707115.0,834.7949952,835.4099943272728,-1.75,50.73938086290433,-2.1044203852597954,4.142144809488059,-88.16831747767343,935431.5160509719,6379.996325243413,28.000000000000004,48.0,-20.0,14.25,824.5999959999999,837.1999919999998,840.3999839999999,852.9999799999998,821.4000039999999,808.8000079999999,805.6000159999999,1.3924061208147767,-4851567.0,-1
2014-08-04,819.0,822.700012,807.099976,815.450012,790.036499,1840761.0,833.1599976,831.8927246545454,-16.34997599999997,35.661631315493125,-4.575116748669964,4.217212106791521,-180.87927177790198,-983435.0,-38611.65666833647,24.0,44.0,-20.000000000000007,15.05004800000006,815.0833333333334,823.0666906666668,830.6833693333333,838.6667266666668,807.4666546666667,799.4832973333333,791.8666186666667,0.5352574827391438,-6692328.0,-1
2014-08-05,817.0,823.0,809.900024,813.0,797.033142,1519276.0,831.2149964,828.2272705454545,-19.450012000000015,34.116626192312424,-4.901436945680944,2.2164112618586387,-158.87919783240514,2939530.5958130644,96758.62450502235,20.0,96.0,-20.0,11.350036000000046,815.300008,820.6999920000001,828.3999840000001,833.799968,807.6000160000001,802.2000320000001,794.5000400000001,0.23663982285158208,-8211604.0,-1
2014-08-06,815.049988,819.549988,807.349976,820.200012,787.121216,845350.0,830.4899964000001,826.224546109091,-7.25,42.55559478621049,-3.942458240955656,1.055713296918384,-132.30090663188645,-239539.5793198023,81472.32324156664,16.0,92.0,-19.999999999999996,26.799987999999985,815.699992,824.0500079999999,827.9000040000001,836.25002,811.8499959999999,803.4999799999999,799.6499839999999,1.0532806033305566,-7366254.0,+1
2014-08-07,812.900024,818.5,810.0,810.0,788.5788570000001,983435.0,827.5049988000001,822.4990922181818,-29.84997599999997,35.188031414691,-5.301010740026822,-0.19845887020107966,-135.56581367286068,-1460677.1625192696,11374.534988082405,12.0,88.0,-20.0,26.90002400000003,812.8333333333334,815.6666666666667,821.3333333333335,824.1666666666667,807.1666666666667,804.3333333333334,798.6666666666667,0.0,-8349689.0,-1
2014-08-08,805.0,807.799988,795.0,811.5,773.662537,1862670.0,825.025,819.5890924363636,-24.799987999999985,37.03766839846509,-5.101223842853883,-0.69961189547098,-183.84389952312816,-598460.638401171,-16345.277462112317,8.0,84.0,-76.0,13.09997599999997,804.7666626666665,814.5333253333331,817.5666506666666,827.3333133333331,801.7333373333331,791.9666746666666,788.9333493333331,1.2890637084972283,-6487019.0,+1
2014-08-11,801.0,802.849976,791.400024,796.150024,770.5528559999999,1406556.0,820.4150023999999,814.3390968000001,-46.09997599999997,27.702621493112716,-7.145706560666603,-2.371407500092573,-205.010563202536,-3259462.76296045,-163759.87025842522,4.0,96.0,-76.0,12.200012000000015,796.800008,802.1999920000001,808.2499600000001,813.649944,790.7500400000001,785.3500560000001,779.3000880000002,0.4148489006766164,-7893575.0,-1
2014-08-12,801.0,808.5,792.0,792.950012,784.4003299999999,1650768.0,816.1600036000001,809.3454621818181,-42.549987999999985,26.119103699098943,-7.571920206264052,-4.044639225833407,-163.91923179971675,-722472.443545434,-189155.92289747397,0.0,96.0,-76.0,10.200012000000015,797.8166706666667,803.6333413333334,814.3166706666666,820.1333413333334,787.1333413333334,781.3166706666667,770.6333413333334,0.057576484848485765,-9544343.0,-1
2014-08-13,810.0,815.75,802.650024,807.200012,789.453552,1959955.0,813.9250059999999,807.7163728,-22.34997599999997,42.89206367009459,-5.673944683121129,-5.177742749834351,-81.31471924934378,640479.6449657626,-151445.17759179018,52.0,92.0,-76.0,15.0,808.5333453333333,814.4166666666665,821.6333213333332,827.5166426666665,801.3166906666665,795.4333693333333,788.2167146666666,0.3473279645703164,-7584388.0,+1
2014-08-14,814.099976,831.650024,813.299988,812.400024,803.349609,2968306.0,811.2850096000001,807.4391033454546,-26.399963999999954,47.87474524416245,-4.981348507959761,-6.462210637202361,-21.67657478454996,-892082.3537877301,-185110.5358876265,48.0,88.0,-92.0,20.09997599999997,819.1166786666666,824.9333693333333,837.4667146666668,843.2834053333333,806.5833333333333,800.7666426666666,788.2332973333332,-0.049044263455393346,-4616082.0,+1
2014-08-18,830.0,834.5,823.599976,826.700012,808.839966,1675542.0,810.5550108,810.2418310545454,-7.299987999999985,59.176709073512555,-3.07671501987292,-7.419561343331452,28.20283477689367,-1698880.220264606,-253918.311450006,44.0,84.0,-96.0,16.5,828.2666626666665,832.9333493333331,839.1666866666665,843.8333733333332,822.0333253333331,817.3666386666665,811.1333013333331,0.2844063462612593,-2940540.0,+1
2014-08-19,833.0,837.5,822.25,832.349976,800.580017,1973214.0,812.2450072000001,814.204552,16.899963999999954,62.84897741867863,-1.2855091790924562,-9.594039969364985,42.15363621910824,-1427297.2186748462,-307253.76266857,40.0,80.0,-40.0,22.799987999999985,830.699992,839.1499839999999,845.9499919999998,854.3999839999999,823.8999839999999,815.449992,808.6499839999999,0.6622935081967193,-967326.0,+1
2014-08-20,829.0,834.599976,819.0,823.849976,797.37323,2358713.0,813.3300048000001,816.3145463272726,10.84997599999997,54.36047981618472,-2.429673901854667,-11.95570616148757,17.399178524454996,373337.49744228966,-276317.7706405928,36.0,76.0,-40.0,24.450012000000015,825.8166506666666,832.6333013333333,841.4166266666666,848.2332773333333,817.0333253333333,810.2166746666667,801.4333493333334,0.3108963757380126,-3326039.0,-1
2014-08-21,822.0,835.200012,821.0,820.549988,808.985779,1597620.0,813.3650024000001,817.6272705454545,0.34997599999996964,51.2591674949892,-2.6116932613299584,-12.694800102225827,17.650548837400706,30042.640581581883,-262392.2863779899,32.0,72.0,-40.0,22.09997599999997,825.5833333333334,830.1666666666667,839.7833453333333,844.3666786666668,815.9666546666667,811.3833213333334,801.7666426666667,-0.031690959134401765,-4923659.0,-1
2014-08-22,834.349976,848.75,828.049988,832.5,822.8332519999999,2503822.0,815.6150024000001,821.1063610181818,22.5,60.64139235075258,-2.1673891297099033,-12.448832859571667,74.49970363393167,505517.5,-227487.26970886646,28.000000000000004,68.0,-40.0,15.25,836.4333293333333,844.8166706666666,857.1333413333334,865.5166826666666,824.1166586666666,815.7333173333333,803.4166466666666,0.2149763004968312,-2419837.0,+1
2014-08-25,843.0,852.7999880000001,837.200012,846.75,819.626526,1664016.0,819.1400024,826.7672696727274,35.25,68.88289660223785,-0.8025985800360742,-12.217336044352692,115.58606340885088,-1094489.808471663,-266896.5044457276,24.0,64.0,-40.0,15.59997599999997,845.5833333333334,853.9666546666667,861.1833093333335,869.5666306666668,838.3666786666666,829.9833573333333,822.7667026666666,0.6121796597635749,-755821.0,+1
2014-08-26,844.5,848.5,838.099976,843.4500119999999,818.703308,1041314.0,823.8700012,831.1872714181818,47.29998799999987,65.23300832632938,-1.2403789000856547,-9.999994680424948,100.30069936138068,-49935.653994621774,-257034.6408161582,96.0,60.0,-40.0,14.200012000000015,843.3499959999999,848.6000159999999,853.75002,859.0000399999999,838.1999919999998,832.9499719999999,827.7999679999998,0.5144253513261042,-1797135.0,-1
2014-08-27,846.0,846.0,834.0,842.5,812.9699099999999,1213242.0,828.8249999999999,834.5745439272728,49.549987999999985,64.10471305726084,-1.3664086181970192,-8.071894260767408,83.72483545794671,-2210726.303400947,-345838.8656683321,92.0,56.00000000000001,-40.0,28.200012000000015,840.8333333333334,847.6666666666667,852.8333333333335,859.6666666666667,835.6666666666667,828.8333333333334,823.6666666666667,0.7083333333333334,-3010377.0,-1
2014-08-28,837.5,845.5,834.0,836.599976,819.7236330000001,1997863.0,831.7649964000001,835.9881759272727,29.399963999999954,57.035469064280015,-2.1491127962183154,-3.8713767557046594,70.54319430895808,310130.9234490629,-316022.0383643221,88.0,52.0,-40.0,20.2999880000001,838.699992,843.3999839999999,850.1999919999998,854.8999839999999,831.8999839999999,827.199992,820.3999839999999,0.22608486956521476,-5008240.0,-1
2014-09-01,845.900024,849.0,838.599976,843.5499880000001,817.440063,1038664.0,834.8799928,838.1309016727273,31.149964000000068,62.63585260409539,-1.2271159654091157,1.0425248106143954,91.01010113727628,884779.0936777234,-261440.1360367374,84.0,48.0,36.0,10.40002400000003,843.7166546666667,848.8333333333335,854.1166786666668,859.2333573333335,838.4333093333335,833.3166306666667,828.0332853333334,0.4759615939347942,-3969576.0,+1
2014-09-02,843.099976,861.099976,838.650024,841.2000119999999,834.9315190000001,2860563.0,836.3299927999999,839.2799960727273,14.499999999999886,59.60465895515587,-2.6112012369358832,5.120300159817248,101.29892355943383,339138.21176570235,-234141.1046212002,80.0,44.0,35.99999999999999,12.0,846.9833373333332,855.3166506666664,869.433289333333,877.7666026666664,832.8666986666665,824.5333853333333,810.4167466666665,0.11358545443660094,-6830139.0,-1
2014-09-03,865.0,865.0,851.599976,859.2000119999999,832.453552,2308695.0,839.0149963999999,843.438181381818,26.850035999999932,71.7061663328259,-0.7571785900783419,9.053408378948575,148.25367006140806,-2713798.719406279,-346852.87589045614,96.0,40.0,36.0,11.5,858.5999959999999,865.6000159999999,872.00002,879.0000399999999,852.1999919999998,845.1999719999999,838.7999679999998,0.5671658498522029,-4521444.0,+1
2014-09-04,858.0499880000001,859.0,848.5,856.650024,827.789185,1601742.0,842.2950012,846.6445500363636,32.80004800000006,68.35870509678281,-1.0900751958224504,11.625713498873779,117.85593342018505,284912.1123993162,-318136.27055542456,96.0,36.0,36.0,12.40002400000003,854.7166746666667,860.9333493333334,865.2166746666667,871.4333493333334,850.4333493333334,844.2166746666667,839.9333493333334,0.7761927619047648,-6123186.0,-1
2014-09-05,852.0,855.5499880000001,844.099976,851.849976,824.485229,958802.0,845.4250000000001,848.3818181818181,31.299987999999985,62.065595050587184,-1.716713315926897,13.064246859107698,86.29588635888668,1197298.8696619319,-249252.8208411686,92.0,32.0,36.0,22.44995199999994,850.49998,856.8999840000001,861.9499920000003,868.3499960000003,845.449972,839.0499679999999,833.9999599999999,0.6768551858286186,-7081988.0,-1
2014-09-08,851.0,867.7999880000001,849.4500119999999,848.4500119999999,840.3248289999999,2447086.0,847.0200012,848.9318203636362,15.950011999999901,57.7225563414514,-2.5169063868403954,15.39214290438099,90.90289839750639,-242557.4080571712,-248948.48375199892,88.0,28.000000000000004,56.0,23.7999880000001,855.2333373333332,861.0166626666665,873.5833133333334,879.3666386666667,842.6666866666664,836.883361333333,824.3167106666662,-0.05449598408194045,-9529074.0,-1
2014-09-09,860.099976,869.900024,857.7999880000001,864.75,841.150757,1915261.0,848.8200012,852.1554565090909,18.0,69.52060125441473,-0.6680534232283316,19.43329722433168,106.83207854189581,294229.8875600751,-224258.5465977335,96.0,24.0,60.0,10.700011999999901,864.1500040000001,870.5000200000001,876.25004,882.600056,858.3999840000001,852.0499680000001,846.2999480000002,0.5743794481272568,-7613813.0,+1
2014-09-10,865.0,865.0,854.099976,865.599976,833.085205,1078563.0,851.0349976,855.2063610181817,22.149964000000068,70.02392039258305,-0.5577958056984131,21.868005727150944,78.51183702048849,-348542.9563648191,-229907.84039380576,96.0,20.0,60.0,12.55004800000006,861.5666506666666,869.0333253333333,872.4666746666667,879.9333493333334,858.1333013333333,850.6666266666666,847.2332773333333,1.0550435485279637,-6535250.0,+1
2014-09-11,857.400024,863.099976,853.0,857.2999880000001,830.2186280000001,1633216.0,852.5149964,856.3454501818183,14.799988000000099,59.03904615588053,-1.634457855458561,21.12713429310918,51.466798854007436,961959.3884057199,-175732.03490328125,92.0,16.0,60.0,18.349976000000197,857.7999880000001,862.5999760000002,867.8999640000002,872.6999520000002,852.5000000000002,847.7000120000001,842.4000240000003,0.4257423978037286,-8168466.0,-1
2014-09-12,850.099976,858.0,848.9500119999999,854.349976,831.5304570000001,1521639.0,854.2899964,856.6790828363636,17.75,55.47039458282714,-2.017129007120132,20.632358918237287,29.90777824339531,572889.0218352838,-141703.79164346232,88.0,12.0,72.0,21.45001200000013,853.7666626666665,858.5833133333332,862.8166506666665,867.6333013333333,849.5333253333331,844.7166746666664,840.483337333333,0.5966818961527915,-9690105.0,-1
2014-09-15,850.0,865.0,850.0,855.7000119999999,836.049133,1452272.0,855.5049987999998,856.9354493090909,12.150023999999803,56.84772452973642,-1.8420043530832904,20.7983847774924,34.281556242971526,-926920.2170231413,-177395.46076679017,84.0,8.0,76.0,10.90002400000003,856.900004,863.8000079999999,871.9000040000001,878.8000079999999,848.8000079999999,841.900004,833.8000079999999,0.3800007999999934,-8237833.0,+1
2014-09-16,861.0,862.0499880000001,848.0,860.349976,826.963196,1269067.0,857.4199952,857.8163542545453,19.149964000000068,61.5715530563748,-1.2388179663618821,21.364692660042692,30.762327459408063,-12023.068816588406,-169878.53116122732,80.0,4.0,76.0,12.59997599999997,856.7999880000001,865.5999760000002,870.8499760000002,879.6499640000003,851.5499880000001,842.75,837.5,0.8790026012833522,-6968766.0,+1
2014-09-17,855.0,855.900024,842.099976,851.0,822.493164,1976474.0,856.599994,856.6490824,-8.200011999999901,49.10091165784888,-2.4516828916326547,20.947982283997362,4.534010377898973,2395915.8666666667,-53251.4731098325,76.0,0.0,76.0,9.049988000000099,849.6666666666666,857.2333573333333,863.4667146666666,871.0334053333333,843.4333093333332,835.8666186666666,829.6332613333332,0.6449270321378586,-8945240.0,-1
2014-09-18,844.75,861.0,842.25,846.400024,833.911255,1663142.0,855.5749940000001,854.7945424000001,-10.25,44.03769785465262,-3.0483849096364795,19.834393056537692,1.2509796105251558,986714.3673469388,-5980.283080051474,72.0,0.0,76.0,15.0,849.8833413333333,857.5166826666666,868.6333413333332,876.2666826666666,838.7666826666666,831.1333413333333,820.0166826666666,0.22133461333333496,-10608382.0,-1
2014-09-19,860.0,865.0,851.400024,858.150024,835.951904,1635527.0,856.2049988,855.2627296727272,6.300048000000061,57.0816670161006,-1.5241924548182397,16.2814124015473,27.040642780995924,-632545.2320797085,-34460.51692768244,68.0,0.0,76.0,14.049988000000099,858.1833493333334,864.9666746666667,871.7833253333333,878.5666506666666,851.3666986666667,844.5833733333334,837.7667226666667,0.49632440527836336,-8972855.0,+1
2014-09-22,856.9500119999999,858.5,851.0,860.25,832.647949,1633579.0,857.3849976000001,855.9981844363637,11.799988000000099,59.049973616502946,-1.2517867037970192,13.885224186110122,17.97107279476658,564981.5628629547,-7213.141543070422,64.0,0.0,76.0,18.25,856.5833333333334,862.1666666666667,864.0833333333335,869.6666666666667,854.6666666666667,849.0833333333334,847.1666666666667,1.2333333333333334,-7339276.0,+1
2014-09-23,856.0499880000001,857.849976,845.599976,856.849976,824.8739009999999,1179244.0,856.5949952,855.9009077818182,-7.90002400000003,54.38998949506762,-1.692832740137528,12.325895204186509,3.8274934364427575,-1751191.4413673086,-86484.90499806049,60.0,8.0,72.0,18.75,853.4333093333333,861.2666426666667,865.6833093333335,873.5166426666667,849.0166426666667,841.1833093333333,836.7666426666667,0.9183673469387755,-8518520.0,-1
2014-09-24,847.099976,857.2999880000001,845.0499880000001,848.849976,831.287476,1666374.0,854.9199952,854.4927224727271,-16.75,44.79307696559952,-2.7305807944818614,11.921627094883434,-13.07383439505648,638411.545934119,-53535.05737076967,56.00000000000001,4.0,68.0,18.59997599999997,850.399984,855.7499799999999,862.649984,867.9999799999999,843.4999799999999,838.149984,831.2499799999999,0.3102031020408058,-10184894.0,-1
2014-09-25,853.0,865.599976,842.099976,855.4500119999999,825.942871,4148990.0,854.7349976,854.5890891636363,-1.849976000000197,52.73235092403885,-1.8744339797815508,9.736411825994082,4.681282773108049,-1734341.365564054,-129935.36391257543,52.0,0.0,64.0,7.5,854.3833213333332,866.6666666666665,877.8833213333332,890.1666666666665,843.1666666666665,830.8833213333332,819.6666666666665,0.5680866382978694,-6035904.0,+1
2014-09-26,849.9500119999999,879.0,845.0,849.9500119999999,847.0299679999999,2470563.0,854.2950012000001,853.7190917818182,-4.399964000000068,46.32644557093023,-3.7243574358974483,6.6005105706224185,23.25817253472082,1880939.5895378252,-38531.93431950306,48.0,0.0,52.0,14.65002400000003,857.9833373333332,870.9666746666664,891.9833373333331,904.9666746666664,836.9666746666664,823.9833373333332,802.9666746666664,0.14558858823529122,-8506467.0,-1
2014-09-29,873.0,877.349976,861.2000119999999,871.650024,840.664917,2170567.0,855.8900024000002,856.8745504727274,15.950012000000129,65.43945737419784,-0.9423046153846115,4.790322687791786,112.14839947214443,1451389.0018908489,29191.760595834792,96.0,0.0,52.00000000000001,12.25,870.0666706666666,878.9333293333333,886.2166346666667,895.0832933333334,862.7833653333332,853.9167066666665,846.6334013333332,0.64706100892857,-6335900.0,+1
2014-09-30,864.2000119999999,879.7999880000001,861.150024,865.099976,848.00177,3008858.0,856.3650024000002,858.5490911272728,4.75,58.21898195783887,-1.8826859920494936,3.93927627771302,105.49502919963997,-228144.90588080202,17494.636755017724,92.0,8.0,52.0,23.5,868.6833293333334,876.2166346666668,887.3332933333336,894.8665986666668,857.5666706666667,850.0333653333333,838.9167066666666,0.21179408174728515,-9344758.0,-1
2014-10-01,866.0,871.150024,860.5,872.650024,843.4829710000001,1467547.0,858.5300048000001,861.5100041454544,21.65002400000003,63.56572564493326,-0.9157228624342739,3.9878746196072825,107.402798598417,-2013272.088948788,-74812.96155250393,96.0,4.0,48.0,34.0,868.100016,875.700032,878.7500399999999,886.350056,865.0500079999999,857.449992,854.3999839999999,1.1408447530259083,-7877211.0,+1
2014-10-07,865.0,867.0,854.099976,868.0,838.0898440000001,1256572.0,860.6900024000001,863.2318214545455,21.59997599999997,58.26683268181503,-1.5112689781445152,3.0894560934050332,55.34993421709557,1324865.893455796,-11191.182345479348,92.0,0.0,96.0,27.399964000000068,863.0333253333333,871.9666746666667,875.9333493333334,884.8666986666667,859.0666506666666,850.1333013333333,846.1666266666666,1.0775192356231273,-9133783.0,-1
2014-10-08,860.5499880000001,870.0,858.2999880000001,862.4500119999999,843.094299,785096.0,861.1200011999999,863.5518232,4.299987999999871,52.26656217797486,-2.222076878413092,3.2927335789659082,57.19653502792441,57130.13212435779,-8085.667442406861,88.0,0.0,84.0,18.649964000000068,863.5833333333334,868.8666786666666,875.2833453333334,880.5666906666665,857.1666666666667,851.8833213333335,845.4666546666668,0.354702542185413,-9918879.0,-1
2014-10-09,874.0,892.9500119999999,868.25,867.599976,862.529358,1912605.0,861.8549987999999,864.7300004363635,7.34997599999997,57.00688960305333,-3.1929007641352536,3.984344200702594,202.69531011701292,218331.42434507702,2206.0204743890727,84.0,0.0,92.0,10.65002400000003,876.2666626666665,884.2833253333331,900.9666746666664,908.983337333333,859.5833133333332,851.5666506666666,834.8833013333333,-0.02631674834813979,-8006274.0,+1
2014-10-10,883.0499880000001,885.150024,864.900024,887.599976,842.802856,1066745.0,864.9299988,869.4109053818181,30.75,70.24696817744356,-0.6738504841788368,4.090834533366319,209.490627970703,0.0,2105.746798545681,96.0,0.0,92.0,18.55004800000006,879.2166746666667,893.5333253333333,899.4666746666667,913.7833253333333,873.2833253333333,858.9666746666667,853.0333253333333,1.1209852839506143,-6939529.0,+1
2014-10-13,864.0,878.0,855.650024,867.2999880000001,852.034485,1344128.0,866.7750000000001,869.8418125090909,18.45001200000013,51.62689463972339,-3.230685006904415,3.315118070152039,58.66480785313266,558415.1267156894,27392.54110758064,92.0,40.0,88.0,11.700011999999901,866.9833373333335,878.3166506666669,889.3333133333335,900.6666266666668,855.9666746666669,844.6333613333335,833.6166986666669,0.5212517454157483,-8283657.0,-1
2014-10-14,885.0,885.9500119999999,865.150024,876.7999880000001,843.8231199999999,1816560.0,868.9099976,871.6645376,21.349976000000197,57.68362201127945,-2.0341361239251174,4.402390797010526,125.26334414685066,-2212845.1612903224,-74436.46194311349,88.0,36.0,84.0,30.5,875.9666746666667,886.7833253333333,896.7666626666664,907.5833133333332,865.9833373333335,855.1666866666668,845.1833493333336,0.5600947462085142,-6467097.0,+1
2014-10-15,868.349976,868.349976,868.349976,868.349976,843.8231199999999,0.0,870.749994,871.5627154909091,18.399964000000068,51.11513699680667,-3.0984363786368876,6.380942277990471,49.59768079841456,-3583699.2939622793,-233948.43364168526,84.0,32.0,96.0,20.25,868.349976,868.349976,868.349976,868.349976,868.349976,868.349976,868.349976,,-6467097.0,-1
2014-10-16,868.400024,874.0,855.0499880000001,868.349976,834.591431,1383271.0,870.4199891999999,871.1263485818183,-3.3000480000000607,51.11513699680667,-3.0984363786368876,7.3188521234889095,24.979563310155662,-1284756.556905013,-281712.44632983214,80.0,28.000000000000004,52.0,31.94995199999994,865.7999880000001,876.5499880000001,884.7500000000001,895.5,857.5999760000002,846.8499760000002,838.6499640000003,0.7018458880131548,-6467097.0,-1
2014-10-17,860.25,888.099976,857.099976,858.849976,860.24585,2494480.0,869.7949892,869.0227098181817,-6.25,43.67168000611012,-4.294985261616185,8.711405780469136,37.4614886033689,-491971.5766435493,-291269.68087917985,76.0,24.0,52.0,20.79998799999987,868.0166426666666,878.9333093333332,899.0166426666665,909.9333093333332,847.9333093333332,837.0166426666666,816.9333093333332,0.056451612903225805,-8961577.0,-1
2014-10-20,894.0,909.599976,890.150024,885.25,868.5543210000001,2383001.0,871.0549868,871.8327117818183,12.59997599999997,61.60127787054518,-3.0039448212369515,8.876269586404533,226.5614800460734,-1809039.6503813996,-360259.2342721023,72.0,20.0,52.0,8.450012000000129,895.0,899.849976,914.4499519999999,919.2999279999999,880.400024,875.5500480000001,860.9500720000001,-0.2519298762279745,-6578576.0,+1
2014-10-21,900.0,905.75,887.650024,893.7999880000001,870.2548830000001,4009288.0,873.6349856000002,875.9681665454546,25.7999880000001,65.68315723672532,-1.9491720290897063,10.286484479781052,173.5753181315387,70200.58824469209,-340692.8761787735,96.0,16.0,52.0,18.9500119999999,895.7333373333335,903.8166506666669,913.8333133333335,921.9166266666668,885.7166746666669,877.6333613333335,867.6166986666669,0.339777467108248,-2569288.0,+1
2014-10-22,905.0499880000001,906.349976,891.25,895.5499880000001,868.4085689999999,1142886.0,876.9449832,879.9527124363636,33.0999760000002,66.52358952400658,-1.7332825581035882,10.294846166061689,149.25675302025996,-300058.93417020893,-338845.87858728616,92.0,12.0,52.0,31.0,897.7166546666667,904.1833093333335,912.8166306666667,919.2832853333334,889.0833333333335,882.6166786666668,873.9833573333335,0.28476786982973396,-1426402.0,+1
2014-10-27,899.0499880000001,907.2999880000001,894.150024,893.650024,871.9068599999999,1681192.0,879.5499880000001,882.9899925818181,26.05004800000006,64.5434189575396,-1.9676723997336931,10.791343393631223,131.23674480286905,-825210.5258334825,-360953.3651518528,88.0,8.0,52.0,50.75,898.3666786666668,902.5833333333335,911.5166426666669,915.7332973333336,889.4333693333334,885.2167146666667,876.2834053333333,-0.03802291778137168,-3107594.0,-1
2014-10-28,899.0,900.2000119999999,894.0,897.25,870.011963,1450873.0,880.5149904000002,886.2081765818182,9.65002400000003,66.70984975544428,-1.5235598773321417,12.374995503337459,106.07176026875517,-2731531.9713789965,-468706.9502533081,84.0,4.0,80.0,20.5,897.150004,900.3000079999999,903.3500159999999,906.5000199999998,894.099996,890.9499920000001,887.8999840000001,0.5241925338209106,-1656721.0,+1
2014-10-29,900.2000119999999,902.5,890.0,895.2999880000001,866.367798,1974047.0,883.3149904,888.8963579636364,28.0,64.25600397805152,-1.764123911101605,13.683265279517627,84.8432361401182,-130217.64622702148,-453321.07114957954,80.0,0.0,80.0,15.09997599999997,895.9333293333334,901.8666586666668,908.4333293333334,914.3666586666668,889.3666586666668,883.4333293333334,876.8666586666668,0.4239990400000079,-3630768.0,-1
2014-10-30,889.900024,899.9500119999999,887.099976,891.5499880000001,871.323853,2684545.0,884.7899904000001,890.3936302545454,14.75,59.40716234032538,-2.2267442060718583,11.616114554041928,59.290389366945384,-1712588.5157654306,-510560.5063025619,76.0,20.0,80.0,13.149964000000068,892.8666586666667,898.6333413333334,905.7166946666666,911.4833773333334,885.7833053333335,880.0166226666668,872.9332693333336,0.3463034656089798,-6315313.0,-1
2014-10-31,900.099976,914.599976,897.349976,896.650024,886.0944820000001,2526497.0,887.6199952000003,892.5500000000001,28.30004800000006,63.70509698873657,-2.200827921554517,12.185742903463165,87.1166294928659,4418395.827185206,-286517.014733176,72.0,16.0,80.0,6.549987999999871,902.8666586666667,908.3833413333334,920.1166586666668,925.6333413333334,891.1333413333334,885.6166586666667,873.8833413333334,-0.040576927536228366,-3788816.0,+1
2014-11-03,915.2000119999999,919.2999880000001,905.400024,911.849976,884.9769289999999,1809912.0,891.9699952000002,896.9554510545455,43.5,73.39289214541974,-0.908205791659737,12.690757214984728,112.51977843886095,-254961.2372637113,-285082.6610782147,96.0,12.0,80.0,12.5,912.1833293333334,918.9666346666668,926.0832933333336,932.8665986666668,905.0666706666667,898.2833653333333,891.1667066666666,0.4640265255363185,-1978904.0,+1
2014-11-05,915.0499880000001,920.2999880000001,910.25,910.7000119999999,887.017639,1881045.0,897.1549988000002,900.3609086545454,51.85003599999993,71.72172470072778,-1.1688757019682552,14.648519590169371,105.32175997911081,-1031868.7735975757,-319027.4873930539,96.0,8.0,56.0,12.850035999999932,913.75,917.25,923.7999880000002,927.2999880000001,907.2000119999999,903.7000119999999,897.1500239999998,0.04477736689833829,-3859949.0,-1
2014-11-07,905.0,906.599976,893.650024,912.7999880000001,874.044739,2257123.0,899.9099976000002,903.2054521454545,27.5499880000001,73.01635160265958,-0.9131864251287435,16.718212843228457,59.26050508308743,-1186253.6190476192,-358446.86035970546,96.0,4.0,56.0,23.04998799999987,904.349996,915.049968,917.2999479999999,927.99992,902.1000160000001,891.4000440000001,889.1500640000002,1.4787671799864708,-1602826.0,+1
2014-11-10,899.5,908.349976,893.0,899.4500119999999,879.097839,1597439.0,900.4750000000001,903.1218184,5.650023999999803,54.660347128859385,-2.5386553396613705,19.60023747474827,38.89923948645792,-45896.93386574349,-344240.0443679836,92.0,0.0,84.0,22.649964000000068,900.2666626666665,907.5333253333331,915.6166386666664,922.8833013333331,892.1833493333331,884.9166866666666,876.8333733333332,0.42019687848371323,-3200265.0,-1
2014-11-11,905.900024,917.2999880000001,902.400024,904.650024,882.256042,1478352.0,901.3850036000001,903.8809136727273,9.100035999999932,59.26310107658539,-1.9055112904738123,19.643312031895675,56.39371985975571,-1275633.1421959726,-386576.0975435557,88.0,0.0,88.0,10.049988000000099,908.1166786666668,913.8333333333335,923.0166426666669,928.7332973333336,898.9333693333334,893.2167146666667,884.0334053333333,0.15100707625870705,-1721913.0,+1
2014-11-12,911.0,919.900024,904.150024,907.900024,885.9973140000001,2264666.0,902.8100036000001,905.0654628363636,14.25,62.041982478570425,-1.5097971729180235,18.30970250930386,56.250721879911424,2356208.485807377,-261904.0618236647,84.0,12.0,92.0,17.04998799999987,910.650024,917.150024,926.400024,932.900024,901.400024,894.900024,885.650024,0.23809523809523808,542753.0,+1
2014-11-13,915.5,920.0,903.900024,911.75,890.078674,1847238.0,904.2600036000001,906.6909167272727,14.5,65.27935311115971,-1.0410310635484994,18.20249068034377,52.674537545680536,-908920.6376229762,-291313.9082506766,80.0,8.0,92.0,19.7999880000001,911.8833413333333,919.8666586666666,927.9833173333332,935.9666346666666,903.7666826666666,895.7833653333333,887.6667066666666,0.48757687589099413,2389991.0,+1
2014-11-14,918.2000119999999,933.0,911.75,915.9500119999999,903.8289789999999,2109514.0,906.3250060000001,908.8163728,20.650023999999803,68.64547293207637,-2.044363069544376,18.123041815866145,72.20342725312022,252725.54779180032,-266584.84040349326,76.0,4.0,88.0,17.849976000000197,920.2333373333332,928.7166746666664,941.4833373333331,949.9666746666664,907.4666746666664,898.9833373333332,886.2166746666664,0.19764762352940712,4499505.0,+1
2014-11-17,930.0,934.0,908.0,930.099976,892.9938960000001,3366021.0,910.1800048,913.1390946181818,38.54998799999987,77.22771965125757,-0.4670687425149737,18.463269438618113,77.64375968457139,981910.9772926986,-209835.02686437443,96.0,0.0,72.0,15.75,924.0333253333333,940.0666506666666,950.0333253333333,966.0666506666666,914.0666506666666,898.0333253333333,888.0666506666666,0.8499990769230757,7865526.0,+1
2014-11-18,921.0,935.0,912.0,918.9500119999999,905.86969,2297278.0,912.4100036,914.7336413818182,22.29998799999987,61.83824106367891,-1.9198550239234569,18.630315779317016,63.52643658716719,-1331990.329443667,-260842.08919875804,96.0,24.0,72.0,16.09997599999997,921.9833373333332,931.9666746666664,944.9833373333331,954.9666746666664,908.9666746666664,898.9833373333332,885.9666746666664,0.3021744347826044,5568248.0,-1
2014-11-19,935.0499880000001,937.7000119999999,922.150024,932.2000119999999,900.3792109999999,863712.0,914.4450072,918.3318247272728,20.350035999999932,70.02778701793265,-0.6557767880418249,19.445425637126505,82.51457039611924,-1035720.778258509,-296063.8498530075,96.0,20.0,72.0,21.25,930.6833493333332,939.2166746666664,946.2333373333331,954.7666626666663,923.6666866666666,915.1333613333334,908.1166986666667,0.6463019778536134,6431960.0,+1
2014-11-20,927.9500119999999,927.9500119999999,912.099976,926.5499880000001,892.2651369999999,1192593.0,916.0300048,920.5327303272727,15.849976000000197,63.33986925722679,-1.329441259147115,19.928540801951613,46.0353132173457,-1135830.5061310537,-334235.0636336815,96.0,16.0,96.0,26.0,922.199992,932.3000079999999,938.0500279999999,948.1500439999999,916.449972,906.349956,900.5999360000001,0.911670610716606,5239367.0,-1
2014-11-21,921.2000119999999,935.0,914.0499880000001,918.2000119999999,906.5012820000001,2205952.0,916.5700072,920.9272770909091,5.400023999999803,54.46923560258643,-2.3250267939664706,19.449561685271874,43.11609230874344,1172667.830680689,-265739.4738772157,92.0,12.0,72.0,23.0,922.4166666666666,930.7833453333332,943.3666786666664,951.7333573333331,909.8333333333333,901.4666546666667,888.8833213333334,0.1980917242433953,3033415.0,-1
2014-11-24,932.349976,950.0,928.099976,932.849976,918.502441,1829215.0,919.9100036,923.8872714181817,33.39996400000007,64.52651607703228,-2.0152789659224477,18.236554031430956,84.21762880619787,1773757.5232172618,-173035.06020124388,88.0,8.0,76.0,18.75,936.9833173333333,945.8666586666666,958.8833413333332,967.7666826666666,923.9666346666666,915.0832933333332,902.0666106666665,0.2168947394760843,4862630.0,+1
2014-11-25,943.0,958.7999880000001,939.0,945.2000119999999,926.616699,3039127.0,923.9650024,928.4854547636363,40.54998799999987,70.80034786821571,-1.581760431473767,17.664977768686754,109.69315138432778,-2031487.5520179165,-257510.17756865238,96.0,4.0,80.0,20.100035999999932,947.6666666666666,956.3333333333333,967.4666546666667,976.1333213333334,936.5333453333332,927.8666786666665,916.7333573333331,0.3131321089689484,7901757.0,+1
2014-11-26,939.7999880000001,959.900024,933.2999880000001,953.5499880000001,924.4302369999999,2244107.0,928.5299988,933.8645430545455,45.64996400000007,74.34064471012545,-0.7376043469595642,18.761702251324323,103.99911923089438,473166.5708609457,-224297.5965547473,96.0,0.0,80.0,20.9500119999999,948.9166666666669,964.5333453333336,975.5167026666669,991.1333813333335,937.9333093333337,922.3166306666669,911.3332733333338,0.761277165188801,10145864.0,+1
2014-11-27,950.599976,953.7999880000001,943.0,951.2999880000001,921.369141,3302862.0,932.4849976,938.004541090909,39.5499880000001,71.64002803495652,-0.998958736235316,19.331041724059673,95.89017618048972,1216270.5902316645,-158817.2215302241,96.0,0.0,80.0,31.7999880000001,949.3666586666668,955.7333173333336,960.166646666667,966.5333053333337,944.9333293333335,938.5666706666667,934.1333413333334,0.7685182613165887,6843002.0,-1
2014-11-28,948.0,965.900024,947.0,948.150024,930.11499,2312965.0,935.7049988,940.8527277090909,32.20001200000013,67.66904831158041,-2.0475256094813536,18.983633989948316,96.23234413484441,1457997.5363002869,-85325.63852426571,92.0,24.0,92.0,25.95001200000013,953.6833493333334,960.3666986666667,972.5833733333334,979.2667226666667,941.4666746666667,934.7833253333333,922.5666506666666,0.060847753420843725,4530037.0,-1
2014-12-01,958.2999880000001,962.4500119999999,948.2000119999999,957.150024,923.1669310000001,1847282.0,938.4100036000001,944.7518232,27.05004800000006,72.66429584209776,-1.0093436103077094,20.16207189260433,87.78873562405472,-1402720.8872855594,-145207.24315533772,96.0,20.0,96.0,26.600035999999932,955.9333493333334,963.6666866666668,970.1833493333332,977.9166866666668,949.4166866666668,941.6833493333334,935.1666866666668,0.6280710175438687,6377319.0,+1
2014-12-02,941.75,949.599976,939.2000119999999,950.0,916.656067,1129389.0,941.5150024000001,946.8590952727274,31.0499880000001,63.64967231599278,-1.8341243003587724,21.34653576643848,52.13737918126498,316101.1413018845,-124238.67941836655,92.0,16.0,96.0,10.799988000000099,946.2666626666665,953.3333133333332,956.6666266666665,963.7332773333333,942.9333493333331,935.8666986666665,932.5333853333331,1.0384639792983925,5247930.0,-1
2014-12-03,942.0,944.0499880000001,932.0,943.2999880000001,906.744202,1665296.0,942.6250000000001,947.1836381090909,11.099976000000197,56.121771571028226,-2.6069945062084727,20.661824330762784,30.682045322261988,786068.55,-82861.07656090328,88.0,12.0,68.0,18.90002400000003,939.7833253333334,947.5666506666669,951.8333133333335,959.616638666667,935.5166626666668,927.7333373333333,923.4666746666667,0.93775927411712,3582634.0,-1
2014-12-04,940.0,944.25,932.0,933.099976,914.8098140000001,1709776.0,943.2799988,945.4518155636364,6.549987999999871,46.467858584762126,-3.783602156181283,21.22524589728698,18.931329616933738,-704055.3217262567,-111097.17960414768,84.0,8.0,76.0,14.299987999999871,936.449992,940.8999839999999,948.6999919999998,953.1499839999999,928.6499839999999,924.199992,916.3999839999999,0.08979395918367099,1872858.0,-1
2014-12-05,941.0,944.400024,935.7000119999999,941.400024,916.121765,1018545.0,945.5999999999999,945.1100019636364,23.20001200000013,53.911602801118356,-2.8261621088615865,20.48203735173763,26.42176600018794,-975382.061764896,-150382.85738116832,80.0,4.0,76.0,17.95001200000013,940.50002,945.300028,949.2000320000001,954.0000400000001,936.6000159999999,931.8000079999998,927.9000039999997,0.6551728894167094,2891403.0,+1
2014-12-08,945.0,945.0,925.0,942.75,900.962402,1014282.0,946.5900023999999,944.5918201454546,9.90002400000003,55.08372767302224,-2.6704375774708744,20.488217352908123,13.181263136703599,229740.96522121612,-133104.50125619653,76.0,0.0,76.0,18.0,937.5833333333334,950.1666666666667,957.5833333333335,970.1666666666667,930.1666666666667,917.5833333333334,910.1666666666667,0.8875,3905685.0,+1
2014-12-09,925.0499880000001,935.0,925.0499880000001,927.150024,900.573608,1218336.0,944.7850036000001,941.0572786181818,-18.04998799999987,41.134880746359336,-4.4699502742198565,21.162977965313075,-16.898358815474026,320602.90282572794,-112481.4368052287,72.0,16.0,76.0,12.25,929.0666706666667,933.0833533333333,939.0166826666665,943.0333653333332,923.1333413333334,919.1166586666668,913.1833293333335,0.2110586399292737,2687349.0,-1
2014-12-10,926.099976,935.0,925.2999880000001,926.75,905.092285,1391358.0,942.1050048000002,937.7781870545455,-26.7999880000001,40.82897090816135,-4.516094464890686,20.223558629806917,-21.527979934416667,-946920.3403165737,-150410.47897828158,68.0,12.0,76.0,11.30004800000006,929.0166626666668,932.7333373333335,938.7166746666668,942.4333493333334,923.0333253333336,919.3166506666669,913.3333133333336,0.149485588265243,1295991.0,-1
2014-12-11,929.900024,935.75,925.0,931.400024,907.2301640000001,1204711.0,940.1150084000001,935.8318269090909,-19.899964000000068,46.19578502998969,-3.9796976634989685,18.600374754083077,-19.493658318389105,1197589.44,-89137.75368541405,64.0,8.0,76.0,20.0,930.7166746666667,936.4333493333334,941.4666746666667,947.1833493333334,925.6833493333334,919.9666746666667,914.9333493333334,0.5953510697674447,2500702.0,+1
2014-12-12,933.0,936.2000119999999,929.0,933.599976,905.189453,1154207.0,938.6600036,934.6472755636364,-14.55004800000006,48.7340800848003,-3.7259253784494137,15.663687149479642,-14.269547015848794,321091.63636363635,-70490.9627339477,60.0,4.0,56.0,17.7000119999999,932.9333293333333,936.8666586666666,940.1333413333332,944.0666706666665,929.6666466666667,925.7333173333334,922.4666346666668,0.6388844907480755,3654909.0,+1
2014-12-15,930.0,944.2999880000001,928.0,931.5,914.9070429999999,1659657.0,936.0950012,933.3454567272728,-25.65002400000003,46.32690265739962,-3.9681650764379297,12.910426514264145,-11.030423425712272,-1668399.6452357564,-143123.17741425397,56.00000000000001,0.0,56.0,9.700011999999901,934.599996,941.1999920000001,950.8999840000001,957.4999800000002,924.900004,918.3000079999999,908.6000159999999,0.21472408445944738,1995252.0,-1
2014-12-16,937.5499880000001,942.0,917.0,941.5,899.601807,1247489.0,935.2450011999999,934.3281837818181,-8.5,57.784236199735666,-2.8146295218005473,9.817106969833276,-20.55111583625279,-1241351.4233119818,-193042.64434356143,52.0,0.0,56.0,10.75,933.5,950.0,958.5,975.0,925.0,908.5,900.0,0.98,3242741.0,+1
2014-12-17,926.0,932.5,916.0,925.75,895.8120119999999,1766004.0,933.4900024000001,932.6018199272726,-17.5499880000001,41.633340258748675,-4.631448020354425,5.176171500464875,-69.74376139353848,-2258443.2947159107,-286924.49425397476,48.0,4.0,56.0,7.2000119999999015,924.75,933.5,941.25,950.0,917.0,908.25,900.5,0.5909090909090909,1476737.0,-1
2014-12-18,932.599976,936.5,922.0499880000001,921.849976,907.667419,1623457.0,932.3650024000001,930.485451490909,-11.25,38.55443573627637,-5.0813296551483385,1.305498111925317,-66.70986210456114,-192653.93374938317,-282639.4686821155,44.0,0.0,56.00000000000001,16.2999880000001,926.7999880000001,931.5499880000001,941.2500000000001,946.0,917.0999760000002,912.3499760000002,902.6499640000003,-0.013841649404867639,-146720.0,-1
2014-12-19,945.0499880000001,949.0,932.5,934.0499880000001,914.8583980000001,1528527.0,931.6299988000001,930.7918125090908,-7.350035999999932,51.50039067257283,-3.2891335462741074,-1.3448897142829992,-0.9426331143510588,2390737.641116275,-161122.324772879,40.0,4.0,52.0,25.0,938.5166626666668,944.5333253333336,955.0166626666669,961.0333253333336,928.0333253333336,922.0166626666668,911.5333253333336,0.09393866666667264,1381807.0,+1
2014-12-22,954.0,966.099976,942.5,941.4500119999999,936.4799800000001,2073903.0,931.5000000000001,932.5772694545454,-1.2999880000000985,57.73294809522846,-2.8428052914627306,-2.254702445713292,97.2849186663929,-404624.06625216245,-172190.58597133087,36.0,0.0,44.0,25.5,950.0166626666665,957.5333253333331,973.6166386666664,981.1333013333331,933.9333493333331,926.4166866666666,910.3333733333332,-0.044491062194304765,3455710.0,+1
2014-12-23,959.7000119999999,973.9500119999999,955.349976,963.7000119999999,932.641541,1886020.0,935.1549988000002,938.431817090909,36.54998799999987,70.7663105103161,-1.1714954979622312,-2.900281265581498,239.469307507423,-821537.1324096788,-201706.3386475708,96.0,0.0,44.0,14.450011999999901,964.3333333333331,973.3166906666663,982.9333693333331,991.9167266666662,954.7166546666664,945.7332973333332,936.1166186666665,0.44892579777802377,5341730.0,+1
2014-12-24,957.900024,964.7999880000001,941.099976,959.75,918.5510859999999,4166203.0,938.4549988,942.903635490909,33.0,66.56197814336717,-1.622951232098492,-4.552753035128262,128.57685344068665,88509.51327169641,-188514.70877366338,96.0,4.0,36.0,27.15002400000003,955.2166546666667,969.3333333333335,978.916666666667,993.0333453333336,945.6333213333334,931.5166426666666,921.9333093333332,0.7869204454411217,1175527.0,-1
2014-12-26,950.400024,952.9500119999999,942.5499880000001,945.25,921.855042,841620.0,939.8399964,944.1390902545455,13.84997599999997,53.17960614616731,-3.2801887658011606,-3.575542119068132,53.42349708123035,967103.1441045384,-135986.6236350917,92.0,0.0,36.0,32.04998799999987,946.9166666666666,951.2833453333332,957.3166906666664,961.683369333333,940.8833213333334,936.5166426666668,930.4832973333336,0.25961593934782773,333907.0,-1
2014-12-29,950.099976,956.0,948.2999880000001,948.650024,924.818909,903700.0,941.3450012,945.7409134545455,15.05004800000006,55.59506689780271,-2.891592394194958,-2.6867244208494867,89.4505247561208,355434.789331277,-113649.28630991663,88.0,0.0,96.0,32.5,950.9833373333335,953.6666866666668,958.6833493333335,961.3666986666667,945.9666746666669,943.2833253333336,938.266662666667,0.04545914993378404,1237607.0,+1
2014-12-30,950.0,959.599976,942.75,951.7000119999999,929.434692,1420300.0,943.3650024000001,947.623642690909,20.2000119999999,57.84602548912403,-2.5430024224058188,-2.7731530121463948,89.25846174511666,-1217544.6843949447,-163826.35065722748,84.0,68.0,92.0,23.70001200000013,951.3499959999999,959.9499919999998,968.1999719999999,976.7999679999998,943.1000159999999,934.50002,926.2500399999999,0.5311587387424123,2657907.0,+1
2014-12-31,956.0,957.2999880000001,949.75,956.4500119999999,924.7216189999999,1248132.0,944.8600036,950.0027353454545,14.950011999999901,61.36533023973386,-2.0001142648135652,-2.04624445252432,105.2983821406847,384146.2639640736,-138918.5041599608,80.0,64.0,92.0,17.2000119999999,954.5,959.25,962.0499880000002,966.7999880000001,951.7000119999999,946.9500119999999,944.1500239999998,0.8874202184162165,3906039.0,+1
2015-01-01,951.0,954.400024,945.0499880000001,951.599976,925.159058,886235.0,947.4450012000001,951.2281848727273,25.84997599999997,55.86997141146098,-2.554435761296948,-0.24636240979089052,66.23461329229407,2184712.20811788,-33298.92479865947,76.0,60.0,88.0,10.75,950.349996,955.650004,959.7000319999999,965.0000399999999,946.299968,940.9999600000001,936.9499320000001,0.7005307787050145,3019804.0,-1
2015-01-02,950.400024,969.2999880000001,950.400024,952.0499880000001,938.03479,1475096.0,950.4650024,952.0654552,30.20001200000013,56.28904502233937,-2.5030028801233737,0.8327080399751594,104.20678645973308,-294914.529885873,-45190.543376198664,72.0,56.00000000000001,16.0,16.84997599999997,957.2500000000001,964.0999760000002,976.1499640000002,982.9999400000003,945.2000120000001,938.350036,926.3000480000001,0.08729984882511216,4494900.0,+1
2015-01-05,970.0,970.5499880000001,955.099976,965.2999880000001,930.11499,1199000.0,953.5900024,954.7627253090909,31.25,66.95132064634359,-0.988630651050246,4.446062074775341,129.13447507877004,-3115980.123129809,-184771.88975337494,68.0,52.0,16.0,7.5499880000000985,963.6499840000001,972.1999920000003,979.0999960000004,987.6500040000004,956.7499800000002,948.199972,941.299968,0.6601944386839339,5693900.0,+1
2015-01-06,954.0,956.5499880000001,937.5499880000001,957.150024,915.6358029999999,2054920.0,955.1600036000001,955.4100019636364,15.700012000000129,57.07115955694472,-1.9201083227140834,8.54989481576581,37.44408808977468,-2833014.0536393053,-305146.5350834607,64.0,48.0,16.0,11.400023999999803,950.4166666666666,963.2833453333332,969.4166666666666,982.2833453333332,944.2833453333332,931.4166666666666,925.2833453333332,1.0315808421052595,3638980.0,-1
2015-01-07,939.7000119999999,951.349976,936.25,942.25,918.3081050000001,1436528.0,953.0150024000001,953.0627285818182,-21.4500119999999,43.52246275554869,-3.6230654969120577,11.476998099335106,-6.486955218411852,1292108.1765531066,-232544.04731746743,60.0,44.0,15.999999999999993,18.899964000000068,943.2833253333333,950.3166506666666,958.3833013333333,965.4166266666666,935.2166746666667,928.1833493333334,920.1166986666667,0.3973516249297358,2202452.0,-1
2015-01-08,954.25,968.9500119999999,948.2000119999999,945.0,937.597473,2381456.0,951.5400024,951.6054554181819,-14.75,46.24034676736644,-3.308761826727068,13.190681170831112,49.63638321019568,578347.15137382,-195685.35604460156,56.00000000000001,40.0,16.0,18.5,954.0500079999998,959.9000039999997,974.8000079999998,980.6500039999997,939.1500039999997,933.3000079999998,918.4000039999997,-0.1542174457831278,4583908.0,+1
2015-01-09,972.900024,980.0,966.599976,964.849976,948.0924679999999,2246296.0,953.5000000000001,954.0254506181818,19.59997599999997,61.62224498681735,-1.7196395005675404,11.943186065870236,137.94980269641502,-471443.33997002355,-208219.8099967886,52.0,36.0,16.0,27.75,970.4833173333333,974.3666586666666,983.8833413333332,987.7666826666666,960.9666346666666,957.0832933333332,947.5666106666665,-0.13059678102069042,6830204.0,+1
2015-01-12,969.400024,974.400024,964.5,975.650024,939.7353519999999,1031603.0,956.2000000000002,958.052727709091,27.0,67.46614307294723,-0.49375437003404876,10.7987327232795,115.54959522389004,-4271827.613908364,-392929.25756177574,96.0,32.0,16.0,20.90002400000003,971.5166826666667,978.5333653333334,981.4167066666669,988.4333893333335,968.6333413333334,961.6166586666667,958.7333173333334,1.1262623201721527,7861807.0,+1
2015-01-13,968.9500119999999,971.9500119999999,955.7000119999999,967.0499880000001,936.1398320000001,1457087.0,957.7349976000002,960.0254528000002,15.349976000000197,59.185553304494,-1.4699219069239389,11.99464068555642,68.31168326290076,-3246907.6923273043,-522655.5513467662,92.0,28.000000000000004,16.000000000000007,26.7000119999999,964.900004,974.099996,981.150004,990.349996,957.849996,948.650004,941.599996,0.6984600615384736,6404720.0,-1
2015-01-14,960.0499880000001,974.650024,959.7000119999999,963.349976,936.674316,921308.0,958.4249940000002,961.0463579636364,6.899964000000068,55.78651994431003,-1.8899005675368934,12.840209772969729,69.06753724887542,-1258798.0614637288,-556116.574852904,88.0,24.0,16.0,35.0,965.900004,972.099996,980.8500160000002,987.0500080000002,957.1499839999999,950.9499919999998,942.1999719999998,0.2441445531950099,5483412.0,-1
2015-01-15,990.0,998.2000119999999,970.75,963.900024,965.0981449999999,2849619.0,959.6549988000002,962.0418179636363,12.30004800000006,56.2178228981268,-3.8145003939345896,12.3843763838521,117.8342559643395,-1692657.0373929432,-607777.5054384865,84.0,20.0,64.0,9.90002400000003,977.6166786666666,984.4833573333333,1005.0666906666665,1011.9333693333332,957.0333453333334,950.1666666666667,929.5833333333335,-0.24954364318674957,8333031.0,+1
2015-01-16,1002.2000119999999,1014.900024,998.5499880000001,993.150024,973.066467,1955327.0,963.7650024000001,968.1318225454546,41.10003599999993,72.61132976853298,-2.374713334432667,12.015614895628005,209.62093163287832,-1084952.182463277,-629467.2636734777,96.0,16.0,64.0,19.95001200000013,1002.2000120000001,1005.8500360000002,1018.5500480000002,1022.2000720000001,989.5000000000002,985.8499760000002,973.1499640000003,-0.3302723003178764,10288358.0,+1
2015-01-19,1013.25,1020.0,1002.9500119999999,1001.349976,976.176147,1059873.0,967.3700012000002,974.965454109091,36.04998799999987,75.57021126162192,-2.0249754614549436,12.933204154383475,189.5224109589084,-1292971.0930629026,-659626.528895797,96.0,12.0,64.0,14.950012000000129,1008.0999959999999,1013.2499799999999,1025.1499840000001,1030.299968,996.1999919999998,991.0500079999998,979.1500039999997,-0.09384381971412077,11348231.0,+1
2015-01-20,1010.0,1027.0,1002.0,1004.5499880000001,992.112915,2126451.0,972.1099976000002,981.725451709091,47.39996400000007,76.703487392585,-2.419182327586196,14.215164413790717,164.57898931215408,-3163549.917486025,-773441.2292779962,96.0,8.0,64.0,34.85003599999993,1011.1833293333334,1020.3666586666668,1036.1833293333334,1045.3666586666668,995.3666586666668,986.1833293333334,970.3666586666668,0.10199952000000394,13474682.0,+1
2015-01-21,1027.400024,1032.949951,1018.349976,1020.9500119999999,991.141174,1685153.0,979.9799988,990.6054543272728,78.7000119999999,81.7184692945517,-1.2848588928294888,14.132576129958238,178.72720877233868,-2233763.888899152,-839819.5324895418,96.0,4.0,80.0,51.0,1024.0833129999999,1029.8166499999998,1038.6832879999997,1044.4166249999998,1015.2166749999997,1009.4833379999998,1000.6166999999996,0.1780849624742451,15159835.0,+1
2015-01-22,1025.0,1032.5,1018.5499880000001,1019.9500119999999,992.404419,1617670.0,987.4749999999999,997.8727294545453,74.9500119999999,80.4992724369873,-1.3919310115152148,15.968763750167795,143.53904060147372,-7426.8639364347,-801983.5018279036,96.0,0.0,84.0,26.84997599999997,1023.6666666666666,1028.7833453333333,1037.6166786666663,1042.733357333333,1014.8333333333333,1009.7166546666667,1000.8833213333334,0.10036005703793036,13542165.0,-1
2015-01-23,1030.0,1048.0,1024.400024,1021.25,1013.345825,2496978.0,993.1150024000001,1004.0136385454546,56.40002400000003,80.92612682697649,-2.8187565858798735,19.278438405322845,137.91344781797022,-5830094.770908354,-1030534.0156321425,92.0,0.0,88.0,25.65002400000003,1031.2166746666667,1038.0333253333333,1054.8166506666666,1061.6333013333333,1014.4333493333334,1007.6166986666667,990.8333733333334,-0.1334757289583699,16039143.0,+1
2015-01-27,1043.0,1077.75,1040.900024,1042.800049,1043.713135,2490600.0,999.8300049,1013.0472833818181,67.15002499999991,86.55522937009957,-3.5708762196679498,23.004126697705374,166.40237531282665,2721088.5141606303,-860005.7177028462,96.0,0.0,92.0,28.399962999999957,1053.816691,1066.733358,1090.666667,1103.583334,1029.883382,1016.966715,993.033406,0.05156109192581063,18529743.0,+1
2015-01-28,1070.0,1093.199951,1055.0,1074.050049,1028.456421,2841235.0,1010.5300110000001,1026.5418368545454,107.00006099999985,90.99961012539131,-1.926162034180196,26.04869586749487,171.19803366324618,328361.7627848866,-805989.013705505,96.0,44.0,96.0,13.950011999999901,1074.0833333333333,1093.1666666666665,1112.2832843333335,1131.3666176666666,1054.9667156666665,1035.8833823333332,1016.7667646666664,0.498693021883717,21370978.0,+1
2015-01-29,1075.0,1100.599976,1061.0,1058.349976,1064.071411,5141904.0,1020.0300110000001,1035.2363759454545,95.0,76.36583088680351,-4.2182508997983446,28.1341283074305,133.72228099909626,2436414.0059597082,-658607.0573837758,96.0,40.0,92.0,28.0499880000001,1073.3166506666666,1085.6333013333333,1112.9166266666666,1125.2332773333333,1046.0333253333333,1033.7166746666667,1006.4333493333334,-0.0669198385372767,16229074.0,-1
2015-01-30,1094.550049,1094.550049,1064.25,1095.0,1046.9198,2642604.0,1033.1400086,1048.8672830363637,131.09997599999997,83.50892569407634,-0.5591030485408048,34.2040506538882,125.3097411605007,-648046.3624371246,-658127.0257925483,96.0,36.0,96.0,56.5,1084.6000163333333,1104.9500326666666,1114.9000653333333,1135.2500816666666,1074.6499836666667,1054.2999673333334,1044.3499346666667,1.0148498439722013,18871678.0,+1
2015-02-02,1068.5,1093.0,1052.349976,1077.349976,1051.049805,1427588.0,1041.5600038,1056.9054589272728,84.19995199999994,71.50078354557363,-2.321285998113882,40.855562684426786,92.1826685831842,-2490441.214547528,-741414.0348266719,92.0,32.0,52.0,50.39990200000011,1074.2333173333334,1096.1166586666668,1114.8833413333336,1136.7666826666668,1055.4666346666668,1033.5832933333334,1014.8166106666667,0.6150057869584525,17444090.0,-1
2015-02-03,1078.5,1082.199951,1055.300049,1081.599976,1034.044067,2550172.0,1049.5850038,1064.1854538727273,80.25,72.59563258499199,-1.8969649016844625,47.434104760191076,77.93392137258576,1433178.5623356036,-642568.9162591263,88.0,28.000000000000004,56.0,39.59997599999997,1073.0333253333333,1090.7666016666667,1099.9332273333334,1117.6665036666668,1063.8666996666666,1046.1334233333332,1036.9667976666665,0.9776960153981199,19994262.0,+1
2015-02-04,1063.0,1080.800049,1057.25,1064.099976,1037.542358,1549378.0,1055.5400026,1066.8245397272726,59.54998799999987,61.39044506030747,-3.644169416393836,50.450083361056386,59.49540710800094,1573360.0289855073,-541844.8727928029,84.0,24.0,60.0,36.200072999999975,1067.3833416666666,1077.5166833333333,1090.9333906666666,1101.0667323333332,1053.9666343333333,1043.8332926666667,1030.4165853333334,0.29086886400958173,18444884.0,-1
2015-02-05,1075.0,1092.800049,1070.349976,1067.699951,1046.09375,2014787.0,1060.2149965,1069.0354394363637,46.749939000000154,62.7549846352375,-3.2847469836600633,53.08090454199953,60.10623103005405,-868709.9743095145,-556702.3774776927,80.0,20.0,60.0,42.65002400000003,1076.949992,1083.5500080000002,1099.4000650000003,1106.0000810000001,1061.0999350000002,1054.499919,1038.6498620000002,-0.118040818842768,20459671.0,+1
2015-02-06,1077.0,1078.949951,1050.050049,1076.5,1023.7435300000001,1725780.0,1065.8699953,1071.9963491636363,56.5499880000001,66.13116126144412,-2.4061478212335707,56.25083631100597,42.400313616184576,-784715.9141761928,-567066.6291927459,76.0,16.0,60.0,26.89990200000011,1068.5,1086.949951,1097.399902,1115.8498530000002,1058.050049,1039.600098,1029.1501469999998,0.9152263215287012,22185451.0,+1
2015-02-09,1047.0,1051.75,1034.5,1053.5,1010.721985,1307974.0,1069.0949953,1069.747259109091,32.25,51.934053611127794,-4.702473754851605,56.69556805212437,14.263899788625498,-842102.0781436079,-579568.2405627401,72.0,12.0,60.0,24.34997599999997,1046.5833333333333,1058.6666666666665,1063.833333333333,1075.9166666666665,1041.4166666666665,1029.3333333333333,1024.1666666666665,1.1014492753623188,20877477.0,-1
2015-02-10,1030.0,1062.300049,1030.0,1040.099976,1024.666626,2318938.0,1068.8249879999998,1064.4754374181819,-2.700072999999975,45.384299318283766,-6.040335607995263,57.22967979776968,7.862405000986988,670827.7275616619,-522732.0599589077,68.0,8.0,60.0,28.700072999999975,1044.1333416666666,1058.2666833333333,1076.4333906666666,1090.5667323333332,1025.9666343333333,1011.8332926666667,993.6665853333334,0.3126922810550531,18558539.0,-1
2015-02-11,1058.0,1064.800049,1053.0,1054.449951,1028.505127,1040397.0,1066.8649782,1061.8617943272727,-19.60009799999989,52.74785813989754,-4.607630401940018,59.04799959721436,18.673024251393368,-1305331.78117592,-558304.7746998037,64.0,4.0,60.0,28.89990200000011,1057.4166666666667,1061.8333333333335,1069.2167156666665,1073.6333823333334,1050.0332843333335,1045.6166176666668,1038.2332353333336,0.12287669313916089,19598936.0,+1
2015-02-12,1065.099976,1081.900024,1052.699951,1058.400024,1045.60791,1381435.0,1066.869983,1060.3227117454544,0.05004800000006071,54.68822226335662,-4.213254094566786,57.73195846525198,22.216103738468895,-254535.35880352446,-544497.0739253286,60.0,0.0,60.0,42.0,1064.333333,1075.966715,1093.533406,1105.166788,1046.766642,1035.13326,1017.5665690000001,0.19520749143332553,20980371.0,+1
2015-02-13,1081.199951,1082.0,1063.599976,1076.0,1035.696167,1928625.0,1064.969983,1061.9827148363636,-19.0,62.58668822065757,-2.4560679502252674,51.5603027272216,29.573699324149032,48061.86115267431,-517562.57677965803,56.00000000000001,0.0,60.0,32.300048999999944,1073.8666586666666,1084.1333413333332,1092.2666826666668,1102.5333653333332,1065.7333173333332,1055.4666346666666,1047.3332933333331,0.6739134688085194,22908996.0,+1
2015-02-16,1075.800049,1085.0,1062.5,1065.800049,1037.3967289999998,1847179.0,1063.8149903,1062.1336359272727,-11.549927000000025,56.05291887958294,-3.4744336894832384,47.27734382071651,22.350745660194665,87005.60389295722,-490082.20483675634,52.0,8.0,60.0,24.700072999999975,1071.1000163333333,1079.7000326666666,1093.6000163333333,1102.2000326666666,1057.2000326666666,1048.6000163333333,1034.7000326666666,0.14666884444444198,21061817.0,-1
2015-02-18,1067.550049,1082.949951,1057.050049,1067.550049,1044.442017,1345423.0,1062.4099976,1062.8127375090908,-14.049927000000025,56.94276685345582,-3.2997132380123007,38.93973503787288,16.832681306779705,182010.56294840656,-459532.5334738901,48.0,4.0,60.0,29.200072999999975,1069.1833496666666,1081.3166503333332,1095.0832516666665,1107.2165523333333,1055.416748333333,1043.2834476666665,1029.516846333333,0.40540693937760675,22407240.0,+1
2015-02-19,1074.0,1084.900024,1063.800049,1074.800049,1049.300659,1126751.0,1063.4800049,1065.0654741272726,10.700072999999975,60.74252542426801,-2.575871367632703,33.460599770806084,22.932479461535376,725529.8176267913,-405666.0628011653,44.0,0.0,56.00000000000001,23.59997599999997,1074.5000406666666,1085.2000323333332,1095.6000156666664,1106.3000073333333,1064.100057333333,1053.4000656666665,1043.000082333333,0.521327631904775,23533991.0,+1
2015-02-20,1083.0,1089.900024,1068.5,1079.800049,1042.741455,1551506.0,1064.6900147000001,1068.032754872727,12.100097999999889,63.31847397158401,-1.4815930163245867,26.672936128303718,30.407622450055776,492030.2511446313,-364861.6847729538,40.0,0.0,44.0,22.5,1079.4000243333332,1090.3000486666665,1100.8000483333335,1111.7000726666665,1068.9000246666665,1058.0000003333332,1047.5000006666664,0.5280390807038314,25085497.0,+1
2015-02-23,1077.099976,1081.550049,1062.0,1073.050049,1037.3479,1395391.0,1064.3450196000001,1069.5527611090906,-3.4499510000000555,57.44679497097545,-2.0070373239436674,21.62017063180474,13.26221593114378,2051324.2904188232,-255035.04922458972,36.0,0.0,44.0,25.89990200000011,1072.2000326666666,1082.4000653333333,1091.7500816666666,1101.9501143333332,1062.8500163333333,1052.6499836666667,1043.2999673333334,0.565218481038077,23690106.0,-1
2015-02-24,1070.300049,1071.0,1057.099976,1067.5,1037.4938960000002,1461572.0,1065.7450196000002,1070.126393909091,14.0,52.80144316703537,-2.5457886649792214,15.758845750006003,-8.230388147969578,-5424595.377728659,-490015.06479455525,32.0,0.0,44.0,21.099975000000086,1065.199992,1073.3000080000002,1079.1000159999999,1087.2000320000002,1059.3999840000001,1051.299968,1045.49996,0.7482018736082763,22228534.0,-1
2015-02-25,1070.0,1074.800049,1050.0,1067.650024,1022.723206,1162131.0,1068.5000244,1070.4727583454546,27.55004800000006,52.920183809508764,-2.5306926705534822,10.229095174324812,-15.150953549771549,-398255.97358058643,-485844.19700129307,28.000000000000004,4.0,40.0,21.40002400000003,1064.1500243333332,1078.3000486666665,1088.9500733333334,1103.1000976666664,1053.4999996666666,1039.3499753333333,1028.6999506666666,0.7116931099611968,23390665.0,+1
2015-02-26,1053.650024,1056.0,1035.099976,1052.449951,1008.8270259999999,3106736.0,1068.3000244000002,1067.5545631818181,-2.0,40.893245262280274,-4.060182734001846,7.80658792000736,-77.49675371789033,-161881.24544018254,-471118.60825754236,24.0,0.0,36.0,19.550048999999944,1047.8499756666668,1060.5999753333335,1068.749999666667,1081.4999993333336,1039.6999513333335,1026.9499516666667,1018.7999273333335,0.8301413912251996,20283929.0,-1
2015-02-27,1045.449951,1058.550049,1045.449951,1038.150024,1024.22937,2565446.0,1066.2750244000001,1062.0727449272727,-20.25,32.80118161147372,-5.222524850801699,7.081028481389467,-86.42645636932913,-1931661.345088228,-537506.9146338827,20.0,0.0,32.0,15.950072999999975,1047.3833413333334,1049.3167316666668,1060.4834393333335,1062.4168296666667,1036.216633666667,1034.2832433333335,1023.116535666667,-0.5572421671960077,17718483.0,-1
2015-03-03,1086.449951,1092.0,1077.050049,1082.550049,1052.750366,1507337.0,1066.9300293,1065.0318403090907,6.5500489999999445,60.6779026056684,-0.9516566968781526,6.565232084365562,91.20900320860791,-780780.7856172534,-548564.8178853239,16.0,0.0,24.000000000000004,24.800048999999944,1083.8666993333334,1090.6833496666668,1098.8166503333337,1105.6333006666669,1075.7333986666667,1068.9167483333333,1060.7834476666667,0.36789418239564664,19225820.0,+1
2015-03-04,1105.0,1109.300049,1060.0,1083.349976,1035.210327,3069406.0,1068.6850220000001,1068.0172851636364,17.549927000000025,61.01410638654647,-2.5685510978333106,5.5489575184669775,88.09260645121513,-308895.20144625806,-537670.744387382,12.0,0.0,24.0,32.55004800000006,1084.216675,1108.4333499999998,1133.516724,1157.7333989999997,1059.1333009999998,1034.916626,1009.8332519999999,0.4736298740798411,22295226.0,+1
2015-03-05,1065.0,1090.0,1062.5,1065.300049,1054.450928,2425613.0,1068.460022,1067.4018355272726,-2.25,49.90491937713242,-4.355141825792389,1.697563902669799,28.584837696315255,489147.03060514317,-490997.209064594,96.0,40.0,20.0,13.100097999999889,1072.6000163333333,1082.7000326666666,1100.1000163333333,1110.2000326666666,1055.2000326666666,1045.1000163333333,1027.7000326666666,0.10181996363636162,19869613.0,-1
2015-03-09,1077.050049,1081.800049,1056.0,1085.099976,1029.088135,1438952.0,1069.4900147,1070.427281709091,10.299927000000025,59.287386495065086,-2.3953352297620225,0.9615048490472873,36.72885519739455,-1311139.658442605,-528276.4113821305,92.0,36.0,32.00000000000001,0.0,1074.3000083333334,1092.6000166666668,1100.100057333333,1118.4000656666667,1066.7999676666668,1048.4999593333334,1040.9999186666669,1.127903904368555,21308565.0,+1
2015-03-10,1062.0,1062.25,1045.0,1059.0,1022.820496,1283709.0,1067.4100098000001,1068.5200063090908,-20.800048999999944,46.142719608137796,-4.978723800893327,1.3076247250087363,-54.40950977379782,-329023.62511575373,-519219.46653489256,88.0,32.0,32.0,0.0,1055.4166666666667,1065.8333333333335,1072.666666666667,1083.0833333333335,1048.5833333333335,1038.1666666666667,1031.3333333333335,0.8115942028985508,20024856.0,-1
2015-03-11,1050.900024,1061.900024,1050.0,1052.550049,1026.610229,1366384.0,1065.3600098,1065.8181952545456,-20.5,43.399050576759784,-5.617143150311775,-0.5399131506674166,-57.80721310247643,-619440.8272519186,-523774.9829392581,84.0,28.000000000000004,16.0,0.0,1054.816691,1059.633382,1066.716715,1071.533406,1047.733358,1042.916667,1035.833334,0.2142893997524659,18658472.0,-1
2015-03-12,1060.099976,1063.900024,1051.099976,1056.449951,1024.8123779999999,1882709.0,1064.2550049000001,1064.1981845636365,-11.050048999999944,45.653523935079775,-5.231128915841505,-0.850886854497503,-49.38039201311914,246203.79779050578,-488775.94739186746,80.0,24.0,12.0,49.300048999999944,1057.1499836666667,1063.1999913333334,1069.9500316666667,1076.0000393333335,1050.3999433333333,1044.3499356666666,1037.5998953333333,0.41796522950539405,20541181.0,+1
2015-03-13,1060.0,1064.0,1034.599976,1054.599976,1013.1999509999999,1356695.0,1062.9500001000001,1062.4427247636363,-13.05004800000006,44.67945579526831,-5.414240359004474,-1.4916080938410232,-88.11187738872506,-125603.152404904,-472268.0930474113,76.0,20.0,56.0,27.5,1051.0666506666666,1067.5333253333333,1080.4666746666667,1096.9333493333334,1038.1333013333333,1021.6666266666666,1008.7332773333333,0.6802715535198196,19184486.0,-1
2015-03-16,1045.0,1057.900024,1042.5,1042.650024,1021.8486330000001,1337193.0,1061.9700074,1058.7518200181817,-9.799927000000025,38.54919983042006,-6.597052535627455,-1.489922157629735,-104.06129876927812,650358.2889433646,-421239.6210594647,72.0,16.0,56.0,25.800048999999944,1047.6833493333334,1052.8666986666667,1063.0833733333334,1068.2667226666667,1037.4666746666667,1032.2833253333333,1022.0666506666666,0.009741802999789485,17847293.0,-1
2015-03-17,1060.0,1065.900024,1042.849976,1051.550049,1028.165039,1342326.0,1063.3100099,1056.8572821272726,13.400024999999914,45.03054482276656,-5.716123646352511,-2.467108603222414,-66.28862573244042,317514.47415079625,-387659.88940920203,68.0,12.0,56.0,40.09997599999997,1053.4333496666666,1064.0167233333332,1076.4833976666664,1087.0667713333332,1040.9666753333331,1030.3833016666665,1017.916627333333,0.37744272810190904,19189619.0,+1
2015-03-18,1060.150024,1071.900024,1053.199951,1058.050049,1033.509644,1287083.0,1060.8600099,1055.9009256000002,-24.5,49.5174692221318,-5.072750422087726,-0.9792004113278381,-18.18581963130595,-323032.17188647704,-384722.2658812835,64.0,8.0,56.0,11.90002400000003,1061.050008,1068.9000649999998,1079.7500809999997,1087.6001379999998,1050.1999919999998,1042.349935,1031.4999189999999,0.25936251692706735,20476702.0,+1
2015-03-19,1071.0,1073.800049,1048.699951,1063.550049,1022.480225,1343393.0,1058.8800171999999,1056.3900236181819,-19.799927000000025,53.243659845802355,-4.528357693863677,3.3767183173022204,-10.286501520773042,10169309.255616123,95006.44028952571,60.0,4.0,56.0,12.80004800000006,1062.016683,1075.333415,1087.1167810000002,1100.433513,1050.2333170000002,1036.9165850000002,1025.1332190000003,0.5916350605483673,21820095.0,+1
2015-03-20,1051.0,1059.5,1045.949951,1052.199951,1026.075684,1620809.0,1057.5700074000001,1055.1754661272728,-13.100097999999889,45.284638277196585,-5.651796024014633,-0.005420409481075694,-59.052280297451816,-3113674.823460352,-50842.70825085225,56.00000000000001,0.0,56.0,29.40002400000003,1052.5499673333334,1059.1499836666667,1066.1000163333333,1072.7000326666666,1045.5999346666667,1038.9999183333334,1032.0498856666668,0.4612529445465493,20199286.0,-1
2015-03-23,1055.949951,1059.400024,1046.0,1055.900024,1018.155884,1361685.0,1054.6500122000002,1054.8718327818183,-29.19995199999994,48.19738074877099,-5.285560963087701,-4.555780880571774,-49.04805045824668,-1493227.5860347014,-116405.65732174419,52.0,76.0,56.0,15.40002400000003,1053.7666826666666,1061.5333653333332,1067.1667066666669,1074.9333893333333,1048.1333413333332,1040.3666586666666,1034.7333173333332,0.7388064379586192,21560971.0,+1
2015-03-24,1043.300049,1057.0,1035.449951,1047.75,1008.63269,2243391.0,1053.5250122,1053.6172851090907,-11.25,42.453530270825965,-6.092254381351609,-6.187432117030767,-87.00933517551186,1133543.3667461246,-59589.792524617864,48.0,72.0,56.0,23.25,1046.733317,1058.0166829999998,1068.2833660000001,1079.5667319999998,1036.4666339999999,1025.183268,1014.9165849999999,0.5707666372359513,19317580.0,-1
2015-03-25,1040.050049,1046.699951,1031.099976,1037.949951,1005.037231,2652225.0,1052.0650024000001,1050.7854558000001,-14.600097999999889,36.4299401479186,-7.062268092595122,-10.802145454730407,-132.03668866762266,-179313.46847678864,-65031.77780127568,44.0,68.0,56.0,20.349975000000086,1038.5832926666667,1046.0666093333334,1054.1832676666668,1061.6665843333335,1030.4666343333333,1022.9833176666666,1014.8666593333332,0.4391016652270307,16665355.0,-1
2015-03-26,1026.900024,1032.199951,1002.099976,1034.25,978.508423,8950155.0,1049.8450073000001,1047.5463644545455,-22.199951000000056,34.309290285153594,-5.6256306760847625,-11.11171522726977,-217.6830635858444,1032835.0618515398,-15128.73958180394,40.0,96.0,56.0,25.10009799999989,1022.8499756666666,1043.5999753333333,1052.9499506666666,1073.6999503333334,1013.5000003333332,992.7500006666666,983.4000253333331,1.0681079967674372,7715200.0,-1
2015-03-27,1014.9500119999999,1023.5499880000001,1008.099976,1006.9500119999999,985.9908449999999,2710224.0,1045.0800109000002,1039.7472744000002,-47.64996400000007,22.940263259686844,-7.615998501033861,-11.952091101186852,-222.9212614983244,218275.06787051467,-4519.475595854836,36.0,96.0,56.00000000000001,17.60009799999989,1012.8666586666667,1017.6333413333334,1028.3166706666668,1033.0833533333334,1002.1833293333333,997.4166466666666,986.7333173333332,-0.07443126905015081,5004976.0,-1
2015-03-30,1020.0,1039.0,1012.7999880000001,1014.650024,1007.6123660000001,1738786.0,1042.2800109,1034.214549509091,-28.0,30.441589694865456,-6.06791362604865,-13.19996413174681,-138.534108019603,-579500.7089572108,-30654.986228688034,32.0,92.0,-24.0,13.40002400000003,1022.1500040000001,1031.50002,1048.3500159999999,1057.700032,1005.3000080000002,995.9499920000002,979.0999960000003,0.07061202872731275,6743762.0,+1
2015-03-31,1039.900024,1039.900024,1014.849976,1036.900024,993.813416,1490564.0,1040.8150084,1033.2363700727274,-14.650024999999914,47.48570914950087,-3.7853942496057376,-13.346990478581574,-88.03530262852333,-1080596.0976480066,-78379.58224673898,28.000000000000004,88.0,-24.0,21.550048999999944,1030.550008,1046.25004,1055.6000559999998,1071.300088,1021.1999919999998,1005.4999599999999,996.1499439999998,0.8802397504388019,8234326.0,+1
2015-04-01,1026.099976,1036.849976,1013.0,1022.7000119999999,1004.0654910000001,961049.0,1037.2800047,1029.9427343636362,-35.35003700000004,40.227144778311455,-5.242104475930329,-11.925525770583135,-97.25338872566103,2052413.161219836,18474.633451477664,24.0,84.0,-24.0,16.65002400000003,1024.1833293333332,1035.3666586666664,1048.0333053333334,1059.2166346666663,1011.5166826666664,1000.3333533333332,987.6667066666664,0.4067095077999204,7273277.0,-1
2015-04-06,1035.0,1036.849976,1019.7999880000001,1033.25,1002.802185,1787793.0,1034.2499998,1029.2100062363636,-30.300048999999944,47.15223718265207,-4.159832474526266,-11.91429289050302,-59.74041032670237,416638.3269174084,36572.98316983193,20.0,80.0,-56.0,35.849975000000086,1029.9666546666667,1040.1333213333332,1047.0166426666665,1057.1833093333332,1023.0833333333335,1012.9166666666669,1006.0333453333336,0.7888575640053238,9061070.0,+1
2015-04-07,1033.25,1038.199951,1023.650024,1031.949951,1003.57959,1549268.0,1032.2249998000002,1028.7918155454545,-20.25,46.38807838733086,-4.2931981838667195,-13.302681873336041,-47.10157889295934,192646.21726824378,43667.22108914232,16.0,76.0,-60.0,26.15002400000003,1031.266642,1038.88326,1045.816569,1053.433187,1024.333333,1016.716715,1009.783406,0.5704445802374136,7511802.0,-1
2015-04-08,1040.050049,1042.449951,1030.050049,1032.75,1006.300476,1026536.0,1029.9099974000003,1028.8872701272728,-23.15002400000003,46.998005997705974,-4.211125044783409,-15.652561621689983,-26.44647353856444,1059786.1201254234,89854.44380832001,12.0,72.0,-60.0,32.0499880000001,1035.0833333333333,1040.1166176666666,1047.4832353333336,1052.5165196666667,1027.7167156666665,1022.6834313333331,1015.3168136666663,0.21773970471702367,8538338.0,+1
2015-04-09,1038.25,1059.0,1030.0,1035.550049,1026.270142,1750696.0,1028.6900023,1029.9127340545456,-12.199951000000056,49.3260881565778,-3.9238816246715227,-17.560393970041332,0.19986666570177758,1321084.4984971308,145819.44633547842,8.0,68.0,-60.0,25.25,1041.516683,1053.0333660000001,1070.5166829999998,1082.0333660000001,1024.0333660000001,1012.5166830000001,995.0333660000001,0.19138099999999808,10289034.0,+1
2015-04-10,1053.0,1053.0,1034.849976,1056.099976,1013.1999509999999,1529831.0,1030.5050048,1034.8963656363635,18.150024999999914,63.064640743455655,-1.8157644758181557,-20.57311539857119,26.457175772063074,515414.141220564,162619.2052057264,4.0,64.0,-60.0,23.90002400000003,1047.9833173333334,1061.1166586666668,1066.1333413333336,1079.2666826666668,1042.9666346666668,1029.8332933333334,1024.8166106666667,1.1707973499098383,11818865.0,+1
2015-04-13,1040.0,1046.300049,1034.800049,1042.650024,1009.458801,1140809.0,1031.3450072,1037.1045509454545,8.40002400000003,52.34684619069054,-1.7542921395106683,-20.197480849170006,3.485520994582789,17311.6085167389,156014.3144426946,0.0,60.0,-60.0,17.04998799999987,1041.2500406666666,1047.7000323333332,1052.7500406666663,1059.2000323333332,1036.2000323333332,1029.7500406666666,1024.7000323333332,0.6826065217391379,10678056.0,-1
2015-04-15,1040.0,1048.699951,1025.199951,1038.800049,1002.5106810000001,1223499.0,1034.5300109,1038.4600130909091,31.850037000000043,49.564717476811396,-2.1449369518133294,-18.54524149155941,-8.198272874085102,-522822.32727272727,125158.10343582375,0.0,56.00000000000001,-60.0,14.549927000000025,1037.5666503333334,1049.9333496666668,1061.0666503333337,1073.4333496666668,1026.4333496666668,1014.0666503333334,1002.9333496666668,0.5787275744680804,9454557.0,-1
2015-04-16,1028.0,1033.550049,1018.0,1031.650024,1000.5671390000001,1402530.0,1036.2300109,1037.936379109091,17.0,44.496972852151366,-2.84895583333333,-17.65625157040722,-44.06866384335592,-545219.7324070978,94686.38360611151,0.0,52.0,-60.0,12.399902000000111,1027.7333576666667,1037.4667153333335,1043.2834066666665,1053.0167643333334,1021.9166663333335,1012.1833086666668,1006.3666173333336,0.877812282134936,8052027.0,-1
2015-04-17,1025.099976,1027.849976,1016.0499880000001,1029.650024,989.4891359999999,1012253.0,1035.5050109000003,1036.7400178545454,-7.25,43.07548673590651,-3.0572891666666635,-11.650831024766148,-51.822903197738725,738876.9248481413,123967.77186151111,28.000000000000004,48.0,-60.0,29.0,1024.5166626666667,1032.983337333333,1036.3166506666662,1044.783325333333,1021.1833493333334,1012.7166746666668,1009.3833613333335,1.1525465958101042,7039774.0,-1
2015-04-20,1020.0,1025.0,1002.599976,1018.25,976.7105710000001,1297220.0,1035.0600097000001,1033.6027431454545,-4.4500119999999015,35.59649476833724,-4.244791666666667,-8.271460447187337,-82.86737265432181,491382.9469226446,140668.46164634076,24.0,44.0,-60.0,18.15002400000003,1015.2833253333333,1027.9666746666667,1037.6833493333334,1050.3666986666667,1005.5666506666666,992.8833013333333,983.1666266666666,0.6986610371488892,5742554.0,-1
2015-04-21,1005.0,1014.400024,995.599976,1005.099976,974.669983,1627686.0,1032.2450073,1028.155464290909,-28.15002400000003,28.914611037562423,-5.6145858333333365,-8.588540619435662,-121.85895773705735,869541.8091553533,173799.06836895115,20.0,40.0,-60.0,21.299927000000025,1005.0333253333333,1014.4666746666667,1023.8333733333334,1033.2667226666667,995.6666266666666,986.2332773333333,976.8665786666666,0.5053178587629121,4114868.0,-1
2015-04-22,1006.5,1021.0,993.5,1003.0,984.484558,1691484.0,1029.3500122,1022.8381902363636,-28.949951000000056,27.947943296483913,-5.833333333333333,-6.7887642527769,-115.59960023843003,1060664.5776100645,214111.13699132574,16.0,96.0,-56.00000000000001,23.5,1005.8333333333334,1018.1666666666667,1033.3333333333335,1045.6666666666667,990.6666666666667,978.3333333333334,963.1666666666667,0.34545454545454546,2423384.0,-1
2015-04-23,1020.0499880000001,1024.199951,1006.099976,1013.099976,984.873352,2406957.0,1027.3850098000003,1019.8836382000001,-19.65002400000003,39.22375144751422,-4.781252500000003,-6.284574080349103,-66.64739252092922,2907694.3268293557,336546.7365888672,12.0,96.0,-52.0,20.800048999999944,1014.4666343333333,1022.8332926666667,1032.5666093333334,1040.9332676666668,1004.7333176666666,996.3666593333332,986.6333426666665,0.38674086566417726,4830341.0,+1
2015-04-24,1018.900024,1019.0,1000.349976,1013.5,978.0225220000001,1801311.0,1025.1800049,1017.3590909636363,-22.050048999999944,39.655324051999365,-4.739583333333333,-6.374565260244935,-78.69243665545642,-1072581.1799250199,272495.467626731,8.0,92.0,-19.999999999999996,15.600035999999932,1010.949992,1021.5500079999999,1029.6000159999999,1040.200032,1002.8999839999999,992.2999679999999,984.2499599999999,0.7050942132835866,6631652.0,+1
2015-04-27,1006.9500119999999,1012.5,996.0,1006.4500119999999,977.050659,1842676.0,1020.2150085000001,1013.953637709091,-49.64996400000007,34.651598420464296,-5.473957083333344,-6.254551970563625,-106.94256277586817,864635.8158174257,299410.9380109432,4.0,88.0,-20.0,27.05004800000006,1004.9833373333332,1013.9666746666664,1021.4833373333331,1030.4666746666664,997.4666746666664,988.4833373333332,980.9666746666664,0.6333340606060547,4788976.0,-1
2015-04-28,999.5499880000001,1011.4500119999999,990.099976,1005.4500119999999,976.176147,1985527.0,1016.4950073000001,1011.269092890909,-37.20001200000013,33.95047042222201,-5.57812375000001,-6.227380604292648,-113.8416228754054,2789456.240561462,412594.81544740143,0.0,84.0,-20.0,22.65002400000003,1002.3333333333331,1014.5666906666663,1023.6833693333331,1035.9167266666664,993.2166546666664,980.9832973333332,971.8666186666665,0.7189700289029949,2803449.0,-1
2015-04-29,1004.0,1009.5,988.0,1004.5499880000001,965.0981449999999,1965891.0,1013.0700012000001,1009.0972712,-34.250060999999846,33.25177032004055,-5.67187624999999,-8.933214577527451,-114.12288457541526,3070633.4417690355,533414.7530561796,0.0,96.0,-80.0,27.5,1000.6833293333334,1013.3666586666668,1022.1833293333334,1034.8666586666668,991.8666586666668,979.1833293333334,970.3666586666668,0.7697668837209348,837558.0,-1
2015-04-30,991.0,995.0,979.0499880000001,993.150024,960.870972,3785921.0,1009.2200012000001,1005.4754571636364,-38.5,25.563037580131592,-6.8593724999999965,-11.119122055926255,-153.14324076322714,-3625164.952263143,344388.4027416572,0.0,96.0,-84.0,21.199951000000056,989.0666706666667,999.0833533333333,1005.0166826666665,1015.0333653333332,983.1333413333334,973.1166586666668,967.1833293333335,0.8840141311492442,-2948363.0,-1
2015-05-04,994.0499880000001,1009.5,992.0,988.7999880000001,972.677856,785362.0,1005.1349976000001,1001.762727490909,-40.85003599999993,23.201013958987218,-6.729561006289297,-12.959865086898617,-92.91283325877689,-251974.20226084295,317281.01159522345,40.0,96.0,-84.0,18.65002400000003,996.7666626666668,1001.5333253333336,1014.2666626666669,1019.0333253333336,984.0333253333336,979.2666626666668,966.5333253333336,-0.18285782857142294,-3733725.0,-1
2015-05-05,999.0499880000001,1003.900024,985.849976,1000.9500119999999,959.7534789999999,1284501.0,1003.4049988,1001.001821018182,-17.2999880000001,40.823064443435975,-5.027897384823614,-14.294352802261528,-81.12490473705942,2849329.763243154,432374.1367104813,36.0,92.0,-84.0,17.5,996.900004,1007.950032,1014.9500520000001,1026.00008,989.8999839999999,978.8499559999999,971.8499359999998,0.8365648667527024,-2449224.0,+1
2015-05-06,987.5,987.5,965.5,987.650024,943.185059,2751924.0,1001.6600036,998.1372801454545,-17.44995199999994,31.65029074985999,-6.42833843844223,-16.53704850247493,-125.38929179376923,-1885406.4655688955,327020.4729352514,32.0,88.0,-84.0,21.350035999999932,980.2166746666667,994.9333493333334,1002.2166746666667,1016.9333493333334,972.9333493333334,958.2166746666667,950.9333493333334,1.006819272727274,-5201148.0,-1
2015-05-07,968.0,970.0,944.2000119999999,970.599976,924.4302369999999,2934166.0,998.4200012,992.4900024,-32.40002400000003,23.75494205291676,-6.735869637731941,-18.125914688628995,-159.10298302076626,622339.4109004275,340444.0610288658,28.000000000000004,96.0,-96.0,21.5,961.5999959999999,978.9999799999999,987.399984,1004.799968,953.1999919999998,935.8000079999998,927.4000039999997,1.023254894537159,-8135314.0,-1
2015-05-08,961.5,987.7999880000001,955.400024,951.2999880000001,954.263,2892983.0,992.2400023999999,983.9227272727272,-61.79998799999987,17.91721833709518,-8.241372662747409,-20.30747309483229,-121.57077940638146,53437.78732309265,327398.321310989,24.0,96.0,-96.0,25.5,964.8333333333335,974.2666426666669,997.2332973333337,1006.666606666667,941.8666786666669,932.4333693333334,909.4667146666668,-0.12654446159260926,-11028297.0,-1
2015-05-11,986.0499880000001,992.75,974.0499880000001,982.0,962.328552,1682836.0,989.0900024,982.0609086545454,-31.5,43.4319167040886,-4.643628509719223,-21.155024031354515,-57.66514640586464,-1699711.3679824045,235256.97177083313,20.0,92.0,-56.0,17.5,982.9333293333334,991.8166706666667,1001.6333413333333,1010.5166826666666,973.1166586666668,964.2333173333335,954.4166466666669,0.4251340587374994,-9345461.0,+1
2015-05-12,990.0,990.0,967.0,990.2999880000001,944.4968869999999,2776892.0,987.475,982.2809060363637,-16.150023999999803,48.432296481643036,-3.6640688278635625,-21.94085568360083,-50.174436773346606,216466.29581511847,234402.85013624516,16.0,88.0,-56.0,18.05004800000006,982.4333293333334,997.8666586666668,1005.4333293333334,1020.8666586666668,974.8666586666668,959.4333293333334,951.8666586666668,1.0130429565217434,-6568569.0,+1
2015-05-13,975.849976,993.400024,971.599976,971.9500119999999,962.2799679999999,1947962.0,984.1250000000001,979.4581809454545,-33.5,39.52058975313853,-5.647421289152247,-24.32556896863548,-52.04185877795929,-1234605.6999340486,167629.73420625002,12.0,84.0,-56.0,35.4500119999999,978.9833373333332,986.3666986666665,1000.7833853333332,1008.1667466666665,964.5666506666664,957.1832893333332,942.7666026666664,0.01605666189358532,-8516531.0,-1
2015-05-14,989.0,994.849976,974.0,990.25,963.057434,1113797.0,982.6950012000002,980.5718173090909,-14.299988000000099,50.08851086070226,-3.6694717680546067,-24.86229151331895,-26.664571772524955,198046.9963397317,169012.33703084922,8.0,80.0,-68.0,43.45001200000013,986.3666586666667,998.7333173333334,1007.2166346666668,1019.5832933333334,977.8833413333334,965.5166826666667,957.0333653333334,0.7793773959260204,-7402734.0,+1
2015-05-15,994.900024,997.5499880000001,984.2000119999999,991.0499880000001,962.134277,2038406.0,982.4849976,982.0909058181818,-2.100035999999932,50.5245767415923,-3.038044782608685,-25.459173125444522,-10.050498613020471,225661.50494911175,171587.2992095743,4.0,76.0,-72.0,32.39996400000007,990.9333293333334,997.6666466666669,1004.2833053333337,1011.0166226666671,984.3166706666667,977.5833533333332,970.9666946666665,0.5131077389202869,-5364328.0,+1
2015-05-18,996.0,1012.0,992.0,990.099976,981.326355,1428326.0,982.6149964,983.4754473454545,1.2999879999998711,49.926881843705424,-2.4521099069512897,-26.04718755936824,12.493665780523294,9.944484421215373,163788.32853845018,0.0,72.0,-72.0,41.4500119999999,998.0333253333333,1004.0666506666666,1018.0333253333333,1024.0666506666666,984.0666506666666,978.0333253333333,964.0666506666666,-0.09500120000000152,-6792654.0,-1
2015-05-19,1006.349976,1018.0,998.099976,1009.849976,979.0913699999999,1196587.0,983.5049928,988.4272618181818,8.899964000000068,60.99518414259603,-0.88683612622416,-24.467414602986082,44.10696338179758,-116093.23553643351,151066.439259518,0.0,68.0,-72.0,23.0,1008.649984,1019.1999920000001,1028.5500080000002,1039.100016,999.299968,988.74996,979.399944,0.5904515492041609,-5596067.0,+1
2015-05-20,1009.650024,1026.800049,1009.5499880000001,1007.5499880000001,995.125427,1002210.0,985.4949892,992.7990791272728,19.899964000000068,59.235775067563765,-2.0748070686941564,-20.962584876073834,60.7119909292236,-285519.5882214033,131221.61982439618,4.0,64.0,-72.0,21.80004800000006,1014.6333416666668,1019.7166953333334,1031.8834026666664,1036.9667563333333,1002.4666343333336,997.3832806666669,985.2165733333337,-0.11594161898905853,-6598277.0,-1
2015-05-21,1024.0,1030.0,1015.099976,1024.050049,995.7568970000001,983595.0,990.8399965000001,999.8090900000001,53.450072999999975,67.0929747703286,-0.6390924812030135,-19.451456355864252,82.73865221889064,1156246.0328213058,177813.63860633023,0.0,60.0,-72.0,22.899964000000068,1023.0500083333333,1031.0000406666666,1037.9500323333332,1045.9000646666666,1016.1000166666665,1008.1499843333332,1001.1999926666665,0.6006750727381349,-5614682.0,+1
2015-05-22,1024.699951,1029.0,1018.349976,1024.699951,995.3683470000001,1172384.0,998.1799928,1005.9654453636363,73.39996299999996,67.37873359413742,-0.5692856068743227,-16.220493436014635,85.03238867301826,-1052713.9446202854,121880.56663077288,0.0,56.00000000000001,-72.0,13.349976000000197,1024.0166423333333,1029.6833086666666,1034.666666333333,1040.3333326666666,1019.0332846666665,1013.3666183333332,1008.3832606666665,0.596240440397136,-4442298.0,+1
2015-05-25,1028.400024,1031.0,1017.599976,1024.300049,994.6394650000001,1092265.0,1002.4099977,1010.714546490909,42.300048999999944,66.96585907633491,-0.7188788626609501,-10.794259782749918,82.22572740830736,541629.8844935957,140960.0810825707,92.0,52.0,-72.0,20.9500119999999,1024.3000083333334,1031.0000406666668,1037.7000323333336,1044.4000646666668,1017.6000166666668,1010.8999843333334,1004.1999926666667,0.5000045522306497,-5534563.0,-1
2015-05-26,1024.449951,1030.199951,1018.0499880000001,1023.5499880000001,998.380676,1226586.0,1005.7349977,1014.558181090909,33.25,66.0894272522369,-0.7993575107296033,-2.3051529549416045,76.66186998041957,907814.3973954322,175817.09546651013,96.0,48.0,-68.0,27.90002400000003,1023.9333090000001,1029.8166300000003,1036.0832719999999,1041.966593,1017.6666670000002,1011.7833460000002,1005.5167040000002,0.45267627563968876,-6761149.0,-1
2015-05-27,1023.7999880000001,1040.0,1021.400024,1027.400024,1008.8270259999999,804648.0,1011.2799989,1018.4972767818183,55.45001200000013,68.52888310458428,-1.3389985122210382,1.9013192595252804,90.84125071896982,199268.72900043617,176883.07880913885,92.0,44.0,-60.0,17.250060999999846,1029.600016,1037.8000080000002,1048.1999920000003,1056.3999840000001,1019.2000320000002,1011.0000400000001,1000.6000560000002,0.32258106139491843,-5956501.0,+1
2015-05-28,1039.050049,1043.699951,1022.2000119999999,1038.150024,1000.324219,2390290.0,1016.0700013,1023.3827358909091,47.90002400000003,74.45040609919937,-0.5874803946083855,4.736335694793411,106.65363374873749,-106409.07237713017,164006.16284407937,96.0,40.0,-60.0,22.4500119999999,1034.683329,1047.1666460000001,1056.1832680000002,1068.6665850000002,1025.6667069999999,1013.1833899999998,1004.1667679999997,0.7418631280767827,-3566211.0,+1
2015-05-29,1029.949951,1054.0,1027.150024,1029.400024,1020.876953,1264670.0,1019.9050049,1025.8063763818182,38.35003599999993,63.26980275889668,-2.5759137172774835,10.13931280757322,109.01506189250077,939211.1889474792,199242.75494503588,96.0,36.0,-56.00000000000001,10.65002400000003,1036.850016,1046.5500080000002,1063.6999920000003,1073.3999840000001,1019.7000320000002,1010.0000400000001,992.8500560000002,0.0837989575856605,-4830881.0,-1
2015-06-01,1048.949951,1056.0,1031.0,1050.550049,1006.9321289999999,960330.0,1025.9500122,1031.3782025818182,60.450072999999975,74.1125297120318,-0.5694828631139034,14.642438719366055,124.37807882966962,895933.232622108,230910.50393494475,96.0,32.0,40.0,13.40002400000003,1045.8500163333333,1060.7000326666666,1070.8500163333333,1085.7000326666666,1035.7000326666666,1020.8500163333333,1010.7000326666666,0.7820019599999978,-3870551.0,+1
2015-06-02,1038.400024,1040.300049,1004.900024,1036.199951,980.306091,1181502.0,1028.5850097000002,1033.2418278181817,26.349975000000086,60.200064119544905,-2.0689706374085626,19.13079131479776,59.49042918626705,644753.2594428654,249721.53827881493,96.0,28.000000000000004,48.0,12.149962999999957,1027.1333413333334,1049.3666586666668,1062.5333663333336,1084.7666836666667,1013.9666336666669,991.7333163333335,978.566608666667,0.8841781043939969,-5052053.0,-1
2015-06-03,1009.0,1017.0,998.0,1008.7999880000001,977.147827,1456208.0,1028.7100097,1029.6445511454547,1.25,42.587068468192896,-4.93208066875652,23.028349482824297,1.6683705745775539,-1116264.0197716418,187631.2856319625,92.0,24.0,48.0,18.59997599999997,1007.9333293333334,1017.8666586666668,1026.9333293333334,1036.8666586666668,998.8666586666668,988.9333293333334,979.8666586666668,0.5684204210526368,-6508261.0,-1
2015-06-04,1008.849976,1017.849976,995.0,1005.5499880000001,986.2823490000001,1389397.0,1026.8600036,1025.433638109091,-18.500060999999846,40.94744410035396,-5.271683594566342,24.3089436839565,-9.892528299874092,1711113.0707170323,256880.4576900086,88.0,20.0,56.0,21.499939000000154,1006.1333213333334,1017.2666426666667,1028.9832973333332,1040.1166186666667,994.4166666666667,983.2833453333334,971.5666906666668,0.46170674314931937,-7897658.0,-1
2015-06-05,1010.25,1018.5,1002.5,1014.9500119999999,983.1727289999999,1688465.0,1025.8850097,1023.2681850909091,-9.749939000000154,47.67104859173021,-4.289444932079426,26.215565067220155,0.17804062690845962,-47305.05799899074,243053.8433388458,84.0,16.0,60.0,26.84997599999997,1011.9833373333332,1021.4666746666664,1027.983337333333,1037.4666746666664,1005.4666746666664,995.9833373333332,989.4666746666664,0.7781257499999938,-6209193.0,+1
2015-06-08,1004.25,1012.25,995.5499880000001,1011.75,975.107178,952999.0,1024.6300048,1020.6981833272729,-12.550048999999944,45.630309764447006,-4.623824451410658,25.139404516271384,-19.278579407527765,496354.64348626113,254567.51607414093,80.0,12.0,64.0,26.59997599999997,1006.5166626666668,1017.4833373333335,1023.2166746666668,1034.1833493333334,1000.7833253333336,989.8166506666669,984.0833133333336,0.9700599017533639,-7162192.0,-1
2015-06-09,1005.0,1006.0,997.099976,1003.4500119999999,973.552307,1510065.0,1022.6200071999998,1016.8472755454544,-20.099976000000197,40.448209743603485,-5.491116823406489,23.416668179331964,-35.86692313341999,325198.37002857367,257778.00943605785,76.0,8.0,68.0,45.650024999999914,1002.1833293333333,1007.2666826666666,1011.0833533333334,1016.1667066666666,998.3666586666666,993.2833053333333,989.4666346666666,0.7134852670060114,-8672257.0,-1
2015-06-10,998.0,1019.0,997.0,1001.849976,986.914001,1996562.0,1020.0650023999999,1013.0709062363636,-25.55004800000006,39.451617765005196,-5.658309717868342,22.357228710168215,-29.450768854290036,657290.7739440105,275937.6805519552,72.0,4.0,68.0,38.199951000000056,1005.949992,1014.8999839999999,1027.9499919999998,1036.899984,992.8999839999999,983.949992,970.8999839999999,0.22045345454545318,-10668819.0,-1
2015-06-11,1017.599976,1018.5499880000001,994.7000119999999,1015.599976,971.949036,2273544.0,1017.8099975999997,1012.2590832545454,-22.55004800000006,51.33974213247131,-4.221528108672939,20.822600231026286,-23.14914310764184,-1628629.3043205622,189366.45395819715,68.0,0.0,68.0,22.84997599999997,1009.6166586666667,1024.5333053333334,1033.4666346666668,1048.3832813333338,1000.6833293333333,985.7666826666665,976.8333533333331,0.8763096449237473,-8395275.0,+1
2015-06-12,1001.0,1010.849976,990.150024,1000.2000119999999,980.64624,1632086.0,1014.8899964,1009.057267690909,-29.20001200000013,40.94952585687421,-5.830719749216311,17.181137915186582,-59.986855679315,-381959.6468540068,163397.08573698558,64.0,0.0,68.0,16.0,1000.400004,1010.6499839999999,1021.099956,1031.3499359999998,989.950032,979.700052,969.25008,0.48550779248183284,-10027361.0,-1
2015-06-15,1002.0,1013.75,1000.0,1009.150024,976.8078,1499957.0,1010.7499939,1008.0136363454546,-41.400024999999914,48.00583116717123,-4.895504284221523,10.772888494775998,-37.42598394051616,-1170524.007230135,102764.30877841871,60.0,4.0,68.0,19.400023999999803,1007.6333413333333,1015.2666826666666,1021.3833413333332,1029.0166826666666,1001.5166826666666,993.8833413333333,987.7666826666666,0.6654562909090931,-8527404.0,+1
2015-06-16,1000.0,1010.4500119999999,997.0499880000001,1005.2000119999999,979.917358,1502631.0,1007.6500000000001,1007.0045487272728,-30.999939000000154,45.25213659892326,-5.308253709508892,7.033387826100466,-53.17940731264704,-710672.2291349829,65789.92068823513,56.00000000000001,0.0,68.0,14.65002400000003,1004.2333373333332,1011.4166866666664,1017.633361333333,1024.816710666666,998.0166626666665,990.8333133333334,984.6166386666667,0.6082096569379221,-10030035.0,-1
2015-06-17,1009.0,1013.5,999.5,1008.400024,976.32196,2421567.0,1007.6100036000001,1007.1409167272727,-0.39996400000006815,48.03829781596257,-4.973874190177635,0.6000332202320351,-43.39488435866162,383922.41502326325,80250.48861375324,52.0,0.0,68.0,22.0,1007.1333413333333,1014.7666826666666,1021.1333413333332,1028.7666826666666,1000.7666826666666,993.1333413333333,986.7666826666666,0.6357160000000022,-7608468.0,+1
2015-06-18,1005.900024,1023.7999880000001,1002.25,1004.7000119999999,990.801025,2107929.0,1007.5250060000001,1006.6118273454546,-0.849976000000197,44.98409753889428,-5.360500313479634,-5.577553047308697,-30.43945574870894,-3217731.673712943,-69657.79150386687,48.0,0.0,68.0,23.849976000000197,1010.25,1018.25,1031.7999880000002,1039.7999880000002,996.7000119999999,988.7000119999999,975.1500239999998,0.11368971527965074,-9716397.0,-1
2015-06-19,1024.800049,1034.949951,1013.150024,1019.599976,1001.3931269999999,935581.0,1007.9900024000001,1008.8072764363635,4.649964000000068,57.53045157552427,-3.8035552769070042,-6.74993432232543,37.53368395241724,548059.6317144394,-41579.726810005035,44.0,0.0,64.0,25.44995199999994,1022.5666503333333,1031.9832766666666,1044.3665773333332,1053.7832036666666,1010.1833496666666,1000.7667233333333,988.3834226666665,0.29587034855666866,-8780816.0,+1
2015-06-22,1032.099976,1056.900024,1028.5,1030.5,1017.572876,1362413.0,1009.8650023999999,1012.9000032727271,18.75,64.38597339826529,-2.75603124945741,-7.14914841816767,165.62299362032772,1736142.422270973,39225.82542677406,40.0,76.0,56.0,13.75,1038.6333413333334,1048.7666826666668,1067.0333653333337,1077.1667066666669,1020.3666586666668,1010.2333173333334,991.9666346666668,0.07042247569931624,-7418403.0,+1
2015-06-23,1052.0,1061.199951,1042.5,1047.150024,1022.383057,1413795.0,1014.2350035999998,1019.6790981090909,43.70001200000013,72.27424099398532,-1.4601878731544462,-8.462392447898765,243.60560500394632,-508787.096598662,14316.147151176412,96.0,72.0,56.00000000000001,13.400023999999803,1050.283325,1058.0666500000002,1068.983276,1076.7666010000003,1039.3666990000002,1031.583374,1020.6667480000001,0.24866503660892034,-6004608.0,+1
2015-06-24,1054.0,1057.800049,1042.699951,1052.099976,1016.261108,1566849.0,1019.2600035999999,1026.5636385454545,50.25,74.23206731916127,-0.9457467744144674,-7.938972745836281,191.02232422544097,-201634.38778063984,4500.213744539971,96.0,68.0,52.0,14.0,1050.8666586666666,1059.033366333333,1065.9667566666662,1074.133464333333,1043.9332683333332,1035.7665606666667,1028.8331703333333,0.6225141717623278,-4437759.0,+1
2015-06-25,1048.25,1070.849976,1042.650024,1045.800049,1034.918701,4143392.0,1022.2800109,1031.3891013454545,30.200072999999975,67.25754938607648,-2.577550817370193,-6.412131447591037,168.28196257993622,1985933.7380381464,94565.37394535121,92.0,64.0,48.0,21.5499880000001,1053.1000163333333,1063.5500086666666,1081.2999683333333,1091.7499606666665,1035.3500566666667,1024.9000643333334,1007.1501046666667,0.11170320431750809,-8581151.0,-1
2015-06-26,1067.0,1070.949951,1051.5,1065.0,1032.829224,1411876.0,1028.7600097,1039.156372090909,64.7999880000001,75.38894907424363,-0.6121663974444765,-2.898038462198315,177.80236997722153,-630576.1105866323,61604.39737374281,96.0,60.0,44.0,30.249939000000154,1062.483317,1073.4666339999999,1081.9332679999998,1092.916585,1054.0166829999998,1043.033366,1034.5667319999998,0.6940891522040319,-7169275.0,+1
2015-06-29,1044.900024,1061.75,1030.5,1062.849976,1026.804443,1621959.0,1034.1300049,1045.3545477818182,53.69995199999994,73.04506513830147,-0.8333736723445841,-0.9895303522898757,111.82262993331284,107275.60606060608,63680.361405082476,96.0,56.00000000000001,-36.0,37.30004800000006,1051.699992,1072.8999840000001,1082.9499919999998,1104.1499840000001,1041.6499840000001,1020.4499920000001,1010.3999840000001,1.035199231999999,-8791234.0,-1
2015-06-30,1052.25,1072.0,1048.0,1056.650024,1037.0079349999999,1822534.0,1039.2750061000002,1049.449096709091,51.45001200000013,66.19711768085048,-1.5775926002055467,3.1641512351932306,123.85285364706534,-238931.07692307694,49925.296025779644,92.0,52.0,24.0,30.699951000000056,1058.8833413333334,1069.7666826666668,1082.8833413333332,1093.7666826666668,1045.7666826666668,1034.8833413333334,1021.7666826666668,0.3604176666666679,-10613768.0,-1
2015-07-01,1061.349976,1077.0,1060.050049,1067.150024,1042.061035,1242797.0,1045.1500061000002,1054.5172817818182,58.75,71.43089308265756,-1.0071550102249458,6.691920609426916,132.54402135162334,2506137.5098112514,161571.30574911294,96.0,48.0,28.0,15.100097999999889,1068.066691,1076.083333,1085.016642,1093.033284,1059.133382,1051.11674,1042.183431,0.41887879203898953,-9370971.0,+1
2015-07-02,1065.0,1067.699951,1055.650024,1072.349976,1036.039917,1120861.0,1051.9150025000001,1059.4627308545455,67.64996400000007,73.75308228031167,-0.47546257668711966,11.553202649712148,102.0548268372733,29143.376520826354,155551.85442025537,96.0,44.0,28.0,28.19995199999994,1065.233317,1074.8166099999999,1077.2832439999997,1086.8665369999999,1062.7666829999998,1053.18339,1050.7167559999998,1.3858965286677591,-8250110.0,+1
2015-07-03,1054.050049,1076.150024,1054.050049,1058.199951,1051.7536619999998,1009822.0,1055.775,1060.6054487636366,38.599975000000086,58.757315958018026,-1.9222953987730003,16.781322635848028,83.0371073454568,-711895.047088458,116122.44980435279,92.0,40.0,36.0,25.14990200000011,1062.800008,1071.549967,1084.8999829999998,1093.649942,1049.4499919999998,1040.7000329999998,1027.3500169999998,0.18777858345994033,-9259932.0,-1
2015-07-06,1064.050049,1085.0,1060.25,1074.25,1060.810059,816945.0,1060.15,1063.9645396727274,43.75,67.4255817546314,-1.09026369168357,22.897156431124813,96.15027124300705,-795637.3569955723,74678.82222066165,88.0,36.0,39.99999999999999,34.5,1073.1666666666667,1086.0833333333335,1097.916666666667,1110.8333333333335,1061.3333333333335,1048.4166666666667,1036.5833333333335,0.5656565656565656,-8442987.0,+1
2015-07-07,1078.5,1091.5,1078.5,1083.5,1064.0898439999999,1035368.0,1063.7849976,1068.209994218182,36.34997599999997,71.42005861152053,-0.8060453400503778,29.080744773930974,107.22757478036624,392550.4543072408,89127.53277067604,96.0,32.0,40.0,24.0,1084.5,1090.5,1097.5,1103.5,1077.5,1071.5,1064.5,0.38461538461538464,-7407619.0,+1
2015-07-08,1079.099976,1080.599976,1066.0,1086.849976,1046.466797,1350169.0,1067.2599976000001,1072.4036266545456,34.75,72.81318171652558,-0.46851627204030527,33.45912859830946,75.97901561072572,-772603.0946433096,49957.9587956972,96.0,28.000000000000004,48.0,20.34997599999997,1077.8166506666666,1089.6333013333333,1092.4166266666666,1104.2332773333333,1075.0333253333333,1063.2166746666667,1060.4333493333334,1.4280828954787332,-6057450.0,+1
2015-07-09,1062.699951,1076.900024,1060.099976,1068.849976,1051.557983,699491.0,1069.5649902999999,1072.6927136363638,23.049927000000025,55.91514250540576,-2.282118287153655,33.714123530603274,46.37094020409418,-2072456.827936833,-46515.44060503486,92.0,24.0,52.0,12.049927000000025,1068.6166586666666,1077.1333413333332,1085.4167066666664,1093.9333893333333,1060.3332933333331,1051.8166106666665,1043.533245333333,0.520831845242345,-6756941.0,-1
2015-07-10,1069.800049,1095.0,1068.5,1074.050049,1067.908325,1225022.0,1070.4699952,1073.5081788545456,9.050048999999944,59.08062650397309,-2.1034087349397645,33.32745613214365,57.8373301805187,111412.61441606034,-39336.892649260706,88.0,20.0,52.0,22.099975000000086,1079.1833496666666,1089.8666993333331,1105.6833496666668,1116.3666993333331,1063.3666993333331,1052.6833496666666,1036.8666993333331,0.20943581132075262,-5531919.0,+1
2015-07-13,1085.0,1105.900024,1085.0,1090.75,1073.1951900000001,1769021.0,1073.2599976,1077.1954524545454,27.90002400000003,67.6801389508075,-1.5046204825594511,34.96788992935876,77.0773380722535,-464599.3161611772,-58667.00280958682,96.0,16.0,52.0,26.800048999999944,1093.8833413333334,1102.7666826666668,1114.7833653333337,1123.6667066666669,1081.8666586666668,1072.9833173333334,1060.9666346666668,0.2751193012984096,-3762898.0,+1
2015-07-14,1095.5,1101.900024,1086.0,1096.150024,1068.985107,1418529.0,1077.2099976000002,1081.3572754363636,39.5,70.03008938067708,-0.9683185785682332,34.08037783188729,68.75054233146285,742583.6087911017,-22246.520462853638,96.0,12.0,64.0,17.25,1094.6833493333334,1103.3666986666667,1110.5833733333334,1119.2667226666667,1087.4666746666667,1078.7833253333333,1071.5666506666666,0.6383653257378737,-2344369.0,+1
2015-07-15,1093.0,1101.449951,1090.800049,1091.849976,1073.733521,962351.0,1079.6799928,1084.019089690909,24.69995199999994,65.64464089896985,-1.3953766675051802,32.934343579865526,59.87150960666301,-615749.9671215152,-49223.94985731109,92.0,8.0,68.0,17.5,1094.699992,1098.5999350000002,1105.3498940000004,1109.2498370000003,1087.950033,1084.05009,1077.300131,0.09858560200835784,-3306720.0,-1
2015-07-16,1098.800049,1119.0,1098.099976,1096.699951,1091.356689,1827606.0,1082.1149903,1087.1136275454546,24.349975000000086,68.23352419088994,-2.186279313725485,32.77431057900503,69.85273426658748,918656.1886962461,-5229.398103503804,88.0,4.0,68.0,26.75,1104.5999756666668,1111.0999753333335,1125.499999666667,1131.9999993333336,1090.1999513333335,1083.6999516666667,1069.2999273333335,-0.06698676518265778,-1479114.0,+1
2015-07-17,1119.400024,1121.75,1105.599976,1114.699951,1087.293701,877747.0,1087.7649903000001,1093.0381658545455,56.5,75.98361146455537,-0.6893228061598576,32.62824337563734,79.71382221814581,24629.84359283257,-3872.159844538996,96.0,0.0,68.0,26.5,1114.0166423333333,1122.4333086666666,1130.166666333333,1138.5833326666666,1106.2832846666665,1097.8666183333332,1090.1332606666665,0.5634651069249228,-601367.0,+1
2015-07-20,1115.949951,1119.0,1107.0,1110.550049,1091.895142,1137817.0,1091.3949952,1097.1809038,36.300048999999944,71.35275274341556,-1.0950819848447866,30.827792336473067,67.53530957712876,993746.4248445202,41474.13946079848,96.0,4.0,80.0,31.849975000000086,1112.1833496666666,1117.3666993333331,1124.1833496666668,1129.3666993333331,1105.3666993333331,1100.1833496666666,1093.3666993333331,0.295837416666662,-1739184.0,-1
2015-07-21,1116.550049,1128.0,1093.099976,1115.25,1075.05542,2757034.0,1094.5699952,1101.5181774,31.75,73.46598831372765,-1.239067055393586,31.809415738383677,61.54955565172322,-1083495.6220248882,-9660.849699029652,92.0,0.0,84.0,15.90002400000003,1112.1166586666666,1131.1333413333332,1147.0166826666668,1166.0333653333332,1096.2333173333332,1077.2166346666666,1061.3332933333331,0.6346707383353092,1017850.0,+1
2015-07-22,1096.400024,1117.050049,1088.650024,1098.050049,1091.0629880000001,1821600.0,1095.6900025,1102.1509144545455,11.200072999999975,56.01711039166758,-2.9105880466472356,30.114814577152174,37.21663928723456,-456446.96276326885,-29969.309384293923,96.0,0.0,84.0,10.649902000000111,1101.2500406666666,1113.850057333333,1129.6500656666663,1142.250082333333,1085.4500323333332,1072.8500156666666,1057.0500073333333,0.33098650441328636,-803750.0,-1
2015-07-23,1112.900024,1116.699951,1100.099976,1114.400024,1084.6990970000002,1270793.0,1100.2450073,1105.5527365454545,45.55004800000006,65.10697792041891,-1.3216691933916396,27.78349027617969,50.8300066236091,-208290.41346906553,-38074.81411562035,92.0,0.0,84.0,27.15002400000003,1110.3999836666667,1120.6999913333334,1126.9999586666668,1137.2999663333335,1104.1000163333333,1093.8000086666666,1087.5000413333332,0.8614499720632102,467043.0,+1
2015-07-24,1103.150024,1115.0,1100.5,1107.900024,1084.6501460000002,1190252.0,1103.6300048,1106.9445577636363,33.849975000000086,59.46917512423374,-1.9533504373177812,24.59272084207373,41.71308832444613,-227541.61595834204,-46686.941472310995,88.0,0.0,96.0,25.050048999999944,1107.800008,1115.1000159999999,1122.3000080000002,1129.6000159999999,1100.6000159999999,1093.300008,1086.1000159999999,0.5103464827586228,-723209.0,-1
2015-07-27,1103.900024,1104.5,1070.0,1107.849976,1072.901367,832143.0,1105.3400024,1107.7118252545454,17.09997599999997,59.42345982624925,-1.9582141885325588,24.87575474355549,10.736014971898298,557900.7587013248,-19205.682372890155,84.0,0.0,92.0,12.0,1094.1166586666666,1118.2333173333332,1128.6166586666668,1152.7333173333332,1083.7333173333332,1059.6166586666666,1049.2333173333332,1.0971007536231876,-1555352.0,-1
2015-07-28,1094.0,1113.900024,1092.449951,1095.849976,1085.286499,1586418.0,1105.3099976,1105.9863659090909,-0.3000480000000607,49.0020531624016,-3.124394946550052,25.0366742395438,21.983185901871146,460452.4871736739,2596.961697877141,80.0,16.0,92.0,34.90002400000003,1100.733317,1109.0166829999998,1122.1833899999997,1130.4667559999998,1087.5666099999999,1079.283244,1066.1165369999999,0.1585087845621746,-3141770.0,-1
2015-07-29,1105.099976,1117.900024,1105.050049,1108.5,1085.139648,985758.0,1106.975,1106.5663663454545,16.65002400000003,57.96817551718738,-1.8950437317784257,24.37239266111169,41.73647164387674,-824556.0,-35000.900198252806,76.0,12.0,96.0,28.400024999999914,1110.4833576666667,1115.9166663333335,1123.3333326666666,1128.7666413333336,1103.0666913333334,1097.6333826666666,1090.2167163333334,0.2684791993758768,-2156012.0,+1
2015-07-30,1107.0,1117.0,1101.099976,1108.349976,1087.293701,2365547.0,1108.1400025000003,1106.816361981818,11.650024999999914,57.82904727293568,-1.9096233236151634,23.31997690726689,32.94725082535868,-141273.40040030953,-39831.46838935005,72.0,8.0,92.0,18.64990200000011,1108.8166506666666,1116.5333253333333,1124.7166746666667,1132.4333493333334,1100.6333013333333,1092.9166266666666,1084.7332773333333,0.45597415450442,-4521559.0,-1
2015-07-31,1115.599976,1121.0,1103.0,1110.550049,1088.370605,1412375.0,1107.7250123000003,1107.2545522545454,-4.149902000000111,59.47483828715931,-1.6958164237123474,22.571743902419257,35.03617389673176,525761.874115182,-14122.680093208583,68.0,4.0,88.0,14.5,1111.516683,1120.0333660000001,1129.5166829999998,1138.0333660000001,1102.0333660000001,1093.516683,1084.0333660000001,0.4194471666666636,-3109184.0,+1
2015-08-03,1112.75,1117.5,1093.449951,1111.650024,1072.4608150000001,1086432.0,1107.8350098,1107.9681907454546,1.0999750000000859,60.36713716845454,-1.588918950437315,22.456086926258422,22.107843429979642,-476393.62393702177,-35134.99572284801,64.0,0.0,84.0,37.90002400000003,1107.533325,1121.6166990000002,1131.5833740000003,1145.666748,1097.5666500000002,1083.4832760000002,1073.5166010000003,0.7567582502638567,-2022752.0,+1
2015-08-04,1098.099976,1102.0,1081.949951,1095.400024,1063.698242,1347732.0,1105.8500122,1105.7072842363636,-19.84997599999997,43.893092766316926,-3.16812206025267,19.29486583904327,-20.13323366956365,289587.15400518954,-20374.89800768564,60.0,0.0,64.0,21.450072999999975,1093.1166583333334,1104.2833656666667,1113.1667073333333,1124.3334146666666,1084.2333166666667,1073.0666093333334,1064.1832676666668,0.6708249441185911,-3370484.0,-1
2015-08-05,1092.150024,1097.699951,1085.199951,1086.449951,1069.3278810000002,1030695.0,1104.6900024000001,1102.1800003818182,-11.600097999999889,37.4058481128833,-4.037905636540326,15.897175493887516,-34.583723806267294,1479347.0736363493,47794.28252269775,56.00000000000001,8.0,64.0,22.05004800000006,1089.7832843333333,1094.3666176666666,1102.283284333333,1106.8666176666666,1081.8666176666666,1077.2832843333333,1069.3666176666666,0.1,-4401179.0,-1
2015-08-06,1091.900024,1101.349976,1085.449951,1092.199951,1072.999268,935928.0,1102.4699951000002,1099.9090819454545,-22.200072999999975,43.5865260275087,-3.4791106899902764,12.420235483406486,-30.92207665916714,-451965.3512862527,25077.935531029038,52.0,4.0,64.0,15.90002400000003,1092.9999593333334,1100.5499676666668,1108.8999843333336,1116.4499926666667,1084.649942666667,1077.0999343333335,1068.749917666667,0.4245276343905143,-3465251.0,+1
2015-08-07,1093.949951,1097.5,1088.599976,1095.949951,1069.768555,806785.0,1101.2749878000002,1098.723619381818,-11.950072999999975,47.48836400653217,-3.11467920310981,11.5840246430148,-34.2443842769817,-1078600.4938631644,-25089.26580581434,48.0,0.0,64.0,18.0,1094.0166423333333,1099.4333086666666,1102.916666333333,1108.3333326666666,1090.5332846666665,1085.1166183333332,1081.6332606666665,0.825837660662495,-2658466.0,+1
2015-08-10,1095.0,1105.949951,1088.0,1092.650024,1071.7265630000002,988594.0,1099.7549926000002,1097.1554441454546,-15.19995199999994,44.37221331746475,-3.4353718172983454,7.418433141444893,-32.31574339468264,625053.0,4462.655367595384,44.0,12.0,64.0,24.050048999999944,1095.533325,1103.0666500000002,1113.483276,1121.0166010000003,1085.1166990000002,1077.583374,1067.166748,0.2590549690079943,-3647060.0,-1
2015-08-11,1095.050049,1098.849976,1084.25,1094.650024,1071.7753910000001,681922.0,1099.6349974,1096.2272680363637,-1.1999519999999393,46.81289512234805,-2.5782755381604665,4.971826461674937,-52.20081932303429,222300.75855512996,14364.387330798876,40.0,8.0,60.0,29.700072999999975,1092.5833333333333,1100.9166666666665,1107.1833093333335,1115.5166426666665,1086.3166906666665,1077.9833573333333,1071.7167146666666,0.7123315819149327,-2965138.0,+1
2015-08-12,1088.400024,1094.900024,1067.699951,1094.699951,1048.033325,1501435.0,1098.2549925,1095.3299868727274,-13.800048999999944,46.88002728040645,-2.5733903131115405,2.9560909815506875,-91.08414897179662,669767.0620906629,44155.41800208588,36.0,4.0,48.00000000000001,12.5,1085.766642,1103.833333,1112.966715,1131.033406,1076.63326,1058.566569,1049.433187,0.9926443947411474,-1463703.0,+1
2015-08-13,1077.0,1082.699951,1066.599976,1070.449951,1054.9846189999998,866263.0,1094.4649900000002,1090.2745247818182,-37.900024999999914,27.457403395819327,-4.94618874755381,2.0959513998107013,-162.0945912105006,497626.61562841514,64767.7451671727,32.0,0.0,48.0,15.900024999999914,1073.2499593333334,1079.899942666667,1089.3499343333337,1095.999917666667,1063.7999676666668,1057.1499843333334,1047.6999926666667,0.239129253306298,-2329966.0,-1
2015-08-14,1083.099976,1103.650024,1079.900024,1077.550049,1078.726807,900415.0,1091.16499,1087.1990809636363,-33.0,36.3642094418234,-4.251462915851278,-1.6082499940334856,-69.04331706563492,2249042.118708738,164052.9439656829,28.000000000000004,96.0,48.0,8.90002400000003,1087.0333656666667,1094.1667073333333,1110.7833656666667,1117.9167073333333,1070.4167073333333,1063.2833656666667,1046.6667073333333,-0.0989463157894773,-1429551.0,+1
2015-08-17,1099.050049,1101.800049,1075.800049,1101.800049,1068.642578,625053.0,1090.1799925,1089.1327280545454,-9.849975000000086,57.11483811351676,-1.8786644814090074,-4.614944049523274,-27.381199524748407,7315750.029725095,489130.08423111954,24.0,92.0,32.0,17.949951000000056,1093.1333823333332,1110.4667156666665,1119.133382333333,1136.4667156666665,1084.4667156666665,1067.1333823333332,1058.4667156666665,1.0,-804498.0,+1
2015-08-18,1091.599976,1096.099976,1078.449951,1091.5,1063.60022,464329.0,1089.7899901,1089.3727294181817,-3.9000240000000304,49.244974804215914,-2.886497064579256,-7.346433945671151,-46.77763074878445,11595.307431380006,467423.9580127172,20.0,88.0,32.0,14.59997599999997,1088.683309,1098.916667,1106.333334,1116.5666919999999,1081.266642,1071.033284,1063.6166170000001,0.7393784994638822,-1268827.0,-1
2015-08-19,1084.849976,1087.0,1075.0,1086.349976,1059.194458,751144.0,1089.7799926,1088.747272309091,-0.09997500000008586,45.61855844400012,-3.3904133072407077,-10.265303637211446,-79.42097833330213,-76627.07810001374,442694.3654618858,16.0,84.0,32.0,27.200072999999975,1082.7833253333333,1090.5666506666666,1094.7833253333333,1102.5666506666666,1078.5666506666666,1070.7833253333333,1066.5666506666666,0.9458313333333308,-2019971.0,-1
2015-08-20,1068.0,1084.75,1068.0,1081.849976,1052.194214,761213.0,1088.7449951,1087.3054511090909,-10.349975000000086,42.46569507810249,-3.830726418786696,-11.522344673601765,-97.47233488753382,-2264344.3123658267,319647.15283215337,12.0,80.0,32.0,28.099975000000086,1078.199992,1088.3999840000001,1094.9499919999998,1105.1499840000001,1071.6499840000001,1061.449992,1054.8999840000001,0.8268642388059684,-2781184.0,-1
2015-08-21,1064.0,1072.949951,1051.0,1074.699951,1039.074951,1939743.0,1086.6199950999999,1084.7518067272727,-21.25,37.69003812304855,-4.202263033873338,-11.487190015188162,-154.68468594956562,-1067230.1229109683,256607.2766614246,8.0,76.0,-68.0,33.200072999999975,1066.216634,1081.4332680000002,1088.166585,1103.3832190000003,1059.4833170000002,1044.266683,1037.5333660000001,1.0797268294585256,-4720927.0,-1
2015-08-24,1044.699951,1044.699951,1011.25,1061.300049,997.709717,3671582.0,1083.4849976,1080.1481801636364,-31.349975000000086,30.317319559255253,-4.434172915511677,-11.499877593505289,-268.48366040365386,369430.04670710827,261735.58439081945,4.0,96.0,-68.0,26.0,1039.0833333333333,1066.9166666666665,1072.5332843333335,1100.3666176666666,1033.4667156666665,1005.6333823333332,1000.0167646666664,1.4962667359363206,-8392509.0,-1
2015-08-25,1024.699951,1032.300049,1005.7000119999999,1019.0499880000001,997.1222529999999,3086980.0,1075.924994,1068.4327238727274,-75.60003599999993,17.712195890220755,-8.630018097096064,-13.500341472171613,-282.9806479863713,3754827.9707187037,420512.5110434336,0.0,96.0,-68.0,23.35009799999989,1019.016683,1032.3333539999999,1045.61672,1058.933391,1005.7333169999999,992.4166459999999,979.1332799999999,0.5018780988913728,-11479489.0,-1
2015-08-26,1017.400024,1029.0,1009.0,1018.4500119999999,992.27594,1393250.0,1068.3000001,1057.9827271454544,-76.24993900000015,17.592346857491123,-8.689601594707277,-15.073996395657332,-210.71020742272066,93709.71157732478,405657.8383403084,28.000000000000004,96.0,-68.0,16.5,1018.8166706666666,1028.6333413333332,1038.8166706666666,1048.6333413333332,1008.6333413333332,998.8166706666666,988.6333413333332,0.47250059999999505,-12872739.0,-1
2015-08-27,1025.0,1034.449951,1009.099976,1013.5,1000.6958619999999,3468358.0,1062.605005,1048.0190907636365,-56.949951000000056,16.52772475430163,-9.181186305057981,-18.456891046615056,-163.12293335284602,-2409754.8319739937,277684.5351432147,24.0,92.0,-68.0,18.34997599999997,1019.0166423333334,1028.9333086666668,1044.3666173333336,1054.2832836666669,1003.5833336666667,993.6666673333333,978.2333586666666,0.17357113764412058,-16341097.0,-1
2015-08-28,1031.050049,1042.75,1019.400024,1022.099976,1006.4232789999999,1388284.0,1057.0599977000002,1040.6545400363636,-55.450072999999975,25.558512524394175,-8.327124393494318,-21.027549573303986,-109.20721423247392,3794217.3989403294,437526.93804426276,20.0,88.0,-68.0,30.84997599999997,1028.0833333333333,1036.7666426666665,1051.433309333333,1060.1166186666665,1013.4166666666665,1004.7333573333333,990.0666906666665,0.11562975482287188,-14952813.0,+1
2015-08-31,1021.099976,1032.900024,1015.5499880000001,1027.949951,1005.933777,860365.0,1049.6749879000001,1035.361804272727,-73.85009799999989,31.38500386760535,-7.534969510934881,-20.789913606813116,-96.06798959507576,103841.79868730559,422359.4317097488,16.0,84.0,-92.0,63.449951000000056,1025.4666543333335,1035.3833206666668,1042.8166903333336,1052.7333566666669,1018.033284666667,1008.1166183333336,1000.683248666667,0.7146937908370914,-14092448.0,+1
2015-09-01,1021.2999880000001,1021.2999880000001,993.0,1027.449951,979.156494,2617286.0,1043.2699830000001,1031.3208884727273,-64.05004899999994,31.144601498990696,-7.584738085867001,-21.703585415907128,-104.85384177070125,-1020795.8646385566,356761.4636934758,12.0,80.0,-96.0,55.60003700000004,1013.9166463333335,1034.833292666667,1042.2166343333336,1063.133280666667,1006.5333046666668,985.6166583333334,978.2333166666667,1.2173132723589826,-16709734.0,-1
2015-09-02,1005.099976,1013.9500119999999,985.0,1000.099976,974.310242,2170422.0,1034.6449830000001,1023.4717962909091,-86.25,20.994712011711485,-10.30707664622522,-27.789804877371807,-116.29928090732494,-1793918.565935984,259003.28052787314,8.0,96.0,-68.0,20.0,999.6833293333333,1014.3666586666666,1028.6333413333332,1043.3166706666666,985.4166466666667,970.7333173333334,956.4666346666668,0.5215879012416306,-18880156.0,-1
2015-09-03,1002.2999880000001,1015.0,999.0,995.150024,989.1430050000001,1626842.0,1025.9749878,1016.2908946545455,-86.69995199999994,19.656927591684777,-10.799780760270005,-32.453011426086505,-94.5992349295669,1045679.921125536,294761.3096461677,4.0,96.0,-68.0,25.349975000000086,1003.050008,1007.1000160000001,1019.0500080000002,1023.1000160000001,991.1000160000001,987.050008,975.1000160000001,-0.2406234999999981,-20506998.0,-1
2015-09-04,1002.2000119999999,1006.0,980.0,1010.2999880000001,975.191345,2851148.0,1019.5349915,1013.440894690909,-64.39996299999996,34.41526680708172,-9.124457172817694,-36.6399319443517,-86.94894688789658,-391067.7577202312,263587.26112933096,0.0,92.0,-68.0,29.25,998.7666626666668,1017.5333253333336,1024.766662666667,1043.5333253333336,991.5333253333336,972.7666626666668,965.5333253333336,1.1653841538461576,-17655850.0,+1
2015-09-07,1001.0,1009.7999880000001,980.0,996.0499880000001,963.834351,1345435.0,1013.0099854000001,1009.1708940545453,-65.25006099999985,28.694668703554115,-10.034097924800259,-40.99866769484311,-77.82146322397837,-323000.0795196302,236924.200190593,0.0,96.0,-68.0,17.350035999999932,995.2833253333334,1010.5666506666669,1025.0833133333335,1040.3666386666669,980.7666626666668,965.4833373333333,950.9666746666667,0.538590418224331,-19001285.0,-1
2015-09-08,986.7000119999999,1010.0,977.0,984.4500119999999,983.0238039999999,1861122.0,1009.5499878000002,1003.9781716181817,-34.5999760000002,24.819632404357748,-10.379553441295556,-45.19934001955312,-72.3104795043261,1092557.9094015646,275816.6415185716,16.0,92.0,-68.0,34.949951000000056,990.4833373333332,1003.9666746666664,1023.4833373333331,1036.9666746666664,970.9666746666664,957.4833373333332,937.9666746666664,0.2257579393939364,-20862407.0,-1
2015-09-09,1014.5,1025.0,1005.0,1004.0499880000001,995.017273,1638280.0,1008.1099854000001,1002.9781716545456,-14.400023999999803,40.48804882155548,-8.186661120973868,-48.64744413055678,-34.64006696039166,-857874.2905981635,224285.23551300346,12.0,96.0,-88.0,42.449951000000056,1011.349996,1017.6999920000001,1031.349996,1037.699992,997.6999920000001,991.349996,977.6999920000001,-0.04750059999999508,-19224127.0,+1
2015-09-10,1003.0,1016.9500119999999,996.2999880000001,1016.2999880000001,989.828308,1115935.0,1008.3899842000001,1004.4672630363636,2.7999880000000985,48.26382005060535,-5.8165168489237855,-46.796562941446155,-31.922036206665673,-2951564.842093371,79928.41380292221,8.0,92.0,-92.0,16.0,1009.849996,1023.400004,1030.50002,1044.0500279999997,1002.7499800000002,989.1999720000002,982.0999560000004,0.9685218767784576,-18108192.0,+1
2015-09-11,1014.5,1020.0,1006.7999880000001,1011.0,989.3388060000001,1075440.0,1007.2799866000001,1004.9418113636364,-11.09997599999997,45.308492628995765,-3.563492941325113,-44.59833828232058,-23.23428150704373,467226.0722092378,97532.85282147264,4.0,88.0,-92.0,26.0,1012.599996,1018.400004,1025.8000079999997,1031.6000159999999,1005.1999920000001,999.3999840000001,991.9999800000002,0.31818243801596036,-19183632.0,-1
2015-09-14,1008.849976,1022.2999880000001,1003.5,1010.5,998.3461300000001,1265086.0,1005.5349915000002,1005.5272683454546,-17.449951000000056,45.00849252687909,-3.4172185430463573,-41.43048954994242,-19.34334170867407,894226.6337338402,133746.20649946766,0.0,84.0,-96.0,30.2999880000001,1012.099996,1020.6999920000001,1030.8999840000001,1039.49998,1001.900004,993.3000079999999,983.1000159999999,0.37234066319616604,-20448718.0,-1
2015-09-15,1017.9500119999999,1019.650024,1008.099976,1019.7000119999999,991.9332890000001,1083182.0,1004.7599976,1008.1027266181818,-7.749939000000154,51.786153837913396,-2.4423828344370966,-39.35755229722042,-9.593545679309596,-400432.3402453121,109465.36346551155,12.0,80.0,-76.0,33.0,1015.8166706666666,1023.5333653333332,1027.3667186666667,1035.0834133333333,1011.9833173333332,1004.2666226666665,1000.4332693333331,1.0043279473816793,-19365536.0,+1
2015-09-16,1018.900024,1028.099976,1011.5499880000001,1013.150024,1001.919678,1063513.0,1006.0650024000001,1009.6281859636364,13.05004800000006,47.02499158852231,-3.1364212980132415,-38.14729569791325,-1.9229133619168568,962819.6336399016,148254.1939281401,8.0,76.0,-84.0,40.5499880000001,1017.599996,1023.650004,1034.1499839999997,1040.1999919999998,1007.1000160000001,1001.0500080000002,990.5500280000002,0.09667898248626793,-20429049.0,-1
2015-09-18,1035.0,1062.0,1031.150024,1023.349976,1027.766846,1960292.0,1008.8849975999999,1012.7709084363637,28.19995199999994,54.53561780289805,-4.013501973001041,-36.684383373275864,42.28889030170433,-25631.863721369133,140350.28221676836,4.0,72.0,-84.0,20.650023999999803,1038.8333333333333,1046.5166426666665,1069.683309333333,1077.3666186666665,1015.6666666666665,1007.9833573333333,984.8166906666665,-0.25283805731323966,-18468757.0,+1
2015-09-21,1037.949951,1055.0,1036.349976,1049.75,1030.899658,1069172.0,1012.8299988,1020.2009088727273,39.4500119999999,68.05949006935708,-1.272066458982347,-32.20836444187819,62.66731169191435,-330923.38298355404,118928.75198031143,0.0,68.0,-84.0,13.200011999999901,1047.0333253333333,1057.7166746666667,1065.6833493333334,1076.3666986666667,1039.0666506666666,1028.3833013333333,1020.4166266666666,0.7184990217706964,-17399585.0,+1
2015-09-22,1050.050049,1060.0,1025.300049,1052.949951,1009.066772,1506303.0,1018.5199951000001,1027.4954456363637,56.89996299999996,69.33521376127023,-0.9397766355140129,-26.155758289723963,61.57103183094221,-920189.7268385158,71696.09385201741,0.0,64.0,-84.0,18.7999880000001,1046.0833333333333,1066.8666176666666,1080.783284333333,1101.5665686666666,1032.1666666666665,1011.3833823333332,997.4667156666665,0.7968282721782537,-15893282.0,+1
2015-09-23,1019.2000119999999,1053.449951,1018.650024,1030.650024,1027.2282710000002,1290288.0,1023.1399963000001,1029.7009054363637,46.20001200000013,52.48051826312136,-3.2554492211837975,-20.857237293269577,37.34152471481998,96829.60994214113,72838.52640157231,0.0,60.0,-68.0,11.55004800000006,1034.2499996666668,1049.8499753333335,1069.049926666667,1084.6499023333336,1015.0500483333335,999.4500726666668,980.2501213333335,0.34482830955363764,-17183570.0,-1
2015-09-24,1047.0,1054.0,1036.0,1049.199951,1029.382202,2063209.0,1027.6549926000002,1034.439079018182,45.14996299999996,61.470303393110186,-1.3291847352024866,-13.411962819915402,67.13008565576128,-3406619.116335611,-85318.6391778955,0.0,56.00000000000001,-68.0,16.54998799999987,1046.3999836666667,1056.7999673333334,1064.3999836666667,1074.7999673333334,1038.7999673333334,1028.3999836666667,1020.7999673333334,0.7333306111111142,-15120361.0,+1
2015-09-28,1055.0,1060.0,1043.099976,1051.400024,1024.487061,1444277.0,1031.1649962000001,1038.7563574545452,35.10003599999993,62.4426374460309,-1.1007244029075773,-4.044104041401852,80.3626772482783,277124.7183797045,-68843.94110704529,0.0,52.0,-68.0,48.84997599999997,1051.5,1059.900024,1068.400024,1076.800048,1043.0,1034.599976,1026.099976,0.49112640313410477,-13676084.0,+1
2015-09-29,1032.0,1073.900024,1025.099976,1046.400024,1042.501709,2604710.0,1034.7049986000002,1041.5263625090909,35.40002400000003,58.566911597832565,-2.820802064109909,2.8261531862199263,74.10254618451607,-716427.4285566541,-98279.55417302222,0.0,48.0,-68.0,31.65002400000003,1048.4666746666667,1071.8333733333334,1097.2667226666667,1120.6334213333334,1023.0333253333333,999.6666266666666,974.2332773333333,0.4364759641220032,-16280794.0,-1
2015-09-30,1068.0,1073.0,1061.349976,1064.800049,1046.4179689999999,2256949.0,1040.1350035000003,1046.9981898545452,54.300048999999944,67.2090643031844,-0.9334264823035932,8.454092314758782,124.93517273959263,596245.2018186036,-66710.24708240612,96.0,44.0,-64.0,34.699951000000056,1066.3833416666666,1071.4167073333333,1078.0333656666667,1083.0667313333333,1059.7666833333333,1054.7333176666666,1048.1166593333332,0.2961429950702218,-14023845.0,+1
2015-10-01,1075.199951,1076.900024,1059.349976,1068.800049,1045.291992,1258697.0,1045.0450072,1052.2100163090909,49.10003700000004,68.83937462962852,-0.8283029758878587,14.510244874618706,125.23080585047482,-523461.9249701895,-87471.6869864513,92.0,40.0,-60.0,34.799927000000025,1068.3500163333333,1077.3500566666667,1085.9000643333334,1094.9001046666667,1059.8000086666666,1050.7999683333333,1042.2499606666665,0.5384642252830273,-12765148.0,+1
2015-10-05,1077.199951,1104.800049,1077.199951,1067.650024,1075.348999,2013343.0,1050.4950072000001,1056.3200193636364,54.5,67.72239823290496,-3.693579557580626,18.43916112251577,148.470099080748,-31318.47960115448,-84919.26846893136,96.0,36.0,-56.00000000000001,23.34997599999997,1083.2166746666667,1089.2333983333333,1110.8167726666666,1116.8334963333332,1061.6333003333334,1055.6165766666668,1034.0332023333335,-0.34601061923765863,-14778491.0,-1
2015-10-06,1107.0,1107.900024,1083.0,1098.349976,1063.20874,1189741.0,1057.9950072000001,1065.0209227818182,75.0,78.4785501388549,-0.9465802133829724,22.240301919029775,158.16055948945794,292908.8765308303,-67745.26187799164,96.0,32.0,-52.0,16.90002400000003,1096.4166666666667,1109.8333333333335,1121.3166906666665,1134.7333573333335,1084.9333093333335,1071.5166426666667,1060.0332853333334,0.6164643054159286,-13588750.0,+1
2015-10-07,1088.0,1098.349976,1083.349976,1085.949951,1064.971069,1096567.0,1061.6150023,1070.1036398363638,36.199951000000056,67.9287956327768,-2.175644016041769,26.812641243746157,114.18690156426489,-30039.181941332496,-66031.34915359408,96.0,28.000000000000004,-48.0,48.80004800000006,1089.2166343333333,1095.0832926666667,1104.2166343333333,1110.0832926666667,1080.0832926666667,1074.2166343333333,1065.0832926666667,0.17333166666667238,-14685317.0,-1
2015-10-08,1088.099976,1090.699951,1075.400024,1087.75,1060.418457,970477.0,1065.0950072,1074.8554576,34.800048999999944,68.6350253639264,-1.997227031486326,31.05739545952838,85.8717443153673,-506574.4516129032,-86056.03562906128,92.0,24.0,52.0,26.59997599999997,1084.6166583333334,1093.8332926666667,1099.9165853333334,1109.1332196666667,1078.5333656666667,1069.3167313333333,1063.2334386666666,0.807191825163607,-13714840.0,+1
2015-10-09,1095.0,1095.0,1080.199951,1083.099976,1063.404541,860807.0,1070.3400024,1078.129088290909,52.44995199999994,64.40750254418104,-2.458127407081919,32.25875702790495,73.25144238771408,-1335680.1379238742,-142857.1311880357,88.0,20.0,52.0,17.55004800000006,1086.0999756666668,1092.0000003333334,1100.900024666667,1106.8000493333334,1077.1999513333335,1071.2999266666668,1062.3999023333336,0.19594698639172917,-14575647.0,-1
2015-10-12,1087.699951,1095.5,1077.800049,1086.150024,1057.9219970000001,554335.0,1074.0350097,1081.0036376727273,36.950072999999975,65.99279881901867,-2.1558132106853827,33.22774267773116,61.99172129438791,314772.4253720548,-122055.78770798989,84.0,16.0,60.0,36.0,1086.4833576666667,1095.1666663333335,1104.183308666667,1112.8666173333336,1077.4667153333335,1068.7834066666667,1059.7667643333334,0.4717513059781951,-14021312.0,+1
2015-10-13,1075.550049,1082.150024,1073.199951,1080.550049,1053.809692,455913.0,1076.9500122,1082.188190272727,29.150024999999914,60.3027449408605,-2.7108706858351788,35.686413112398895,40.68936223445308,123450.24934432577,-110896.42238740875,80.0,12.0,64.0,40.25,1078.6333413333334,1084.0667316666668,1087.5834143333336,1093.0168046666668,1075.1166586666668,1069.6832683333334,1066.1665856666668,0.8212333016725014,-14477225.0,-1
2015-10-14,1068.800049,1086.5,1067.050049,1076.349976,1062.033936,687287.0,1079.9450074,1082.0790927818182,29.94995199999994,56.11556317311972,-3.127172886260141,35.46251352117292,32.02790255814491,76564.63570779529,-102375.46520124754,76.0,8.0,68.0,15.0,1076.6333416666666,1086.2166343333333,1096.0832926666667,1105.6665853333334,1066.7666833333333,1057.1833906666666,1047.3167323333332,0.4781465516288447,-15164512.0,-1
2015-10-15,1085.699951,1096.5,1081.0,1084.75,1061.446533,981488.0,1081.9400025,1082.9527278,19.949951000000056,62.176238798927365,-2.294580577787758,36.25651747873826,45.61442271799627,-1242950.1459445844,-154219.7688714896,72.0,4.0,68.0,15.299927000000025,1087.4166666666667,1093.8333333333335,1102.916666666667,1109.3333333333335,1078.3333333333335,1071.9166666666667,1062.8333333333335,0.24193548387096775,-14183024.0,+1
2015-10-16,1090.0,1101.5,1085.0,1084.150024,1077.013428,1210922.0,1083.475,1083.354549890909,15.349975000000086,61.47652397803171,-2.3540489082196707,37.07451199358934,43.28763501645085,412073.07380142587,-128479.18511358698,68.0,0.0,68.0,14.800048999999944,1090.2166746666667,1095.4333493333334,1106.7166746666667,1111.9333493333334,1078.9333493333334,1073.7166746666667,1062.4333493333334,-0.05151369696969513,-15393946.0,-1
2015-10-19,1100.0,1102.099976,1094.300049,1100.050049,1074.810547,663555.0,1086.7150025,1086.3681951636363,32.400024999999914,71.33923384187143,-0.7780726348758701,35.212963618915865,51.87635782434758,-797371.3564004495,-158883.37471758356,64.0,4.0,68.0,17.699951000000056,1098.8166913333332,1103.3333336666665,1106.616618333333,1111.1332606666665,1095.5334066666665,1091.0167643333332,1087.7334796666664,0.7371863864879737,-14730391.0,+1
2015-10-20,1098.0,1102.900024,1091.199951,1097.800049,1071.971436,962839.0,1086.6600098000001,1088.3836581636365,-0.5499270000000251,68.47672783083846,-1.001087794601944,34.04838965706517,44.07224463810559,-735978.3897958224,-185114.96631208874,60.0,0.0,68.0,12.950072999999975,1097.300008,1103.4000649999998,1109.0000809999997,1115.1001379999998,1091.6999919999998,1085.599935,1079.9999189999999,0.5641074205263423,-15693230.0,-1
2015-10-21,1098.900024,1104.0,1085.0,1094.900024,1072.069214,1818301.0,1087.5550171000002,1089.8818425636364,8.950072999999975,64.6205609478187,-1.2885320339728727,33.8454027712753,35.08687257466243,982243.5862068965,-132053.21392478535,56.00000000000001,4.0,68.0,19.449951000000056,1094.6333413333334,1104.2666826666668,1113.6333413333332,1123.2666826666668,1085.2666826666668,1075.6333413333334,1066.2666826666668,0.5210538947368437,-17511531.0,-1
2015-10-23,1099.449951,1113.699951,1096.0,1095.0,1085.286499,1116762.0,1088.2800171000001,1091.2354758181818,7.25,64.69963498981983,-1.8429044942370414,29.063850688200546,44.889200955594134,436824.7530042594,-106195.12451888395,52.0,0.0,68.0,20.15002400000003,1101.5666503333334,1107.1333006666669,1119.2666013333337,1124.833251666667,1089.4333496666668,1083.8666993333334,1071.7333986666667,-0.0564973315462849,-16394769.0,+1
2015-10-26,1113.949951,1114.199951,1097.0,1108.5,1078.433105,1221996.0,1090.8200195,1094.9118363454545,25.40002400000003,73.81729552239902,-0.5614609215047189,26.118994766128026,49.55525886263768,1090145.1246691186,-51816.02228299396,96.0,0.0,68.0,16.75,1106.5666503333334,1116.1333006666669,1123.7666013333337,1133.333251666667,1098.9333496666668,1089.3666993333334,1081.7333986666667,0.6686065559140234,-15172773.0,+1
2015-10-27,1095.550049,1114.0,1095.550049,1101.5,1087.63623,2246008.0,1092.3550171,1096.8536509818182,15.34997599999997,63.937025204339676,-1.250980261325885,23.25959402575745,40.49538816742028,-248884.93496017772,-60773.70013196812,96.0,0.0,60.0,17.94995199999994,1103.6833496666666,1111.8166503333332,1122.1333006666669,1130.2666013333333,1093.3666993333331,1085.2333986666665,1074.916748333333,0.32249142558698596,-17418781.0,-1
2015-10-28,1105.050049,1124.0,1105.050049,1110.900024,1088.223755,1923690.0,1095.3900146,1100.2254704181819,30.349975000000086,70.1314816758572,-1.2780464390243873,20.81662977404858,60.5170986097159,-222437.4736779503,-68122.05347497614,92.0,12.0,60.0,11.700072999999975,1113.316691,1121.583333,1132.266642,1140.533284,1102.633382,1094.36674,1083.683431,0.3087066029880536,-15495091.0,+1
2015-10-29,1110.0,1114.5,1100.0,1111.5,1080.440186,1675592.0,1098.905017,1103.1545586727273,35.15002400000003,70.50460185954748,-1.2195121951219512,18.597981682643876,45.125610642168695,726044.8944204518,-32023.555843324382,96.0,8.0,52.00000000000001,19.0,1108.6666666666667,1117.3333333333335,1123.166666666667,1131.8333333333335,1102.8333333333335,1094.1666666666667,1088.3333333333335,0.7931034482758621,-13819499.0,+1
2015-10-30,1102.0,1112.0,1090.449951,1103.550049,1076.5727539999998,2024365.0,1100.7850219,1103.9991099454546,18.800048999999944,59.19825185199091,-1.9951171707317128,18.641659843595335,25.2607274040231,-486524.5543307701,-52682.692138230894,92.0,4.0,52.0,18.799927000000025,1102.0,1113.550049,1123.550049,1135.100098,1092.0,1080.449951,1070.449951,0.6078917964409233,-15843864.0,-1
2015-11-02,1095.050049,1095.900024,1076.5,1099.599976,1060.418457,789138.0,1102.3300171,1103.7836470545456,15.44995199999994,54.213947338891316,-2.3804901463414665,19.50958307839801,-9.29654527021083,6304568.309219972,236283.2624692621,88.0,0.0,96.0,19.199951000000056,1090.6666666666667,1104.8333333333335,1110.0666906666665,1124.2333573333335,1085.4333093333335,1071.2666426666667,1066.0332853333334,1.1907189393167728,-16633002.0,-1
2015-11-03,1090.949951,1092.0,1079.199951,1083.099976,1062.180786,637148.0,1100.6350098,1100.2872759454544,-16.950072999999975,38.564215103986356,-3.990246243902442,17.5298224571618,-29.955016246767745,1065573.412885868,273978.26930641814,84.0,8.0,96.0,18.449951000000056,1084.7666423333333,1090.3333336666665,1097.566691333333,1103.1333826666664,1077.5332846666665,1071.9665933333333,1064.7332356666666,0.3046882867401469,-17270150.0,-1
2015-11-04,1090.050049,1098.099976,1078.25,1084.900024,1059.047607,674111.0,1099.3450073,1097.4263694363638,-12.900024999999914,40.71830844263833,-3.814631804878046,16.833177035457084,-21.89150658282147,928717.5085474243,303739.1438174013,80.0,4.0,80.0,22.5,1087.0833333333333,1095.9166666666665,1106.9333093333335,1115.7666426666665,1076.0666906666665,1067.2333573333333,1056.2167146666666,0.3350142085814129,-16596039.0,+1
2015-11-05,1078.5,1083.0,1069.5,1081.699951,1057.23645,899238.0,1098.025,1094.2181773818184,-13.200072999999975,37.98623092901608,-4.126834048780482,13.961402711016262,-53.41143012929558,-368584.0227375257,273178.9998830587,76.0,0.0,88.0,14.5,1078.0666503333334,1086.6333006666669,1091.5666503333332,1100.1333006666669,1073.1333006666669,1064.5666503333334,1059.6333006666669,0.9037000740740782,-17495277.0,-1
2015-11-06,1080.699951,1089.0,1075.25,1079.849976,1058.264526,1470251.0,1096.5099976000001,1090.9136275636363,-15.15002400000003,36.35892859655378,-4.307319414634149,10.882139484494019,-42.58310735774407,351482.10740917333,276738.23204333975,72.0,4.0,88.0,21.550048999999944,1081.3666586666666,1087.4833173333332,1095.1166586666668,1101.2333173333332,1073.7333173333332,1067.6166586666666,1059.9833173333332,0.33454370909090686,-18965528.0,-1
2015-11-09,1058.0,1069.650024,1051.0,1080.900024,1042.501709,2857358.0,1093.75,1088.0754505454545,-27.59997599999997,38.09574434374156,-4.20487570731707,9.240006468932506,-97.29583653849956,295674.7947263423,277598.98489256785,68.0,0.0,88.0,27.050048999999944,1067.1833493333334,1083.3666986666667,1085.8333733333334,1102.0167226666667,1064.7166746666667,1048.5333253333333,1046.0666506666666,1.6032163819199365,-16108170.0,+1
2015-11-10,1060.050049,1065.0,1052.449951,1064.800049,1032.515259,1100645.0,1090.0800049000002,1082.811823090909,-36.699951000000056,25.69151212047005,-5.775604975609761,7.333228397960966,-119.70458294140944,-896180.7456214818,224245.3607782507,64.0,96.0,76.0,20.400024999999914,1060.75,1069.050049,1073.300049,1081.600098,1056.5,1048.199951,1043.949951,0.9840677116081334,-17208815.0,-1
2015-11-13,1049.400024,1055.0,1041.0,1054.599976,1030.018677,985007.0,1084.4500001000001,1076.3609087454545,-56.30004800000006,20.752043059329992,-6.770734048780492,3.0131716957057506,-152.78699567217956,-140589.73936197182,207661.94713550084,60.0,92.0,76.0,19.84997599999997,1050.199992,1059.3999840000001,1064.1999919999998,1073.3999840000001,1045.3999840000001,1036.199992,1031.3999840000001,0.9714268571428549,-18193822.0,-1
2015-11-16,1048.75,1065.0,1045.25,1052.050049,1038.732178,1183683.0,1078.505005,1070.4700085454544,-59.449951000000056,19.661650332757844,-7.019507414634152,1.1891499611690506,-122.7867181749792,370348.6927839466,215056.7992104355,56.00000000000001,96.0,76.0,15.40002400000003,1054.1000163333333,1062.9500326666666,1073.8500163333333,1082.7000326666666,1043.2000326666666,1034.3500163333333,1023.4500326666666,0.34430627848100986,-19377505.0,-1
2015-11-17,1063.300049,1063.800049,1051.199951,1060.949951,1038.585449,641851.0,1074.2449952,1067.2781805454545,-42.60009799999989,33.69266405049329,-6.1512242926829215,-2.7834675518979566,-97.0492958028662,-307179.0402646583,191318.80650700585,52.0,92.0,68.0,13.75,1058.6499836666667,1066.1000163333333,1071.2500816666666,1078.7001143333332,1053.4999183333334,1046.0498856666668,1040.8998203333335,0.7738035053378225,-18735654.0,+1
2015-11-18,1061.699951,1065.849976,1046.300049,1060.800049,1026.6408689999998,611680.0,1070.3650025,1064.8336448727273,-38.799927000000025,33.578691564329105,-6.165848878048786,-7.135179242229697,-93.73380971179554,1465241.8041064523,249224.39730701866,48.0,88.0,68.0,28.84997599999997,1057.6500246666667,1069.0000003333334,1077.199951666667,1088.5499273333335,1049.4500733333334,1038.1000976666667,1029.9001463333334,0.7416907490242793,-19347334.0,-1
2015-11-19,1055.0,1070.949951,1049.599976,1048.599976,1046.5158689999998,819420.0,1066.9150025,1060.8763673272726,-34.5,25.483506731033046,-7.356099902439027,-11.402530361522622,-88.07920905727269,-1242439.388235294,181421.4979641438,44.0,84.0,-32.0,28.450072999999975,1056.383301,1063.1666260000002,1077.7332760000004,1084.5166010000003,1041.816651,1035.033326,1020.466676,-0.046838462340119645,-20166754.0,-1
2015-11-20,1064.900024,1080.25,1060.0,1068.900024,1048.424927,1162040.0,1065.3150025,1061.2372803272726,-16.0,49.06093793328292,-4.490396454948298,-14.82539975332702,-38.764595798691,940427.219259674,215921.75802305216,40.0,80.0,-32.0,23.800048999999944,1069.7166746666667,1079.4333493333334,1089.9666746666667,1099.6833493333334,1059.1833493333334,1049.4666746666667,1038.9333493333334,0.4395073580246929,-19004714.0,+1
2015-11-23,1074.0,1075.5,1059.050049,1070.849976,1043.725464,852070.0,1064.230005,1062.2436391454544,-10.849975000000086,50.78677835430292,-4.062193879565649,-16.532027576689416,-39.43186214866227,-120537.20869289491,200628.16862686403,36.0,76.0,-39.99999999999999,19.75,1068.466675,1077.8833009999998,1084.9166259999997,1094.333252,1061.4333499999998,1052.0167239999998,1044.9833989999997,0.7173229269801463,-18152644.0,+1
2015-11-24,1065.25,1073.5,1062.099976,1066.050049,1042.061035,1000563.0,1062.8500123,1062.5745562363636,-13.799927000000025,46.328599549030415,-3.207879868871103,-19.046817874605722,-37.52868512907331,44550.39930182075,193533.72456663093,32.0,72.0,-40.0,12.600097999999889,1067.216675,1072.3333739999998,1078.6166989999997,1083.7333979999999,1060.9333499999998,1055.8166509999999,1049.5333259999998,0.3464969021117819,-19153207.0,-1
2015-11-26,1059.0,1067.0,1051.099976,1064.349976,1041.669434,2197871.0,1061.1950075000002,1062.8472769090909,-16.55004800000006,44.72413682986966,-3.3780403173585904,-20.84608271586262,-49.98123369374562,507236.9269402437,207792.9610381662,28.000000000000004,68.0,-40.0,19.549927000000025,1060.8166506666666,1070.5333253333333,1076.7166746666667,1086.4333493333334,1054.6333013333333,1044.9166266666666,1038.7332773333333,0.8333320754735952,-21351078.0,-1
2015-11-27,1064.849976,1082.199951,1060.949951,1063.949951,1056.796021,1731268.0,1061.1099977000001,1063.3481757272727,-0.850097999999889,44.30753087110098,-3.4180788530015853,-22.620197532804696,-16.94709608066233,1989349.7274637253,288772.8140575499,24.0,64.0,-40.0,21.349975000000086,1069.0332843333333,1077.1166176666666,1090.283284333333,1098.3666176666666,1055.8666176666666,1047.7832843333333,1034.6166176666666,0.1411764705882353,-23082346.0,-1
2015-11-30,1079.199951,1081.0,1069.699951,1079.400024,1055.18042,1311944.0,1063.5900025,1066.6736350545455,24.80004800000006,60.64473298415657,-0.9696945454545424,-23.33074788395197,13.63484754117232,-2093316.9244607824,180496.00776121084,20.0,60.0,-40.0,31.65002400000003,1076.6999916666666,1083.7000323333332,1088.0000406666663,1095.0000813333331,1072.3999833333332,1065.3999426666667,1061.0999343333333,0.8584098175149526,-21770402.0,+1
2015-12-01,1077.050049,1084.900024,1073.5,1077.75,1060.320557,473833.0,1066.1599976,1069.2481800545456,25.699951000000056,58.52900428538225,-1.1363636363636365,-22.042720845074655,25.920614061344693,1233878.916495038,228377.04906731553,16.0,56.00000000000001,-40.0,16.449951000000056,1078.7166746666667,1083.9333493333334,1090.1166986666667,1095.3333733333334,1072.5333253333333,1067.3166506666666,1061.1333013333333,0.37280623268863194,-22244235.0,-1
2015-12-02,1090.0,1092.699951,1071.849976,1083.0,1055.229492,640571.0,1068.3650025,1072.3099986727273,22.050048999999944,63.23756435284643,-0.9761448604519509,-19.270815540929107,42.45604125161549,-268177.8699617352,205806.37092962165,12.0,52.0,-40.0,11.40002400000003,1082.5166423333333,1093.1833086666666,1103.3666173333336,1114.0332836666666,1072.3333336666665,1061.6666673333332,1051.4833586666664,0.5347739745491294,-21603664.0,+1
2015-12-03,1072.5,1081.0,1067.300049,1077.800049,1054.201294,951928.0,1070.0650025,1074.0254616727273,17.0,55.974472798657544,-1.4994367248388956,-16.036527254123257,21.747222632358493,-825992.4185926674,158906.4259513165,8.0,48.0,-40.0,15.90002400000003,1075.3666993333334,1083.4333496666668,1089.0666503333337,1097.1333006666669,1069.7333986666667,1061.6667483333333,1056.0334476666667,0.766426098896263,-22555592.0,-1
2015-12-04,1073.599976,1073.599976,1056.0,1076.75,1036.72522,1464957.0,1072.8800049,1075.2409157636364,28.15002400000003,54.51557390842502,-1.6051073549866821,-12.991929374829624,1.3446637637146133,758480.0,186159.77022626734,4.0,44.0,-40.0,21.25,1068.7833253333333,1081.5666506666666,1086.3833013333333,1099.1666266666666,1063.9666746666667,1051.1833493333334,1046.3666986666667,1.1789788804257482,-24020549.0,-1
2015-12-07,1068.199951,1071.099976,1061.099976,1058.900024,1039.711304,1453702.0,1071.8800049,1072.6991010545455,-10.0,36.073789899461744,-3.4014218241618916,-10.635579021950662,-16.576421014414798,-539438.1772151899,153178.0453425524,0.0,40.0,-40.0,17.050048999999944,1063.699992,1066.3000080000002,1073.6999920000003,1076.3000080000002,1056.3000080000002,1053.699992,1046.3000080000002,-0.21999519999999392,-25474251.0,-1
2015-12-08,1061.0,1061.900024,1047.0,1061.949951,1027.2773439999999,1225665.0,1070.9900023999999,1070.893636709091,-8.900024999999914,40.07067310304935,-3.0944954731108765,-5.732659514847683,-50.64525542918312,156128.7963448337,153312.17038811068,0.0,36.0,-40.00000000000001,11.40002400000003,1056.9499916666666,1066.8999833333332,1071.8500156666669,1081.8000073333333,1051.9999593333332,1042.0499676666666,1037.0999353333332,1.0033507999718676,-24248586.0,+1
2015-12-09,1047.099976,1057.0,1044.849976,1049.25,1025.515015,972654.0,1069.3099975,1066.940909,-16.800048999999944,30.81406296557175,-4.372542330939498,-3.6931747946009637,-87.70239175481875,-1686259.6524714075,69695.26934901312,0.0,32.0,-40.0,20.849975000000086,1050.3666586666666,1055.8833413333332,1062.5166826666668,1068.0333653333332,1043.7333173333332,1038.2166346666666,1031.5832933333331,0.36214117766351894,-25221240.0,-1
2015-12-10,1045.0,1063.199951,1042.300049,1047.449951,1038.389648,1628585.0,1067.6199950000002,1062.9663550909092,-16.900024999999914,29.69230431605007,-4.553688460431452,-2.4408685281530325,-86.26781104328404,-924248.6151950598,24516.001869722353,8.0,28.000000000000004,-40.0,15.699951000000056,1050.983317,1059.666585,1071.8832189999998,1080.566487,1038.7666829999998,1030.0834149999998,1017.8667809999997,0.2464079496640742,-26849825.0,-1
2015-12-11,1060.0,1060.599976,1042.0,1060.599976,1024.4379880000001,758480.0,1067.2849975000001,1061.689988,-3.349975000000086,46.20105992880261,-3.230348856080409,-0.42590100502957284,-67.79977211825553,336437.8181818182,38694.266247549305,4.0,24.0,-40.0,21.800048999999944,1054.399984,1066.7999679999998,1072.99996,1085.3999439999998,1048.1999919999998,1035.800008,1029.6000159999999,1.0,-26091345.0,+1
2015-12-14,1041.0,1059.849976,1040.099976,1046.349976,1032.955933,1469504.0,1063.9799927,1057.8836204545455,-33.05004800000006,35.71526157054781,-4.664383343619596,0.5042157084512837,-111.28527102254561,-210550.0500577156,27364.979142761167,0.0,20.0,-40.0,15.65002400000003,1048.7666426666667,1057.4333093333335,1068.516642666667,1077.1833093333335,1037.6833093333335,1029.0166426666667,1017.9333093333335,0.31645569620253167,-27560849.0,-1
2015-12-15,1053.0,1062.449951,1045.300049,1055.050049,1037.263672,1139354.0,1061.7099976,1056.2599943272726,-22.699951000000056,44.576588444478325,-3.7888602049453164,1.8426285379341607,-67.98204775640752,500486.7483545629,48870.51410694006,64.0,96.0,-36.0,14.90002400000003,1054.266683,1063.2333170000002,1071.4165850000004,1080.3832190000003,1046.083415,1037.116781,1028.933513,0.5685163681984852,-26421495.0,+1
2015-12-16,1063.0,1073.349976,1059.349976,1059.449951,1044.9494630000002,1710692.0,1059.3549927,1055.8490767636363,-23.550048999999944,48.702809309604454,-3.346080470924769,0.9313428793341245,2.3053083361277578,-1215878.4277319517,-8618.074158479658,60.0,92.0,-32.0,17.099975000000086,1064.0499676666666,1068.7499593333332,1078.0499676666664,1082.7499593333332,1054.7499593333332,1050.0499676666666,1040.7499593333332,0.007141071428577561,-24710803.0,+1
2015-12-17,1073.900024,1084.0,1065.0,1067.300049,1057.628052,1219503.0,1058.3049927000002,1057.2936324545456,-10.5,55.51998004508543,-2.556093715657244,0.19444552777395074,65.03522122440326,231851.7122400947,2312.370677821999,56.00000000000001,88.0,-20.000000000000004,20.89990200000011,1072.1000163333333,1079.2000326666666,1091.1000163333333,1098.2000326666666,1060.2000326666666,1053.1000163333333,1041.2000326666666,0.12105521052631286,-23491300.0,+1
2015-12-18,1085.0,1085.0,1068.5,1080.25,1050.529907,793032.0,1058.6549927,1061.2836337818183,3.5,64.50004281266533,-1.2528883580472325,-1.0121586705045047,103.18488641030828,55847.9075787784,4745.804173320616,52.0,84.0,-20.0,18.59997599999997,1077.9166666666667,1087.3333333333335,1094.416666666667,1103.8333333333335,1070.8333333333335,1061.4166666666667,1054.3333333333335,0.7121212121212122,-22698268.0,+1
2015-12-21,1071.75,1079.900024,1069.050049,1073.0,1052.879761,774375.0,1060.0649903,1063.8918169272727,14.09997599999997,57.05865835726345,-1.9824848517075204,-2.829724240702035,63.95348890326472,414500.45157404034,23371.015418812258,48.0,80.0,-20.0,20.5,1073.9833576666667,1078.9166663333335,1084.8333326666666,1089.7666413333336,1068.0666913333334,1063.1333826666666,1057.2167163333334,0.36405162223876314,-23472643.0,-1
2015-12-22,1074.5,1076.5,1064.0,1075.400024,1044.1170650000001,607384.0,1061.4099976000002,1066.6800048727273,13.450072999999975,58.87110914160627,-1.7409608385902018,-5.24455204980859,46.72898793107449,78654.46281036227,25883.899391156003,44.0,76.0,-32.0,17.14990200000011,1071.9666746666667,1079.9333493333334,1084.4666746666667,1092.4333493333334,1067.4333493333334,1059.4666746666667,1054.9333493333334,0.9120019200000025,-22865259.0,+1
2015-12-23,1072.599976,1077.949951,1069.150024,1066.449951,1051.606812,753492.0,1063.1299927,1067.5963600363634,17.199951000000056,49.82261990772302,-1.88134371196754,-5.677983323296985,41.35131977864694,-2650912.8396913228,-95788.67965807366,40.0,72.0,-32.0,18.299927000000025,1071.1833086666668,1073.2165933333335,1079.983235666667,1082.0165203333336,1064.4166663333335,1062.3833816666668,1055.6167393333335,-0.3068290225589334,-23618751.0,-1
2015-12-24,1076.199951,1076.400024,1068.300049,1074.099976,1051.509033,536588.0,1065.7949952000001,1069.5909024545454,26.650024999999914,56.42757369757095,-1.105479107505074,-5.785354991675604,51.1932712505748,-118964.43863053239,-96842.12324773108,36.0,68.0,-31.999999999999993,24.550048999999944,1072.9333496666666,1077.5666503333332,1081.0333246666664,1085.6666253333333,1069.4666753333331,1064.8333746666665,1061.366700333333,0.71604258037833,-23082163.0,+1
2015-12-28,1074.0,1079.900024,1067.75,1074.0,1054.690796,1938857.0,1067.1349976000001,1071.082721509091,13.40002400000003,56.31579145892476,-1.1156186612576064,-4.069375130070057,54.22693983200563,2071750.6291321306,1730.2745877364005,32.0,64.0,-32.0,17.699951000000056,1073.8833413333334,1080.0166826666668,1086.0333653333337,1092.1667066666669,1067.8666586666668,1061.7333173333334,1055.7166346666668,0.5144022760778073,-25021020.0,-1
2015-12-29,1078.949951,1079.849976,1071.300049,1077.25,1055.376221,1057903.0,1070.2250000000001,1072.9218128545456,30.90002400000003,59.33723085789858,-0.7860040567951319,-2.59122238242162,70.14560469948752,284945.48279032204,14603.693142401782,28.000000000000004,60.0,-32.0,11.199951000000056,1076.1333416666666,1080.9666343333333,1084.6832686666667,1089.5165613333334,1072.4167073333333,1067.5834146666666,1063.8667803333333,0.6959066434134511,-23963117.0,+1
2015-12-30,1080.0,1081.949951,1072.550049,1077.949951,1051.802856,528140.0,1072.5149902,1074.3263494,22.89990200000011,60.02432680448979,-0.7150151115618606,-1.4835075937303372,80.97817593368336,-445566.57215829426,-6313.137098542663,24.0,56.00000000000001,-32.0,12.5,1077.483317,1082.416585,1086.8832189999998,1091.816487,1073.0166829999998,1068.0834149999998,1063.6167809999997,0.5744636486635762,-23434977.0,+1
2015-12-31,1075.0,1084.900024,1075.0,1074.300049,1059.4882810000001,2322502.0,1074.0000000000002,1074.6509055454544,14.850097999999889,54.484978291152146,-1.0851877281947317,1.8087472060519758,89.8587793394859,1952067.097394126,82704.14628750282,20.0,52.0,-32.0,8.799927000000025,1078.066691,1081.133382,1087.966715,1091.033406,1071.233358,1068.166667,1061.333334,-0.07070194981346038,-25757479.0,-1
2016-01-01,1082.400024,1090.25,1076.150024,1082.150024,1065.950195,798769.0,1075.4849975000002,1076.132728090909,14.849975000000086,62.966298981058024,-0.8171476418663273,4.0646857679787445,126.1689411475456,-1124705.8778926763,27821.87246112217,16.0,48.0,-32.0,9.950072999999975,1082.850016,1089.5500080000002,1096.9499920000003,1103.6499840000001,1075.4500320000002,1068.7500400000001,1061.3500560000002,0.4255326392044932,-24958710.0,+1
2016-01-04,1084.0,1084.0,1068.099976,1088.75,1048.082275,1296884.0,1076.3349975,1078.5445467272727,8.5,68.6360221938768,-0.15132408575031525,5.9911966464810575,95.64120669800437,963628.1950105412,70358.52348610233,12.0,44.0,-32.0,12.15002400000003,1080.2833253333333,1092.4666746666667,1096.1833493333334,1108.3666986666667,1076.5666506666666,1064.3833013333333,1060.6666266666666,1.2987416874339304,-23661826.0,+1
2016-01-05,1070.199951,1074.800049,1061.349976,1070.5,1040.1519779999999,790218.0,1076.0849975,1077.4836380909092,-2.5,46.11195911037492,-1.9924337957124842,6.517501737263501,7.757694625816963,511461.4837096215,90408.6580417198,8.0,40.0,-31.999999999999996,8.549927000000025,1068.8833416666666,1076.4167073333333,1082.3334146666666,1089.8667803333333,1062.9666343333333,1055.4332686666667,1049.5165613333334,0.6802954898460438,-24452044.0,-1
2016-01-06,1056.650024,1076.75,1056.650024,1062.400024,1044.753418,1041384.0,1074.7849975000001,1074.995461090909,-13.0,39.47740165614988,-2.8095814375788115,6.022922054231913,-24.865151887727205,-256447.16781071355,74642.48413933424,4.0,36.0,-32.00000000000001,9.399902000000111,1065.2666826666666,1073.8833413333332,1085.3666586666664,1093.9833173333332,1053.7833653333332,1045.1667066666666,1033.6833893333333,0.2860699933174054,-25493428.0,-1
2016-01-07,1060.099976,1064.900024,1049.699951,1067.099976,1034.081665,1513857.0,1074.8500000000001,1073.5981844545454,0.6500249999999141,44.795210710515974,-2.335437477931907,6.494274001395297,-66.15535573147697,2052134.906361242,164528.50333125118,0.0,32.0,-32.0,9.90002400000003,1060.5666503333334,1071.4333496666668,1075.7667233333336,1086.6334226666668,1056.2332766666668,1045.3665773333335,1041.0332036666669,1.1447329891112985,-23979571.0,+1
2016-01-08,1061.949951,1064.5,1057.25,1056.199951,1040.1030269999999,872089.0,1073.0599975000002,1070.2072664545453,-17.900024999999914,36.26778117710185,-3.4350616897856185,6.6827716047180274,-79.14320079041497,464454.4510868129,178161.5009565057,80.0,28.000000000000004,-32.0,15.949951000000056,1059.3166503333334,1061.3833006666669,1066.5666503333332,1068.6333006666669,1054.1333006666669,1052.0666503333334,1046.8833006666669,-0.14483434482757856,-24851660.0,-1
2016-01-11,1052.050049,1061.0,1045.300049,1062.349976,1036.4313960000002,822228.0,1071.8949951,1068.259989818182,-11.65002400000003,43.29531279936813,-2.8146304161412385,7.936212543195779,-106.92421382557447,1735026.8694120056,248928.10861358253,76.0,24.0,-32.0,15.90002400000003,1056.216675,1067.1333009999998,1071.9166259999997,1082.833252,1051.4333499999998,1040.5167239999998,1035.7333989999997,1.085986000848026,-24029432.0,+1
2016-01-12,1063.900024,1063.900024,1043.5,1058.599976,1025.0253910000001,1064684.0,1070.0299927,1065.8427136181817,-18.65002400000003,40.17830642898444,-3.192940630517027,8.005859682040182,-112.05505774187135,-1729428.0213544818,159002.82997866007,72.0,20.0,-32.0,27.40002400000003,1055.3333333333333,1067.1666666666665,1075.7333573333335,1087.5666906666665,1046.7666426666665,1034.9333093333332,1026.3666186666665,0.7401940311442745,-25094116.0,-1
2016-01-13,1052.0,1062.75,1037.0,1046.949951,1037.9490970000002,1128787.0,1066.9299927000002,1061.6463423999999,-31.0,31.936421359468355,-4.368226885245896,6.622488139796133,-149.9574143612418,-1058107.747934149,103679.62189170806,68.0,16.0,-32.0,20.09997599999997,1048.8999836666667,1060.7999673333334,1074.6499836666667,1086.5499673333334,1035.0499673333334,1023.1499836666667,1009.2999673333334,0.3864058640776721,-26222903.0,-1
2016-01-14,1050.150024,1057.400024,1039.5,1060.150024,1027.766846,1569796.0,1065.5149902,1060.413620818182,-14.150024999999914,46.32987247284035,-3.0365675662042846,5.174026219921188,-107.39842911940882,-797524.6750750612,62715.790211396015,64.0,96.0,-32.0,15.200072999999975,1052.350016,1065.2000320000002,1070.25004,1083.1000560000002,1047.3000080000002,1034.449992,1029.3999840000001,1.1536310789303967,-24653107.0,+1
2016-01-15,1048.0,1055.449951,1038.099976,1049.75,1020.325928,1354315.0,1062.2749878000002,1057.5472589636365,-32.40002400000003,38.85934093845677,-4.085750315258512,2.4215168132845974,-120.75206588218754,-968428.6923425177,15845.586458940656,60.0,92.0,52.0,9.84997599999997,1047.7666423333333,1057.4333086666666,1065.1166173333336,1074.7832836666666,1040.0833336666665,1030.4166673333332,1022.7333586666664,0.6714720914583435,-26007422.0,-1
2016-01-18,1035.650024,1041.449951,1021.0,1042.150024,1004.36731,1623847.0,1057.6149902000002,1053.8881746363636,-46.59997599999997,34.2083234309779,-4.852456595208068,-0.34429819388060423,-171.82949326794542,-3557798.1530447532,-146592.76533669746,56.00000000000001,88.0,52.0,15.699951000000056,1034.8666583333334,1048.7333166666667,1055.3166093333334,1069.1832676666668,1028.2833656666667,1014.4167073333333,1007.8334146666666,1.0342334805594386,-27631269.0,-1
2016-01-19,1027.199951,1037.550049,1026.300049,1025.849976,1014.10907,1601303.0,1053.1499878000002,1048.1127175090908,-44.65002400000003,26.391348842110943,-6.496849836065577,-4.055344325016904,-165.99855248250012,38600.00308911812,-138174.91222643235,52.0,96.0,52.0,20.40002400000003,1029.9000246666667,1033.5000003333334,1041.150024666667,1044.7500003333334,1022.2500003333334,1018.6500246666667,1011.0000003333334,-0.04000648888888665,-29232572.0,-1
2016-01-20,1025.0,1108.0,1007.900024,1035.800049,996.9754029999999,2390897.0,1050.4899903,1044.9581831818182,-26.599975000000086,36.59621646679684,-7.155594747274535,-9.737476822143663,-51.42988994634812,-824419.0119592671,-169367.82585065483,48.0,92.0,52.0,25.75,1050.566691,1093.233358,1150.666667,1193.333334,993.133382,950.466715,893.033406,0.2787215952978842,-26841675.0,+1
2016-01-21,1021.0,1033.25,1013.400024,1018.2999880000001,1001.5769650000001,1575201.0,1045.6099915000002,1039.105455490909,-48.79998799999987,28.560775516828272,-8.889991278493547,-13.217674357738588,-168.81508973262794,-1814999.0126582277,-244169.2434328235,96.0,96.0,-32.0,17.90002400000003,1021.6500040000001,1029.8999840000001,1041.49998,1049.74996,1010.0500080000002,1001.8000280000001,990.2000320000002,0.24684987024669833,-28416876.0,-1
2016-01-22,1025.699951,1044.25,1022.0499880000001,1023.0,1008.724182,1059071.0,1042.2899964,1034.9945479454545,-33.199951000000056,33.112007756864045,-8.424182358771061,-15.488848634182887,-111.41248007606922,-1819526.3677321214,-315776.38544643373,92.0,92.0,-32.0,22.05004800000006,1029.7666626666667,1037.483337333333,1051.9666746666667,1059.6833493333331,1015.2833253333333,1007.5666506666668,993.0833133333334,0.042793310201810056,-27357805.0,+1
2016-01-25,1039.949951,1046.699951,1033.050049,1030.300049,1019.3468630000001,2535971.0,1039.0850037,1032.814557509091,-32.049927000000025,39.96629255500559,-7.7006888999008964,-17.99553772019499,-71.51987034519915,439222.21287737566,-281458.2673408034,88.0,88.0,-31.999999999999993,28.75,1036.6833496666666,1040.3166503333332,1050.3332516666665,1053.9665523333333,1026.666748333333,1023.0334476666665,1013.016846333333,-0.20146664789241547,-24821834.0,+1
2016-01-27,1048.449951,1048.699951,1033.0,1041.150024,1013.9620970000001,1009867.0,1037.3400085000003,1033.1900157454545,-17.44995199999994,48.93953883276564,-6.625369276511394,-18.13025348070596,-45.488744500178896,1831745.954001157,-185403.53000707095,84.0,84.0,-44.0,15.849975000000086,1040.9499916666666,1048.8999833333332,1056.649942666667,1064.5999343333333,1033.2000323333332,1025.2500406666666,1017.5000813333331,0.519111429073887,-23811967.0,+1
2016-01-28,1039.0,1046.900024,1030.0,1035.650024,1010.0947880000001,2487993.0,1036.2100158,1032.8827458363637,-11.299927000000025,45.00497324230541,-7.170463429137758,-19.841290988463697,-48.7161942581955,-1935020.810083223,-264931.5881923561,80.0,80.0,-44.0,100.09997599999997,1037.5166826666666,1045.0333653333332,1054.4167066666669,1061.9333893333333,1028.1333413333332,1020.6166586666666,1011.2333173333332,0.33432047197092857,-26299960.0,-1
2016-01-29,1035.199951,1054.949951,1035.199951,1031.699951,1027.8647460000002,1340046.0,1033.3650085000002,1032.0627340545457,-28.450072999999975,42.193871090140306,-7.56194737363726,-21.1959182686212,-31.162312359683177,-1136861.7785240563,-304564.77866198146,76.0,76.0,0.0,22.400024999999914,1040.6166176666668,1046.0332843333335,1060.366617666667,1065.7832843333335,1026.2832843333335,1020.8666176666668,1006.5332843333335,-0.17721518987341772,-27640006.0,-1
2016-02-01,1058.0,1067.0,1053.699951,1049.849976,1037.557373,1152371.0,1033.3750061,1035.0600008727274,0.09997599999996964,56.57457662716314,-5.763134192269577,-21.18948724147549,27.03697224112149,697641.5065294162,-259009.94751691507,72.0,72.0,0.0,25.9500119999999,1056.8499756666668,1060.0000003333334,1070.150024666667,1073.3000493333334,1046.6999513333335,1043.5499266666668,1033.3999023333336,-0.2894707380401457,-26487635.0,+1
2016-02-02,1065.0,1065.25,1050.199951,1059.75,1031.732056,1632157.0,1035.1350037,1039.8554543090909,17.59997599999997,62.45332318742762,-4.781962338949454,-22.369637803876685,36.465088486089584,2475700.748607014,-134704.91587491083,68.0,68.0,0.0,23.699951000000056,1058.3999836666667,1066.6000163333333,1073.4500326666666,1081.6500653333333,1051.5499673333334,1043.3499346666667,1036.4999183333334,0.6345526848450779,-24855478.0,+1
2016-02-03,1044.5,1051.400024,1042.0,1053.800049,1021.990417,1212561.0,1037.9300110000001,1043.249098909091,27.950072999999975,57.093478236146304,-5.3716502477700745,-22.381409140081814,8.35626139871192,1135106.6449247263,-76986.2085658331,64.0,64.0,0.0,18.39990200000011,1049.066691,1056.133382,1058.466715,1065.533406,1046.733358,1039.666667,1037.333334,1.255321156626824,-26068039.0,-1
2016-02-04,1048.0,1054.900024,1045.550049,1043.849976,1027.2282710000002,1418998.0,1038.7350037,1044.325456181818,8.049927000000025,48.982096694961136,-6.357782358771064,-21.415641132259225,8.550892995664253,2195988.4545236835,26330.821574605125,60.0,60.0,0.0,16.90002400000003,1048.1000163333333,1050.6499836666667,1057.4499913333334,1059.9999586666668,1041.3000086666666,1038.7500413333332,1031.9500336666665,-0.18182647547185518,-27487037.0,-1
2016-02-05,1052.800049,1063.800049,1045.599976,1049.199951,1033.151611,1880976.0,1041.8250000000003,1046.2281738727272,30.899962999999957,53.11465366284322,-5.827556888007923,-17.923909139263515,29.060640131028897,-283660.1992847291,12240.320626452833,56.00000000000001,56.00000000000001,0.0,19.75,1052.8666586666666,1060.1333413333332,1071.0667316666663,1078.3334143333332,1041.9332683333332,1034.6665856666666,1023.7331953333332,0.19780003080207925,-25606061.0,+1
2016-02-08,1055.0,1058.0,1030.300049,1055.25,1014.157898,870481.0,1045.0500000000002,1048.6690829636364,32.25,57.596462960398824,-5.2279484638255695,-15.683515625370319,12.441189152349986,-2632776.2320752246,-107987.70449635667,52.0,52.0,0.0,35.300048999999944,1047.8500163333333,1065.3999836666667,1075.5499673333334,1093.0999346666667,1037.7000326666666,1020.1500653333333,1010.0000816666666,0.9007218460422549,-24735580.0,+1
2016-02-09,1026.699951,1031.550049,1020.650024,1035.849976,1004.5631710000001,1383865.0,1045.6049927000001,1046.9963513272728,5.549927000000025,42.548139924347474,-7.150646580773046,-10.794714690570117,-65.71975574024985,285439.5583423946,-90104.64709459439,48.0,48.0,0.0,15.40002400000003,1029.3500163333333,1038.0500086666666,1040.2500413333332,1048.9500336666665,1027.1499836666667,1018.4499913333334,1016.2499586666668,1.3944878108077787,-26119445.0,-1
2016-02-10,1023.900024,1030.150024,1010.099976,1026.050049,991.7374269999999,1920570.0,1044.0949952,1043.4409070181819,-15.099975000000086,36.92497319812403,-8.12189801783945,-6.071062697022626,-101.44424642055608,718078.0270874116,-53369.07099541064,44.0,44.0,0.0,17.75,1022.1000163333333,1034.1000566666667,1042.1500643333334,1054.1501046666667,1014.0500086666666,1002.0499683333333,993.9999606666665,0.7955129583729639,-28040015.0,-1
2016-02-11,1010.0,1013.0,968.2000119999999,1012.9500119999999,954.8758539999999,2200900.0,1041.824994,1037.7781827999997,-22.70001200000013,30.67255613001214,-5.583676446281002,-3.594124565131551,-203.0525510899229,-2201000.294858098,-150988.67208008247,40.0,40.0,0.0,9.349975000000086,998.0500079999998,1027.9000039999996,1042.849996,1072.6999919999998,983.1000159999996,953.2500199999997,938.3000279999995,0.9988841961296931,-30240915.0,-1
2016-02-12,979.0,986.4500119999999,966.0,975.2999880000001,951.0575560000001,3135536.0,1036.1849977000002,1025.6827271636364,-56.39996299999996,19.64270440498069,-9.47314173553718,-4.039643604231969,-288.3962954878964,557684.0486040338,-118776.27568534859,36.0,96.0,0.0,19.950072999999975,975.9166666666666,985.8333333333333,996.3666786666665,1006.2833453333332,965.3833213333334,955.4666546666667,944.9333093333335,0.45476687250844366,-33376451.0,-1
2016-02-15,980.0,988.25,971.099976,971.400024,953.211548,2728240.0,1028.3400025,1013.9036410363635,-78.44995199999994,18.83325744742706,-9.876030578512394,-3.6857556318516345,-228.65565951780857,-30789.508798138682,-114776.87719047526,32.0,96.0,0.0,27.699951000000056,976.9166666666666,982.7333573333333,994.0666906666665,999.8833813333333,965.5833333333333,959.7666426666666,948.4333093333332,0.017495485720606583,-36104691.0,-1
2016-02-16,981.5,982.0,962.0,973.599976,953.064636,1784024.0,1019.7250001000002,1003.9509089454546,-86.15002400000003,20.95342738264374,-9.64876280991736,-3.532303684038652,-201.5692915696322,2026106.6666666665,-17463.988833328815,28.000000000000004,92.0,0.0,34.59997599999997,972.5333253333333,983.0666506666666,992.5333253333333,1003.0666506666666,963.0666506666666,952.5333253333333,943.0666506666666,0.5799987999999985,-34320667.0,+1
2016-02-17,976.900024,979.900024,959.0,973.4500119999999,954.484314,1875981.0,1011.6899964,995.5372747454546,-80.35003700000004,20.91046602628819,-9.664254958677695,-5.716791434213974,-169.12152293079666,3016278.01561068,120433.37500504014,24.0,96.0,0.0,25.75,970.7833453333333,982.5666906666665,991.6833693333333,1003.4667146666666,961.6666666666665,949.8833213333332,940.7666426666665,0.6913873400336707,-36196648.0,-1
2016-02-18,986.0,991.25,977.0,974.900024,968.7296140000001,1699964.0,1004.7950012000001,988.8481888545455,-68.94995199999994,22.6791570839533,-9.514460330578508,-9.889830374128564,-111.91226744220683,416489.4645634443,133890.46998496805,20.0,96.0,0.0,57.85003700000004,981.050008,985.1000160000001,995.3000080000002,999.3500160000001,970.8500160000001,966.800008,956.6000160000001,-0.14736673684210314,-34496684.0,+1
2016-02-19,988.75,992.599976,973.5,989.4500119999999,968.5827029999999,832165.0,998.8200073,986.0581908181817,-59.749939000000154,38.581790870671476,-8.011362396694226,-14.121559363502001,-87.65256156776606,-1832960.707205535,44488.14374903319,16.0,92.0,-60.0,46.9500119999999,985.1833293333333,996.8666586666666,1004.2833053333334,1015.9666346666666,977.7666826666666,966.0833533333333,958.6667066666666,0.8350802116191103,-33664519.0,+1
2016-02-22,983.0,996.0,983.0,989.2999880000001,968.04425,1000599.0,992.2250061,984.3272782181818,-65.9500119999999,38.48761503334704,-7.860285847347985,-16.604112006652258,-67.24982803566026,460007.4563496526,63375.385230880114,12.0,88.0,-64.0,17.15002400000003,989.4333293333334,995.8666586666668,1002.4333293333334,1008.8666586666668,982.8666586666668,976.4333293333334,969.8666586666668,0.4846144615384691,-34665118.0,-1
2016-02-23,984.900024,985.5,966.0,988.75,949.73584,1519580.0,987.5150084999999,983.6954589272726,-47.09997599999997,38.09428481597313,-7.778818945727474,-20.913334044954468,-78.75848269517331,-1080640.0,11374.685902202214,8.0,84.0,-64.0,20.0,980.0833333333334,994.1666666666667,999.5833333333335,1013.6666666666667,974.6666666666667,960.5833333333334,955.1666666666667,1.1666666666666667,-36184698.0,-1
2016-02-24,960.0,962.900024,946.400024,970.0499880000001,929.71405,1615867.0,981.9150024,980.5200006545454,-56.000060999999846,27.19206238834883,-9.717045630042236,-27.586664968824948,-106.33458758890812,-3759386.5421928824,-160023.55173848826,4.0,80.0,-72.0,20.90002400000003,959.7833453333334,973.1666666666667,976.2833453333333,989.6666666666667,956.6666666666667,943.2833453333334,940.1666666666667,1.4333311515151557,-37800565.0,-1
2016-02-25,954.0,957.25,938.2000119999999,949.599976,922.909668,2115799.0,975.5799988000001,974.644541309091,-63.35003599999993,19.977671492668534,-11.83665704809681,-33.79792282669371,-108.80341943883475,-1798053.2337600228,-234479.44637583275,0.0,96.0,-76.0,17.7999880000001,948.3499959999999,958.4999799999999,967.399984,977.549968,939.4499919999998,929.3000079999998,920.4000039999997,0.5984236840464157,-39916364.0,-1
2016-02-26,950.0,971.0,945.0,942.650024,940.875366,1552347.0,972.3150023999999,968.6572731636364,-32.64996400000007,18.095087529542866,-12.028151824817515,-38.8472929340312,-83.7779176894178,614410.0393971694,-195893.56065887713,24.0,96.0,-76.0,19.09997599999997,952.8833413333333,960.7666826666666,978.8833413333332,986.7666826666666,934.7666826666666,926.8833413333333,908.7666826666666,-0.09038369230769114,-41468711.0,-1
2016-02-29,961.099976,982.599976,928.0,961.0,951.498108,2203188.0,971.275,966.6,-10.40002400000003,36.36404143260555,-7.565282858078532,-43.27714833299092,-62.86447368053117,250758.32537048927,-175591.20220299636,20.0,92.0,-76.0,13.0,957.199992,986.3999839999999,1011.7999679999998,1040.9999599999999,931.8000079999999,902.600016,877.200032,0.6043958700641191,-39265523.0,+1
2016-03-01,974.9500119999999,986.75,971.849976,971.849976,963.5405880000001,1080640.0,971.0999999999999,966.7045410909091,-1.75,44.768869702581405,-6.2610800083059495,-42.226412097737466,-25.06839513159669,-588661.1556414772,-194367.1091774732,16.0,96.0,-76.0,23.2999880000001,976.8166506666666,981.7833253333333,991.7166746666667,996.6833493333334,966.8833013333333,961.9166266666666,951.9832773333333,0.0,-38184883.0,+1
2016-03-02,998.0,1010.900024,995.0,984.150024,986.107849,1589744.0,972.1700012000001,969.0772727272728,10.700012000000129,52.90514529568371,-3.1564525164113753,-39.814427702171315,8.324459473352574,586771.7185261778,-158860.79882730645,12.0,92.0,-76.0,42.34997599999997,996.6833493333334,998.3666986666667,1012.5833733333334,1014.2667226666667,982.4666746666667,980.7833253333333,966.5666506666666,-0.6823873976542393,-36595139.0,+1
2016-03-03,1010.75,1020.0,1010.0,1007.2000119999999,994.57666,1152600.0,975.4,975.4463656,32.29998799999987,64.28236646615109,-1.3897923995657,-36.297323078766226,36.477648592666434,-86381.00675936,-155566.2628242179,8.0,88.0,-96.0,31.849976000000197,1012.400004,1014.8000079999999,1022.4000040000001,1024.800008,1004.8000079999999,1002.400004,994.8000079999999,-0.2799988000000099,-35442539.0,+1
2016-03-04,1015.4500119999999,1024.900024,993.099976,1015.849976,999.178284,1426156.0,978.0399964000001,982.8009066909092,26.399964000000068,67.66480368543488,-0.9774325267757051,-32.65004278558399,40.49604844556221,-343512.1959160267,-164109.25978293666,4.0,84.0,-72.0,26.0,1011.2833253333333,1029.4666746666667,1043.0833733333334,1061.2667226666667,997.6666266666666,979.4832773333333,965.8665786666666,0.7154077251707279,-34016383.0,+1
2016-03-08,1024.0,1024.0,1009.5,1020.5499880000001,992.9123539999999,478422.0,981.1649964000001,990.5299960727274,31.25,69.47700636048997,-0.4698170306991947,-29.068487307450823,57.55684878250221,8189.070251035734,-156277.51750866504,0.0,80.0,-72.0,54.59997599999997,1018.0166626666668,1026.5333253333336,1032.516662666667,1041.0333253333336,1012.0333253333336,1003.5166626666668,997.5333253333336,0.7620681379310412,-33537961.0,+1
2016-03-09,1013.0,1029.900024,1006.75,1014.150024,1003.3393550000001,1632043.0,983.7049988000001,996.5272738181818,25.40002400000003,63.854270478973234,-1.6919110101988784,-26.311846057582443,59.45546684502722,15689.24775824988,-148460.84636016877,0.0,76.0,-80.0,25.75,1016.9333493333334,1027.1166986666667,1040.0833733333334,1050.2667226666667,1003.9666746666667,993.7833253333333,980.8166506666666,0.31965513297092135,-35170004.0,-1
2016-03-10,1024.800049,1025.75,1010.099976,1024.800049,999.863647,667848.0,989.1800049000001,1003.9991011272728,54.750060999999846,68.71560348013509,-0.5478542129675663,-22.504897825055195,68.97604111452209,493441.4409814256,-119283.46966282304,8.0,72.0,-80.0,39.05004800000006,1020.216675,1030.333374,1035.8666990000002,1045.983398,1014.68335,1004.566651,999.033326,0.9393003486767781,-34502156.0,+1
2016-03-11,1019.900024,1030.800049,1013.0,1021.25,1007.157593,1182714.0,996.3450073000001,1009.8300093272728,71.65002400000003,65.33587570970246,-1.0249032515343799,-18.884103675964866,70.43849269536393,-655024.1260178295,-143635.3176789601,4.0,68.0,-80.0,35.84997599999997,1021.6833496666667,1030.3666993333334,1039.4833986666667,1048.1667483333333,1012.5666503333334,1003.8833006666667,994.7666013333335,0.4634818701903588,-35684870.0,-1
2016-03-14,1028.0,1037.949951,1025.25,1028.699951,1006.0317380000001,752164.0,1004.9500000000002,1015.7127263636363,86.04992700000003,69.02485850490814,-0.9851430302699913,-12.824933412119549,82.75365534284091,-2007754.2813095823,-228367.99784398972,0.0,64.0,-80.0,31.80004800000006,1030.6333006666666,1036.0166013333333,1043.333251666667,1048.7165523333333,1023.3166503333332,1017.9333496666666,1010.6166993333331,0.2716507331406271,-34932706.0,+1
2016-03-15,1027.900024,1033.400024,1021.650024,1027.550049,1005.199463,1922509.0,1011.6050049000002,1019.8218261818182,66.55004899999994,67.74095312331704,-1.107609834680114,-3.0638633328800324,69.70690519152099,-395180.31250580563,-235950.37578316327,0.0,60.0,-80.0,14.5,1027.5333656666667,1033.4167073333333,1039.2833656666667,1045.1667073333333,1021.6667073333333,1015.7833656666667,1009.9167073333333,0.5021297872340352,-36855215.0,-1
2016-03-16,1027.0,1034.25,1018.9500119999999,1026.699951,1008.870911,1200887.0,1017.0900024000001,1022.5663618363636,54.849975000000086,66.68292261178843,-1.1981469287067463,8.844297904356608,62.677969708516166,2386907.8842440085,-116729.54578192647,92.0,56.00000000000001,-76.0,23.15002400000003,1026.633321,1034.3166300000003,1041.9333090000005,1049.6166180000002,1019.016642,1011.3333329999999,1003.716654,0.5065323580646014,-38056102.0,-1
2016-03-17,1034.949951,1039.0,1011.150024,1030.449951,997.0733640000001,1278371.0,1021.7199951000001,1024.9954434,46.299927000000025,69.13651299605968,-0.9095796808510579,17.96315771630782,60.12470634572853,1005425.1193461355,-65722.51554883205,88.0,52.0,-64.0,15.65002400000003,1026.8666583333334,1042.5832926666667,1054.7166343333333,1070.4332686666667,1014.7333166666667,999.0166823333334,986.8833406666668,0.6929961806789365,-36777731.0,+1
2016-03-18,1022.9500119999999,1032.0,1015.349976,1018.400024,1006.8639529999999,1033767.0,1022.8399963000002,1024.3918122909092,11.200012000000129,54.30793494707054,-2.191486808510635,25.364328377296374,49.11753186044281,-965935.737704918,-106641.29837410922,96.0,48.0,-64.0,17.800048999999944,1021.9166666666666,1028.4833573333333,1038.5666906666665,1045.1333813333333,1011.8333333333333,1005.2666426666666,995.1833093333332,0.18318580201446288,-37811498.0,-1
2016-03-21,1033.0,1047.349976,1032.25,1028.400024,1023.7037349999999,1329699.0,1024.0950011,1025.4027264181818,12.55004800000006,62.09318881264045,-1.9982024020212492,31.052633063215126,78.77631958216612,-1978008.832515646,-191703.45901690744,92.0,44.0,-64.0,16.699951000000056,1036.0,1039.75,1051.099976,1054.849976,1024.650024,1020.900024,1009.5500480000001,-0.2549657032567454,-36481799.0,+1
2016-03-22,1046.5,1056.599976,1040.699951,1045.599976,1031.7810060000002,1030066.0,1026.5999999,1029.3127218545455,25.04998799999987,71.67218848089358,-1.1487051248631193,32.014409563779736,100.24825404814361,-5092661.563414872,-414474.2819440903,96.0,40.0,-60.0,11.75,1047.633301,1054.566651,1063.5333260000002,1070.466676,1038.6666260000002,1031.7332760000002,1022.7666010000003,0.30817718840064345,-35451733.0,+1
2016-03-23,1053.050049,1053.050049,1040.550049,1053.849976,1027.3751220000001,2116075.0,1030.5699951000001,1034.2672629636365,39.69995199999994,75.1478782047345,-0.2871762812157798,31.911387934341292,89.87629242931051,598770.7616183214,-368417.6890548892,96.0,36.0,35.99999999999999,15.299988000000099,1049.1500246666667,1057.7500003333334,1061.650024666667,1070.2500003333334,1045.2500003333334,1036.6500246666667,1032.7500003333334,1.063994160000002,-33335658.0,+1
2016-03-28,1045.0,1053.0,1041.650024,1049.349976,1025.563965,2817717.0,1033.0249878,1037.6818049454546,24.549927000000025,69.76088498299733,-0.7571011050234195,31.292152344355486,71.77616508394381,-1386997.7443909482,-414716.782479256,92.0,32.0,36.0,27.84997599999997,1048.0,1054.349976,1059.349976,1065.699952,1043.0,1036.650024,1031.650024,0.6784113023675081,-36153375.0,-1
2016-03-29,1047.5,1059.5,1044.25,1047.5,1031.732056,1683488.0,1035.6499878,1040.3136253454545,26.25,67.46673970114074,-1.2493492972410203,31.611300537644183,64.61650485281115,435060.4535458689,-376090.5444781136,88.0,28.000000000000004,48.0,16.65002400000003,1050.4166666666667,1056.5833333333335,1065.666666666667,1071.8333333333335,1041.3333333333335,1035.1666666666667,1026.0833333333335,0.21311475409836064,-37836863.0,-1
2016-03-30,1058.0,1069.900024,1053.900024,1053.800049,1042.6484380000002,1953595.0,1038.1599976,1043.6136364727272,25.10009799999989,71.18965483924154,-1.6582526111875024,30.83010581958638,70.0989720995798,-926463.2563779855,-401107.485928108,96.0,24.0,48.0,28.94995199999994,1059.2000323333334,1064.5000406666668,1075.2000323333336,1080.5000406666668,1048.5000406666668,1043.2000323333334,1032.5000406666668,-0.006248437500005366,-35883268.0,+1
2016-03-31,1066.849976,1078.900024,1065.050049,1064.949951,1048.71875,5020098.0,1041.8999878,1048.484537090909,37.39990200000011,76.64691683803973,-1.4236220694285822,31.839418629400484,78.68006989560938,618797.7402747059,-354748.1574643433,96.0,20.0,56.0,28.19995199999994,1069.6333413333334,1074.216633666667,1083.4833163333337,1088.066608666667,1060.3666586666668,1055.7833663333333,1046.5166836666667,-0.007227305464442237,-30863170.0,+1
2016-04-01,1068.800049,1076.400024,1056.800049,1071.150024,1042.158936,1289662.0,1046.3449951,1053.802725490909,44.450072999999975,79.17756369332156,-0.7908970109383321,32.147228428359995,65.81094525244987,-537209.7270612575,-363041.86517329403,96.0,16.0,60.0,12.5,1068.116699,1079.433349,1087.7166739999998,1099.033324,1059.8333739999998,1048.5167239999998,1040.2333989999997,0.7321425154879035,-29573508.0,+1
2016-04-04,1065.199951,1072.800049,1064.0,1064.449951,1046.66272,1544990.0,1049.7449950999999,1057.0945356545453,34.0,69.75262539363968,-1.4746476830375068,32.57367576647732,57.29287119621487,56694.68,-343962.9313017805,92.0,12.0,60.0,12.19995199999994,1067.0833333333333,1070.1666666666665,1075.8833823333334,1078.9667156666665,1061.3666176666666,1058.2832843333333,1052.5665686666666,0.05113051075057177,-31118498.0,-1
2016-04-05,1069.0,1076.900024,1055.650024,1069.050049,1035.305542,1665757.0,1054.8099975999999,1060.6045454545456,50.650024999999914,72.359157692782,-1.005202036815144,32.23245979972421,52.89923139615327,1224845.9092544797,-272653.43854922266,88.0,8.0,60.0,15.25,1067.2000323333334,1078.7500406666668,1088.4500323333336,1100.0000406666668,1057.5000406666668,1045.9500323333334,1036.2500406666668,0.6305894117647018,-29452741.0,+1
2016-04-06,1061.0,1066.949951,1056.75,1057.449951,1039.270752,1073844.0,1057.7149903,1061.0845369818182,29.049927000000025,57.85322974132022,-2.1890062735624523,29.937512623601833,36.38701306798184,-2290092.0534376414,-364355.1937714242,84.0,4.0,72.0,22.40002400000003,1060.3833006666666,1064.0166013333333,1070.583251666667,1074.2165523333333,1053.8166503333332,1050.1833496666666,1043.6166993333331,0.06862297671822656,-30526585.0,-1
2016-04-07,1064.0,1064.75,1047.050049,1061.5,1033.3964839999999,977923.0,1059.3049927,1061.7727205636363,15.90002400000003,61.002670256804066,-1.7756938028200344,29.088047361518875,28.465962406767943,-5044.20963386948,-348022.8763106261,80.0,0.0,76.0,25.099975000000086,1057.766683,1068.4833170000002,1075.4666339999999,1086.1832680000002,1050.7833660000001,1040.066732,1033.083415,0.8163836724745741,-29548662.0,+1
2016-04-08,1055.0,1063.349976,1054.25,1055.5,1037.165649,740699.0,1059.4699951,1061.080903709091,1.6500240000000304,54.093116596705684,-2.3880011661271303,28.038904512540284,25.220421637139268,-461696.8335308736,-353189.874366092,76.0,0.0,80.0,19.599975000000086,1057.699992,1061.1499840000001,1066.7999680000003,1070.24996,1052.0500080000002,1048.600016,1042.9500320000002,0.13736299963868082,-30289361.0,-1
2016-04-11,1060.300049,1074.099976,1042.849976,1059.349976,1048.522827,1012405.0,1060.4699951,1061.0590820545453,10.0,57.64501367299058,-1.995106390567867,25.462717783507287,24.393674595472444,196541.32705287667,-328202.0924834114,72.0,8.0,80.0,8.800048999999944,1058.7666426666667,1074.6833093333335,1090.016642666667,1105.9333093333335,1043.4333093333335,1027.5166426666667,1012.1833093333335,0.528,-29276956.0,+1
2016-04-12,1069.599976,1071.0,1059.25,1070.949951,1040.73938,1235370.0,1062.8149902,1062.9645285818183,23.449951000000056,66.62296513533279,-0.8113147061214864,22.766243068380618,38.65030749301334,-467794.8609072491,-334547.21832085866,68.0,4.0,80.0,21.25,1067.0666503333334,1074.8833006666669,1078.8166503333332,1086.6333006666669,1063.1333006666669,1055.3166503333334,1051.3833006666669,0.9957405106383026,-28041586.0,+1
2016-04-13,1072.0,1084.949951,1069.5,1063.0,1059.096802,1243651.0,1063.7349853,1062.9981667272727,9.199951000000056,57.05873247102933,-2.226274363900248,21.92012040327313,48.12916060396432,-17937.50041805907,-320155.867507095,64.0,0.0,80.0,12.300048999999944,1072.483317,1075.4666339999999,1087.9332679999998,1090.916585,1060.0166829999998,1057.033366,1044.5667319999998,-0.4207133084111384,-29285237.0,-1
2016-04-18,1083.5,1092.0,1071.599976,1081.75,1065.02002,1029267.0,1065.4149902,1066.2736239454546,16.800048999999944,69.12190223629815,-1.0322255790533736,22.421283717065307,67.43152626527232,-1645885.7333333334,-380416.31595374254,96.0,4.0,80.0,17.699951000000056,1081.7833253333333,1091.9666746666667,1102.1833493333334,1112.3666986666667,1071.5666506666666,1061.3833013333333,1051.1666266666666,0.4975496107259489,-28255970.0,+1
2016-04-20,1091.900024,1100.0,1083.550049,1087.800049,1074.8594970000001,955338.0,1067.0799927,1070.3436346363635,16.650024999999914,72.0456597671106,-1.2187763236763292,22.651107147305538,84.2331516280203,-567362.2414770054,-388913.8580229818,96.0,0.0,76.0,9.09997599999997,1090.4500326666666,1097.3500163333333,1106.8999836666667,1113.7999673333334,1080.9000653333333,1074.0000816666666,1064.4501143333332,0.2583594321952683,-27300632.0,+1
2016-04-21,1095.0,1105.150024,1089.0,1097.849976,1068.299927,2047932.0,1070.4199952,1075.9381770545453,33.400024999999914,76.33967384915715,-0.7255426950126536,21.287960724996083,93.7252686211334,103612.39584098903,-366526.3010291648,96.0,0.0,64.0,31.25,1097.3333333333333,1105.6666666666665,1113.4833573333335,1121.8166906666665,1089.5166426666665,1081.1833093333332,1073.3666186666665,0.5479853156874537,-25252700.0,+1
2016-04-22,1089.5,1100.849976,1085.199951,1091.150024,1069.278931,1952330.0,1072.6299927,1079.7072732000001,22.099975000000086,68.27257810227603,-1.3914425946482907,19.572538478656725,71.0753761633047,-673245.6797727064,-380468.0909720531,96.0,16.0,64.0,11.75,1092.3999836666667,1099.6000163333333,1108.0500086666666,1115.2500413333332,1083.9499913333334,1076.7499586666668,1068.2999663333335,0.38019575048602205,-27205030.0,-1
2016-04-25,1100.0,1100.0,1084.5,1092.150024,1070.355957,1390490.0,1076.1,1083.2563698000001,34.700072999999975,68.83965939791396,-1.2920538378876987,18.584700363231832,64.94322915376472,1289867.9248148531,-304543.7266181026,92.0,12.0,64.0,15.449951000000056,1092.2166746666667,1099.9333493333334,1107.7166746666667,1115.4333493333334,1084.4333493333334,1076.7166746666667,1068.9333493333334,0.49354993548387294,-25814540.0,+1
2016-04-26,1095.0,1115.0,1092.5,1093.25,1090.524536,1763449.0,1079.275,1086.3745516181818,31.75,69.53085648923629,-2.140748031496063,17.489853699483092,83.24631170476492,-690326.1691557,-322079.2921879935,88.0,8.0,92.0,29.0,1100.25,1108.0,1122.75,1130.5,1085.5,1077.75,1063.0,0.03333333333333333,-24051091.0,+1
2016-04-27,1109.849976,1125.0,1109.0,1113.849976,1100.657593,1440909.0,1085.1099976,1092.660910890909,58.34997599999997,79.40336305360863,-1.086746978557508,18.542048930782357,119.56932452295932,-833051.6296296297,-345305.3075262498,96.0,4.0,96.0,18.25,1115.949992,1122.8999840000001,1131.9499919999998,1138.8999840000001,1106.8999840000001,1099.949992,1090.8999840000001,0.3031234999999981,-22610182.0,+1
2016-04-28,1124.199951,1136.699951,1110.349976,1124.199951,1090.622314,2022396.0,1091.5949951,1099.7681751454545,64.84997500000009,82.66042568157795,-1.2045871244336215,19.491215640966402,126.46881799347956,-297492.0845913712,-343131.979211028,96.0,0.0,96.0,17.349975000000086,1123.7499593333334,1137.149942666667,1150.0999343333337,1163.499917666667,1110.7999676666668,1097.3999843333334,1084.4499926666667,0.5256162482127608,-20587786.0,+1
2016-04-29,1113.800049,1136.0,1106.199951,1113.949951,1108.637085,1402985.0,1095.8949951000002,1103.8327125818184,43.0,70.00957553234558,-2.192348566469191,21.548250105630586,98.11955606860475,687847.7174815949,-296269.2657249996,96.0,0.0,80.0,15.650024999999914,1118.716634,1131.2333170000002,1148.5166830000003,1161.0333660000001,1101.4332680000002,1088.9165850000002,1071.6332190000003,0.26006668646752945,-21990771.0,-1
2016-05-02,1127.75,1130.0,1116.0,1132.349976,1094.244873,965679.0,1102.8299927000003,1110.4608909272727,69.34997599999997,77.22829389976461,-0.4191939101286597,23.131955916829156,103.16720751918183,-1651209.4044179467,-357857.4538474065,92.0,0.0,80.0,15.5,1126.1166586666666,1136.2333173333332,1140.1166586666668,1150.2333173333332,1122.2333173333332,1112.1166586666666,1108.2333173333332,1.1678554285714264,-21025092.0,+1
2016-05-03,1121.900024,1135.0,1113.150024,1117.650024,1094.5876460000002,1173824.0,1106.4199951,1113.1554420727273,35.90002400000003,63.2043579330923,-1.835783742848035,23.694068348650262,80.51332964777397,-95657.85528169703,-345939.2902762378,88.0,4.0,80.0,22.84997599999997,1121.9333493333334,1130.7166746666667,1143.7833253333333,1152.5666506666666,1108.8666986666667,1100.0833733333334,1087.0167226666667,0.20594988296554678,-22198916.0,-1
2016-05-04,1117.5,1134.5,1114.25,1118.0,1103.741699,1323082.0,1109.4399902,1115.260897509091,30.199951000000056,63.3869992614141,-1.8020576161711754,26.73980774377901,70.99848072056575,1516758.4348109665,-261271.21186318283,84.0,0.0,92.0,31.75,1122.25,1130.25,1142.5,1150.5,1110.0,1102.0,1089.75,0.18518518518518517,-20875834.0,+1
2016-05-05,1128.0,1134.75,1122.699951,1127.349976,1108.588135,1303562.0,1112.3899902,1118.5172585636365,29.5,68.24575049668252,-0.9010287599021083,28.29615000901049,73.73129632600758,-373451.71121251886,-266370.3254699708,80.0,0.0,96.0,26.349975000000086,1128.2666423333333,1133.8333336666665,1140.316691333333,1145.8833826666664,1121.7832846666665,1116.2165933333333,1109.7332356666666,0.38589262168145005,-19572272.0,+1
2016-05-06,1132.0,1132.25,1117.25,1132.300049,1096.203125,683288.0,1116.5049927,1122.1372692545456,41.150024999999914,70.62690747481086,-0.42400522383758993,29.111890550977932,62.874848474831786,1415488.0697893288,-189922.2165945479,76.0,36.0,96.0,29.800048999999944,1127.266683,1137.2833660000001,1142.2666829999998,1152.2833660000001,1122.2833660000001,1112.266683,1107.2833660000001,1.0033365999999964,-18888984.0,+1
2016-05-09,1120.0,1144.949951,1119.0,1119.650024,1117.497559,1738295.0,1119.2549927,1122.7090931272728,27.5,57.83815233727241,-2.4188468077092558,28.282956071288936,56.03214427637759,-564000.4240572851,-206925.77147921783,72.0,32.0,92.0,16.050048999999944,1127.8666583333334,1136.7333166666667,1153.8166093333334,1162.6832676666668,1110.7833656666667,1101.9167073333333,1084.8334146666666,0.025049141711289896,-20627279.0,-1
2016-05-10,1143.5,1147.5,1136.099976,1141.400024,1120.924194,1363250.0,1124.0699951000001,1126.7354624545455,48.15002400000003,68.98110317266739,-0.5817812112541698,29.45374820850816,74.41486345076315,302119.23246720416,-183787.36220892586,96.0,28.000000000000004,84.0,21.84997599999997,1141.6666666666667,1147.2333573333335,1153.066690666667,1158.6333813333335,1135.8333333333335,1130.2666426666667,1124.4333093333335,0.4649155124585744,-19264029.0,+1
2016-05-11,1134.699951,1145.0,1129.699951,1144.900024,1114.951904,1536843.0,1127.1749999,1130.5227404363636,31.05004800000006,70.43207225242908,-0.2479710061993295,31.55712659008077,62.2222278641122,1302155.2007806213,-116244.51843667358,96.0,24.0,84.0,20.25,1139.8666583333334,1150.0333656666667,1155.1667073333333,1165.3334146666666,1134.7333166666667,1124.5666093333334,1119.4332676666668,0.993465641842064,-17727186.0,+1
2016-05-12,1144.0,1152.0,1132.5,1138.800049,1125.036255,1055422.0,1128.6350097000002,1132.6363857272727,14.600097999999889,64.37634836196052,-1.2535566001899388,34.08006325010888,57.105614588495506,594596.8260091072,-83933.54823459256,92.0,20.0,80.0,16.75,1141.1000163333333,1149.7000326666666,1160.6000163333333,1169.2000326666666,1130.2000326666666,1121.6000163333333,1110.7000326666666,0.32307943589743304,-18782608.0,-1
2016-05-13,1148.0,1148.0,1130.0,1149.099976,1117.0079349999999,1261329.0,1132.1500122,1136.3572886909092,35.150024999999914,69.48758693217314,-0.27540588793922416,33.85445717450625,52.06061776871118,-118422.05708689039,-85501.20772787882,96.0,16.0,40.0,15.0,1142.3666586666666,1154.7333173333332,1160.3666586666668,1172.7333173333332,1136.7333173333332,1124.3666586666666,1118.7333173333332,1.061109777777776,-17521279.0,+1
2016-05-16,1145.0,1165.900024,1132.550049,1140.900024,1138.4494630000002,1129692.0,1133.005017,1137.9481999272728,8.55004800000006,61.39568457483523,-2.3432373641037616,32.36349543977076,52.50876524857535,-69780.03767653991,-84786.6090891816,92.0,12.0,40.0,25.949951000000056,1146.4500323333334,1160.3500156666669,1179.8000073333337,1193.699990666667,1127.0000406666668,1113.1000573333333,1093.6500656666667,0.25037425065536223,-18650971.0,-1
2016-05-17,1165.050049,1169.25,1151.300049,1162.800049,1129.295166,1073856.0,1137.5200195,1143.3654784727273,45.150024999999914,71.59065259910327,-0.6026583508526098,32.17458844958969,73.25086597844127,-573434.0396471508,-106997.85593272568,96.0,8.0,68.0,27.84997599999997,1161.1166993333334,1170.9333496666668,1179.0666503333337,1188.8833006666669,1152.9833986666667,1143.1667483333333,1135.0334476666667,0.6406702725818006,-17577115.0,+1
2016-05-18,1151.0,1151.0,1131.5,1153.449951,1116.763306,1040661.0,1141.0650146,1146.2618296545454,35.449951000000056,63.349085122075515,-1.4762951646811442,29.558727826293307,38.050811183202974,-2059431.3684418118,-195744.83377404793,96.0,4.0,72.0,15.300048999999944,1145.3166503333334,1159.1333006666669,1164.8166503333332,1178.6333006666669,1139.6333006666669,1125.8166503333334,1120.1333006666669,1.1256385128205157,-18617776.0,-1
2016-05-19,1140.099976,1142.699951,1132.0,1140.650024,1115.4415279999998,963949.0,1142.3950194,1146.1863768181818,13.30004800000006,53.60201956514473,-2.6722705909834126,28.28845391050345,22.03269755702078,-1293392.9318194296,-245637.92913974717,92.0,0.0,72.0,19.5,1138.4499916666666,1144.8999833333332,1149.149942666667,1155.5999343333333,1134.2000323333332,1127.7500406666666,1123.5000813333331,0.8084171600411988,-19581725.0,-1
2016-05-20,1139.949951,1148.5,1133.599976,1139.300049,1117.0079349999999,504158.0,1143.0950194000002,1145.6236549272728,7.0,52.61681985455092,-2.7984070077084846,27.2656357868575,22.57816635113437,-21705.818827891635,-235459.19685284465,88.0,0.0,80.0,18.0,1140.466675,1147.3333739999998,1155.3666989999997,1162.2333979999999,1132.4333499999998,1125.5666509999999,1117.5333259999998,0.3825546187039674,-20085883.0,-1
2016-05-23,1141.949951,1149.949951,1133.199951,1140.900024,1112.944824,865883.0,1145.2200194,1145.2245648545454,21.25,53.7785938564735,-2.648911562718988,25.78316898919229,20.67495084368554,28220.838220461832,-223473.74071314884,84.0,0.0,80.0,33.349975000000086,1141.3499753333333,1149.4999996666666,1158.099975333333,1166.2499996666666,1132.7499996666666,1124.5999753333333,1115.9999996666666,0.45970585074626713,-19220000.0,+1
2016-05-24,1138.400024,1143.650024,1135.550049,1136.75,1116.0778810000002,814867.0,1144.755017,1143.6845613272728,-4.65002400000003,50.10206173716959,-3.0366736743751463,23.01579000184438,10.54491647803114,-616461.6691388334,-241336.82836886175,80.0,0.0,88.0,28.34997599999997,1138.6500243333332,1141.7499996666666,1146.7499993333336,1149.8499746666666,1133.6500246666665,1130.5500493333332,1125.5500496666664,0.14814255599554849,-20034867.0,-1
2016-05-25,1146.300049,1175.949951,1146.300049,1139.949951,1148.729614,1441837.0,1144.2600097000002,1142.8109129636364,-4.950072999999975,52.96300420521603,-3.342773725610207,23.267995177359126,48.11308876965865,1169576.4638763743,-177204.40599407823,76.0,0.0,92.0,31.300048999999944,1154.0666503333334,1161.833251666667,1183.7165523333338,1191.483153666667,1132.1833496666668,1124.4167483333333,1102.5334476666667,-0.21416927448865986,-18593030.0,+1
2016-05-26,1176.099976,1188.900024,1166.25,1173.300049,1158.471069,3426390.0,1147.7100097,1148.0909201090908,34.5,72.15906279883578,-1.4313216493699321,21.822307288439788,106.52739509714326,-267793.149577856,-181322.07615697721,96.0,8.0,92.0,21.449951000000056,1176.1500243333332,1186.0500486666665,1198.8000483333335,1208.7000726666665,1163.4000246666665,1153.5000003333332,1140.7500006666664,0.31126011168906204,-15166640.0,+1
2016-05-27,1183.25,1190.0,1176.699951,1183.25,1161.946899,1443796.0,1151.1250121,1154.5527365272728,34.15002400000003,75.58860965280202,-0.618698441796517,20.806487934067945,115.83196733116533,-294311.37578007573,-186457.9534125726,96.0,4.0,88.0,14.90002400000003,1183.3166503333334,1189.9333496666668,1196.6166993333331,1203.2333986666667,1176.6333006666669,1170.0166013333335,1163.333251666667,0.49248307280672216,-13722844.0,+1
2016-05-30,1187.0,1195.0,1178.099976,1186.800049,1155.044434,953633.0,1155.7150146000001,1161.0391068727272,45.900024999999914,76.76682006904338,-0.7481707116788372,20.399465564619277,112.48691253617291,-1005038.705614455,-223666.1694217491,96.0,0.0,84.0,16.75,1186.6333416666666,1195.1667073333333,1203.5333656666667,1212.0667313333333,1178.2666833333333,1169.7333176666666,1161.3666593333332,0.5147964878629734,-12769211.0,+1
2016-05-31,1185.900024,1185.900024,1177.400024,1179.75,1157.149414,1378910.0,1157.4100097,1165.409104218182,16.949951000000056,69.12223671719018,-1.3914233576642336,18.555112519209388,88.4429725398186,-620967.8474737236,-241725.3366059298,96.0,0.0,80.0,8.099975000000086,1181.0166826666666,1184.6333413333332,1189.5166826666668,1193.1333413333332,1176.1333413333332,1172.5166826666666,1167.6333413333332,0.2764677647058788,-14148121.0,-1
2016-06-01,1182.949951,1182.949951,1171.0,1181.900024,1150.540894,1418908.0,1160.255017,1169.861834090909,28.450072999999975,70.16760069740555,-1.19525328467153,18.027792709743835,74.32518070118051,585869.9412415372,-204107.3694310449,92.0,8.0,76.0,39.199951000000056,1178.6166583333334,1186.2333166666667,1190.5666093333334,1198.1832676666668,1174.2833656666667,1166.6667073333333,1162.3334146666666,0.9121396397357595,-12729213.0,+1
2016-06-02,1174.699951,1180.599976,1171.0,1175.150024,1150.344971,1977654.0,1163.705017,1172.5700171818182,34.5,62.502349164618124,-1.8111291970802892,15.636953160643316,60.14931717465783,844225.0879551392,-156455.89409530922,88.0,4.0,88.0,48.950072999999975,1175.5833333333333,1180.1666666666665,1185.1833093333335,1189.7666426666665,1170.5666906666665,1165.9833573333333,1160.9667146666666,0.4322952474047897,-14706867.0,-1
2016-06-03,1180.099976,1185.0,1169.050049,1174.949951,1147.211914,1131105.0,1167.2700072000002,1174.6145506363637,35.64990200000011,62.2697012391405,-1.8293840328467104,15.135084020499107,56.34652712886924,-967491.3354916412,-193321.14143150617,84.0,0.0,92.0,16.699951000000056,1176.3333333333333,1183.6166176666666,1192.283284333333,1199.5665686666666,1167.6666666666665,1160.3833823333332,1151.7167156666665,0.36990094828505055,-15837972.0,-1
2016-06-06,1176.0,1182.400024,1170.050049,1171.75,1146.575562,1386827.0,1170.3550048000002,1175.4290947818183,30.84997599999997,58.267214936398766,-2.1213503649635035,15.788053456290754,46.47774765561069,400461.8465056736,-166331.0056161798,80.0,4.0,96.0,16.90002400000003,1174.7333576666667,1179.4166663333335,1187.0833326666666,1191.7666413333336,1167.0666913333334,1162.3833826666666,1154.7167163333334,0.1376481328909608,-17224799.0,-1
2016-06-07,1176.949951,1180.0,1167.650024,1171.099976,1149.1210939999999,1407126.0,1173.7900024000003,1175.564544090909,34.34997599999997,57.402411943800026,-2.180659124087594,17.974465553816117,39.57830824636777,341589.76825223985,-143243.6977130698,76.0,0.0,96.0,9.400024999999914,1172.9166666666667,1178.1833093333335,1185.266642666667,1190.5332853333334,1165.8333333333335,1160.5666906666668,1153.4833573333335,0.2793488829451934,-18631925.0,-1
2016-06-08,1175.800049,1178.0,1161.0,1173.699951,1138.25354,1185703.0,1177.1650024000003,1175.548171109091,33.75,60.13322350014977,-1.943435127737221,19.35364714235061,29.489964639107463,-877607.675035472,-176623.87850045174,72.0,0.0,84.0,11.949951000000056,1170.8999836666667,1180.7999673333334,1187.8999836666667,1197.7999673333334,1163.7999673333334,1153.8999836666667,1146.7999673333334,0.7470559411764739,-17446222.0,+1
2016-06-09,1162.5,1164.199951,1152.5,1162.599976,1135.120483,1162046.0,1176.0949951000002,1172.8999844909092,-10.700072999999975,45.70100213762315,-2.9562065693430686,21.325561614052504,-7.51614925614412,1304526.5454468105,-109298.8592301216,68.0,4.0,84.0,10.90002400000003,1159.7666423333333,1167.0332846666665,1171.4665933333335,1178.7332356666666,1155.3333336666665,1148.0666913333332,1143.6333826666664,0.8632494272839195,-18608268.0,-1
2016-06-10,1158.400024,1172.699951,1156.199951,1159.400024,1137.029663,1580578.0,1173.7099975,1169.8645352,-23.84997599999997,42.32224653457357,-3.2481729927007272,23.6561405192831,-1.4637360458122644,-1454058.0272494897,-170424.27595827475,64.0,0.0,84.0,15.949951000000056,1162.766642,1169.333333,1179.266642,1185.833333,1152.833333,1146.266642,1136.333333,0.19394381818181666,-20188846.0,-1
2016-06-13,1154.75,1164.949951,1151.050049,1161.349976,1128.756714,830809.0,1171.1649902,1167.6172585636364,-25.450072999999975,45.172340173391476,-3.0702576642335795,21.883056851175297,-15.431269417188146,65382.25207195042,-159705.7974114463,60.0,0.0,76.0,12.349975000000086,1159.1166586666666,1167.1832683333332,1173.0165606666665,1181.0831703333333,1153.283366333333,1145.2167566666665,1139.383464333333,0.7410071668131144,-19358037.0,+1
2016-06-14,1155.0,1157.0,1144.25,1152.900024,1127.72876,957192.0,1168.4799926,1164.296355618182,-26.84997599999997,36.22262952737563,-3.841238686131384,17.57874544173592,-38.916339031179575,349109.38788995455,-136577.8344432008,56.00000000000001,4.0,76.0,12.34997599999997,1151.3833413333334,1158.5166826666668,1164.1333413333332,1171.2666826666668,1145.7666826666668,1138.6333413333334,1133.0166826666668,0.6784332549019632,-20315229.0,-1
2016-06-15,1155.0,1170.900024,1153.199951,1151.849976,1145.058105,761456.0,1165.4749878000002,1161.2727162363637,-30.05004800000006,35.22204498657331,-3.9370459854014626,13.818398613014097,-17.855700260595793,-813594.039324438,-167351.29830143886,52.0,0.0,72.0,17.0,1158.6499836666667,1164.1000163333333,1176.3500566666667,1181.8000893333333,1146.3999433333333,1140.9499106666667,1128.6998703333334,-0.07626945945364676,-21076685.0,-1
2016-06-16,1166.550049,1168.849976,1155.349976,1169.550049,1137.8129880000001,1181942.0,1164.9149903000002,1162.0136364545456,-5.599975000000086,57.86152477751553,-2.3220758211678882,11.434043200228189,-2.8607251877394724,-659158.4931996643,-189706.17079681274,48.0,4.0,64.0,21.199951000000056,1164.5833336666667,1173.8166913333334,1178.083333666667,1187.3166913333334,1160.3166913333334,1151.0833336666667,1146.8166913333334,1.0518572592592574,-19894743.0,+1
2016-06-17,1167.0,1178.0,1165.550049,1162.150024,1145.498535,940413.0,1163.6349976000001,1161.510915309091,-12.799927000000025,49.513744370450866,-2.997260583941603,7.995240951751839,8.0603435641637,6877133.819977343,131513.82878383098,44.0,0.0,64.0,16.5,1168.566691,1171.583333,1181.016642,1184.033284,1159.133382,1156.11674,1146.683431,-0.27309545234353927,-20835156.0,-1
2016-06-20,1159.0,1179.25,1158.800049,1170.0,1147.505737,685691.0,1163.4599976000002,1162.6681884727273,-1.75,57.09100956762302,-1.4628782453684102,6.120424149821929,6.553638376631056,114210.77149723624,130727.32617989485,40.0,8.0,60.0,13.899902000000111,1169.3500163333333,1179.8999836666667,1189.7999673333334,1200.3499346666667,1159.4500326666666,1148.9000653333333,1139.0000816666666,0.5476761778060019,-20149465.0,+1
2016-06-21,1175.0,1175.449951,1161.199951,1172.050049,1142.21875,667742.0,1163.5550049,1164.230016,0.9500729999999749,58.94762285779482,-1.1924448434622519,3.6793172056306958,-0.9039226773760798,-139742.94376452433,118433.22300060306,36.0,4.0,52.00000000000001,17.09997599999997,1169.5666503333334,1177.9333496666668,1183.8166503333337,1192.1833496666668,1163.6833496666668,1155.3166503333334,1149.4333496666668,0.7614103859649045,-19481723.0,+1
2016-06-22,1166.0,1175.0,1166.0,1166.650024,1146.967285,950960.0,1162.8500122,1164.7927467454545,-7.049927000000025,52.09650856780057,-1.6896847145488003,2.7880455289900965,-10.434252780627158,649917.0051922302,142591.5767365861,32.0,0.0,52.0,18.0,1169.2166746666667,1172.4333493333334,1178.2166746666667,1181.4333493333334,1163.4333493333334,1160.2166746666667,1154.4333493333334,0.07222488888889227,-20432683.0,-1
2016-06-23,1169.800049,1191.849976,1167.5,1171.5,1165.177612,981683.0,1163.7400146000002,1166.3654718,8.90002400000003,57.245989999657056,-1.8621015186809107,1.4424734602855551,66.8398109309632,-1265360.8884683438,78593.73740908924,28.000000000000004,0.0,44.0,17.0,1176.949992,1186.3999840000001,1201.2999680000003,1210.74996,1162.0500080000002,1152.600016,1137.7000320000002,0.1642712091379476,-19451000.0,+1
2016-06-24,1159.849976,1171.900024,1147.0,1190.099976,1137.568237,2793491.0,1166.8100098,1171.1581920545455,30.69995199999994,71.02763325134828,-0.16013176908373744,-0.6909473442024137,-1.8312162370672775,-317986.9610268101,60567.34202563925,24.0,4.0,44.0,12.449951000000056,1169.6666666666667,1192.3333333333335,1194.5666906666665,1217.2333573333335,1167.4333093333335,1144.7666426666667,1142.5332853333334,1.7309210625660407,-16657509.0,+1
2016-06-27,1162.0,1169.0,1153.050049,1161.900024,1135.659058,1040947.0,1166.8650146,1170.2654673636364,0.5500480000000607,45.416767424374655,-2.740536455847435,-2.1417838708687214,-113.26364827092563,-425152.2719464932,38489.17775417867,20.0,0.0,32.0,20.449951000000056,1161.316691,1169.583333,1177.266642,1185.533284,1153.633382,1145.36674,1137.683431,0.5548590713538903,-17698456.0,-1
2016-06-28,1161.25,1173.099976,1150.0,1159.949951,1142.512451,1008745.0,1167.5700073,1169.0081830727272,7.049927000000025,44.14664657830859,-2.918975678323107,-3.138160251824047,-113.6658179017567,403818.6164964052,55095.0613333708,16.0,0.0,32.0,14.25,1161.0166423333333,1172.0332846666665,1184.1166183333335,1195.1332606666665,1148.9333086666666,1137.9166663333333,1125.8333326666666,0.4307342570399237,-18707201.0,-1
2016-06-29,1165.0,1169.5,1159.699951,1166.949951,1153.222534,1355167.0,1169.0800048,1168.8954455636365,15.099975000000086,49.94460138711558,-2.2784486019881576,-4.511085724269151,-27.784493683104063,-800378.7251769314,16209.889219266131,12.0,56.00000000000001,32.0,9.0,1165.3833006666666,1171.0666503333332,1175.1833496666663,1180.8666993333331,1161.2666013333333,1155.5832516666667,1151.4665523333333,0.7397922194062541,-17352034.0,+1
2016-06-30,1171.0,1180.0,1162.150024,1168.300049,1161.267212,4069723.0,1168.9550047999999,1168.7536354181818,-1.25,51.07484724413181,-2.154909412744501,-4.462043697205672,66.46324937168491,785155.7932657235,51161.97576683241,8.0,52.0,28.000000000000004,25.19995199999994,1170.1500243333332,1178.1500246666665,1188.000000333333,1196.0000006666664,1160.3000486666665,1152.3000483333333,1142.4500726666665,0.34453967893289744,-13282311.0,+1
2016-07-01,1180.0,1185.0,1171.800049,1176.449951,1159.342407,1076219.0,1170.3849975,1170.116352909091,14.299927000000025,57.72379597354964,-1.4091618555335828,-1.8424944319226597,195.9633413460246,-2034292.683880574,-43631.417853504325,4.0,48.0,20.0,24.90002400000003,1177.75,1183.699951,1190.949951,1196.899902,1170.5,1164.550049,1157.300049,0.3522666106866678,-12206092.0,+1
2016-07-04,1178.199951,1179.5,1171.400024,1174.5,1157.664429,1812463.0,1170.8349975,1170.8645351818182,4.5,55.63642690767017,-1.587589914537361,-0.9332361135011524,133.2805575621422,-730391.5992943468,-74847.789737179,0.0,44.0,20.0,37.049927000000025,1175.1333413333334,1178.8666586666668,1183.2333173333332,1186.9666346666668,1170.7666826666668,1167.0333653333334,1162.6667066666669,0.38271422038781117,-14018555.0,-1
2016-07-05,1172.800049,1174.300049,1162.0,1172.800049,1150.557251,534082.0,1170.9099975000001,1171.2218172727273,0.75,53.68367439395091,-1.7431420065291767,1.2659679418984524,53.09006848391966,1749104.2840559243,8059.122707962118,68.0,40.0,16.0,23.09997599999997,1169.7000326666666,1177.4000653333333,1182.0000816666666,1189.7001143333332,1165.1000163333333,1157.3999836666667,1152.7999673333334,0.8780492663078003,-14552637.0,-1
2016-07-07,1167.900024,1188.75,1160.900024,1165.599976,1170.348633,1208154.0,1170.8049927000002,1170.2563588181818,-1.0500480000000607,45.82361658394204,-2.4019765362560617,1.865516701598608,90.54637950962558,99966.72114113416,12236.740818560851,64.0,36.0,-44.00000000000001,9.800048999999944,1171.75,1182.599976,1199.599976,1210.449952,1154.75,1143.900024,1126.900024,0.16875964273721258,-15760791.0,-1
2016-07-08,1185.099976,1185.599976,1171.25,1185.650024,1159.687866,779717.0,1172.2199951,1172.9554554181818,14.15002400000003,63.15649984832941,-0.5673195897109979,2.8421886776541214,213.77383586939524,-953026.322739944,-31638.85297955304,60.0,32.0,-44.0,17.84997599999997,1180.8333333333333,1190.4166666666665,1195.1833093333335,1204.7666426666665,1176.0666906666665,1166.4833573333333,1161.7167146666666,1.0034876713382699,-14981074.0,+1
2016-07-11,1186.0,1201.900024,1181.050049,1174.849976,1184.266602,1275633.0,1170.6949951000001,1173.4336337636364,-15.25,52.68103554875346,-2.4526291967874743,3.9562630603290927,231.84455746178332,-962614.966972943,-73955.94907016172,56.00000000000001,28.000000000000004,-44.0,16.699951000000056,1185.9333496666666,1190.8166503333332,1206.7833246666664,1211.6666253333333,1169.9666753333331,1165.0833746666665,1149.116700333333,-0.2973659680647075,-16256707.0,-1
2016-07-12,1209.900024,1209.900024,1195.550049,1199.75,1186.63562,1761508.0,1174.4799927,1178.7163619272728,37.84997599999997,67.16793425159744,-0.9136757386549512,5.096485450996397,338.58260272605247,394017.92914176214,-52684.40915143788,96.0,24.0,-44.0,8.09997599999997,1201.7333576666667,1207.9166663333335,1216.0833326666666,1222.2666413333336,1193.5666913333334,1187.3833826666666,1179.2167163333334,0.29268002209063293,-14495199.0,+1
2016-07-13,1199.800049,1201.949951,1193.300049,1202.150024,1182.29248,1671768.0,1178.7,1183.747276709091,42.200072999999975,68.24902218949454,-0.6976325351128086,3.554621590292527,208.46377560617992,-1648620.0557602432,-125226.93854274727,96.0,20.0,28.0,12.5,1199.1333413333334,1204.966633666667,1207.7832433333338,1213.616535666667,1196.3167316666668,1190.4834393333333,1187.6668296666667,1.0231300886414634,-12823431.0,+1
2016-07-14,1201.0,1202.150024,1192.199951,1197.75,1184.858765,864917.0,1181.7800049000002,1187.2109130727272,30.800048999999944,63.80472567731579,-1.0937099412647082,5.782055393306109,147.25574210636475,261848.72253211698,-107632.59031207161,92.0,16.0,28.0,27.84997599999997,1197.3666583333334,1202.5333656666667,1207.3167313333333,1212.4834386666666,1192.5832926666667,1187.4165853333334,1182.6332196666667,0.5577897770197222,-13688348.0,-1
2016-07-15,1203.800049,1226.0,1195.099976,1200.349976,1207.907349,1443554.0,1184.9849976,1190.5872714545453,32.049927000000025,65.34342727656585,-2.275955989352265,8.759721655737849,178.31093868790163,112183.84355069378,-97640.93422740046,88.0,12.0,28.0,20.0,1207.149984,1219.1999919999998,1238.0500079999997,1250.1000159999999,1188.2999679999998,1176.2499599999999,1157.3999439999998,0.16990278065803427,-12244794.0,+1
2016-07-18,1225.0,1238.5,1222.650024,1223.699951,1211.609009,1109621.0,1189.7099976000002,1197.626353890909,47.25,75.94165536893652,-1.2988195699868315,10.94293424842158,241.17488919855103,-1632641.3817791103,-167413.68184338734,96.0,8.0,28.000000000000004,20.849975000000086,1228.283325,1233.9166260000002,1244.1333010000003,1249.7666020000001,1218.0666500000002,1212.4333490000001,1202.2166740000002,0.06624155140676725,-11135173.0,+1
2016-07-19,1229.0,1230.75,1213.849976,1227.449951,1202.626587,646501.0,1195.0049927,1204.4881636,52.949951000000056,77.23188631964754,-0.969727863097845,13.125526473852915,168.88778188115097,1767230.189646864,-79475.32404837586,96.0,4.0,72.0,35.05004800000006,1224.0166423333333,1234.1833086666666,1240.916666333333,1251.0833326666666,1217.2832846666665,1207.1166183333332,1200.3832606666665,0.8047311057073091,-10488672.0,+1
2016-07-20,1223.0,1238.5,1221.75,1218.349976,1216.297729,1172583.0,1199.5599854,1208.7327060181817,45.549927000000025,67.14873292208077,-1.7683215445370806,14.345355995260434,144.2738953112135,7653.2949005356895,-75514.93227797079,92.0,0.0,76.0,8.649902000000111,1226.199992,1230.6499840000001,1242.9499919999998,1247.3999840000001,1213.8999840000001,1209.449992,1197.1499840000001,-0.20298650746268837,-11661255.0,-1
2016-07-21,1230.699951,1239.900024,1222.5,1232.199951,1212.744263,2278226.0,1206.2199829,1214.6672452181817,66.59997500000009,73.27589763872352,-0.6749121604015301,15.881231247602273,132.50269119879258,-2186977.784828974,-171490.51648483463,88.0,28.000000000000004,76.0,9.950072999999975,1231.533325,1240.5666500000002,1248.933349,1257.9666740000002,1223.1666260000002,1214.133301,1205.7666020000001,0.5574676793549272,-9383029.0,+1
2016-07-22,1233.349976,1234.650024,1221.5,1228.599976,1214.915894,1405068.0,1210.5149781,1218.7363348727272,42.94995199999994,69.39413818570365,-0.9904503253827664,17.7935066142677,101.10265913654115,673470.1937292063,-133083.21147510546,96.0,24.0,76.0,30.90002400000003,1228.25,1235.0,1241.400024,1248.150024,1221.849976,1215.099976,1208.699952,0.5399211438701521,-10788097.0,-1
2016-07-25,1233.0,1249.449951,1227.0,1230.800049,1230.857422,2468221.0,1216.1099854,1222.4245295818182,55.950072999999975,70.49626112264086,-1.6210963357240482,22.244744286579134,104.76063979592897,257609.26900027686,-115324.46236258808,92.0,20.0,88.0,38.15002400000003,1235.75,1244.5,1258.199951,1266.949951,1222.050049,1213.300049,1199.600098,0.169267585483814,-8319876.0,+1
2016-07-26,1242.400024,1245.650024,1235.150024,1246.949951,1222.8126220000001,1416498.0,1220.8299805,1228.0317960545456,47.199951000000056,77.39184756732924,-0.21730628071450978,24.29545941240417,102.7175194228745,-1016896.2993459869,-156305.00040728805,96.0,16.0,92.0,16.90002400000003,1242.583333,1250.016642,1253.083333,1260.516642,1239.516642,1232.083333,1229.016642,1.1238025714285738,-6903378.0,+1
2016-07-27,1241.0,1247.550049,1230.0,1238.800049,1220.986328,2683684.0,1224.4949829999998,1231.2990812363637,36.650024999999914,68.12126065161581,-0.9257162374376172,28.522270256949014,76.7673808883827,352864.9662441229,-133160.91101404207,92.0,12.0,92.0,16.75,1238.783366,1247.5667319999998,1256.333415,1265.1167809999997,1230.0166829999998,1221.233317,1212.4666339999999,0.5014258934547688,-9587062.0,-1
2016-07-28,1238.0,1251.25,1235.550049,1236.949951,1232.338013,2661632.0,1228.4149781,1233.5636208727274,39.199951000000056,66.0488883377063,-1.2410543718810974,29.782003014949396,69.0669518290183,53389.632957322094,-124681.34083352551,88.0,8.0,60.0,21.55004800000006,1241.25,1246.949951,1256.949951,1262.649902,1231.25,1225.550049,1215.550049,0.08916601077290662,-12248694.0,-1
2016-07-29,1248.0,1250.0,1235.0,1248.449951,1230.1170650000001,848919.0,1233.2249756,1237.2063432181817,48.099975000000086,72.12988631459118,-0.24300707311780814,30.886784586282147,65.12068861217173,-1602295.5003151072,-191845.6208099611,96.0,4.0,72.0,13.15002400000003,1244.483317,1253.9666339999999,1259.4833170000002,1268.9666339999999,1238.9666339999999,1229.483317,1223.9666339999999,0.8966634000000037,-11399775.0,+1
2016-08-01,1249.0,1258.949951,1227.650024,1246.199951,1226.267456,1390216.0,1235.4749756000003,1239.5654296545456,22.5,69.32668754162505,-1.0991853561447325,33.12530983693932,56.39793831315255,-118791.14337530654,-188524.96274474953,92.0,0.0,72.0,22.449951000000056,1244.266642,1260.88326,1275.566569,1292.183187,1229.583333,1212.966715,1198.283406,0.5926508071408604,-12789991.0,-1
2016-08-02,1247.0,1256.449951,1240.400024,1242.300049,1227.254517,1332349.0,1236.9599854,1240.8063520909093,14.850097999999889,64.32691279929232,-1.4353983105603934,36.41437477251543,53.75542834668927,595610.0465818724,-152882.46232081216,96.0,4.0,80.0,14.849975000000086,1246.3833413333334,1252.3666586666668,1262.4332683333337,1268.4165856666668,1236.3167316666668,1230.3334143333334,1220.2668046666668,0.1183821583736743,-14122340.0,-1
2016-08-03,1241.099976,1249.949951,1231.0,1243.300049,1224.441284,1183469.0,1239.4549927,1241.9590909272727,24.950072999999975,65.07218617166737,-1.349187694392179,34.98982886760041,37.7181366478304,687398.4083638468,-114687.87728969127,92.0,0.0,80.0,17.550048999999944,1241.4166666666667,1251.8333333333335,1260.3666176666666,1270.7832843333335,1232.8833823333334,1222.4667156666667,1213.9334313333334,0.6490807812642845,-12938871.0,+1
2016-08-04,1246.599976,1246.699951,1233.599976,1240.449951,1224.9842529999999,1165720.0,1240.2799927,1242.1399924363636,8.25,60.888871493390496,-1.594896399111965,32.870387527239245,29.384670808831547,-175755.64054891976,-117463.68471056529,88.0,0.0,80.0,15.699951000000056,1240.2499593333334,1246.899942666667,1253.3499343333337,1259.999917666667,1233.7999676666668,1227.1499843333334,1220.6999926666667,0.5228998528623178,-14104591.0,-1
2016-08-05,1247.400024,1255.650024,1241.75,1241.0,1233.127808,1446228.0,1241.5199951000002,1242.2709028545455,12.40002400000003,61.440874953889896,-1.5474763358992594,32.49455342922283,35.15877070437412,156202.64742868638,-105024.30597696292,84.0,16.0,92.0,15.0,1246.1333413333334,1250.5166826666668,1260.0333653333337,1264.4167066666669,1236.6166586666668,1232.2333173333334,1222.7166346666668,-0.05395674136965507,-12658363.0,+1
2016-08-08,1252.900024,1255.0,1244.550049,1249.25,1233.473267,1182194.0,1243.3649902,1243.6763582909089,18.449951000000056,69.0102496856615,-0.8362387525114914,30.56580003554336,37.95007029369162,181164.87116598175,-92015.70701591996,80.0,12.0,92.0,31.299927000000025,1249.6000163333333,1254.6499836666667,1260.0499673333334,1265.0999346666667,1244.2000326666666,1239.1500653333333,1233.7500816666666,0.44975818546900653,-11476169.0,+1
2016-08-09,1252.900024,1252.900024,1237.699951,1249.599976,1231.104248,1052714.0,1243.6299927000002,1244.8099920727273,2.650024999999914,69.3051872201946,-0.806067105907407,29.674511662557734,29.039806548836136,-1066253.919966796,-136299.26215005072,76.0,8.0,92.0,16.049927000000025,1246.733317,1255.7666829999998,1261.9333899999997,1270.9667559999998,1240.5666099999999,1231.533244,1225.3665369999999,0.7828926216341154,-10423455.0,+1
2016-08-10,1245.0,1250.949951,1219.75,1247.199951,1211.0661619999998,904930.0,1244.4699829,1245.4590754,8.399902000000111,64.45151433586922,-1.012974739976518,28.359558588722166,9.687268034968577,-1475360.451197102,-197165.67983400766,72.0,4.0,92.0,18.949951000000056,1239.2999673333334,1258.8499346666667,1270.4999183333334,1290.0498856666668,1227.6499836666667,1208.1000163333333,1196.4500326666666,0.8798075035438359,-11328385.0,-1
2016-08-11,1226.800049,1235.0,1222.0,1226.900024,1212.398804,714018.0,1243.4649901999999,1242.264537418182,-10.049927000000025,38.28449330915492,-2.76304395481629,24.14532314998951,-21.144548605803177,1628625.7313017778,-114175.16114601734,68.0,0.0,88.0,13.099975000000086,1227.9666746666667,1233.9333493333334,1240.9666746666667,1246.9333493333334,1220.9333493333334,1214.9666746666667,1207.9333493333334,0.37692492307692543,-12042403.0,-1
2016-08-12,1231.050049,1235.0,1219.400024,1228.25,1212.842896,1160374.0,1241.4449951,1239.4981755636363,-20.199951000000056,40.149033727055354,-2.646661692043992,20.438478987797453,-26.68317728953882,-127818.48608051827,-114795.31227940376,64.0,0.0,68.0,15.200072999999975,1227.550008,1235.6999919999998,1243.1499840000001,1251.2999679999998,1220.1000159999999,1211.950032,1204.50004,0.5673070266261939,-10882029.0,+1
2016-08-16,1233.0,1238.449951,1213.800049,1228.699951,1211.4610599999999,867142.0,1239.6949951000001,1237.180894818182,-17.5,40.836448435224256,-2.607871139088483,18.11419360620107,-30.737736408100996,91926.62356270135,-105398.86065021716,60.0,0.0,68.0,14.0,1226.983317,1240.166585,1251.6332189999998,1264.816487,1215.5166829999998,1202.3334149999998,1190.8667809999997,0.6044609021163672,-10014887.0,+1
2016-08-17,1233.400024,1237.5,1226.0,1227.300049,1218.963013,1377759.0,1238.1949951000001,1234.9272682545454,-15.0,39.21937893706881,-2.728557553083608,13.335415183645182,-24.5875969042139,-678106.8129678974,-131431.04030102084,56.00000000000001,8.0,68.0,15.200072999999975,1230.266683,1234.5333660000001,1241.7666829999998,1246.0333660000001,1223.0333660000001,1218.766683,1211.5333660000001,0.11304773913042995,-11392646.0,-1
2016-08-18,1238.0,1254.900024,1234.550049,1234.900024,1236.3358150000001,1527914.0,1237.3549926000003,1234.3281826,-8.400024999999914,51.2996179200228,-2.073359025470576,10.365697339859253,10.545445532046726,436494.4,-105616.24756006533,52.0,4.0,68.0,31.199951000000056,1241.4500323333334,1248.3500156666669,1261.8000073333337,1268.699990666667,1228.0000406666668,1221.1000573333333,1207.6500656666667,0.017197809825323342,-9864732.0,+1
2016-08-19,1250.0,1250.0,1241.449951,1252.5,1231.005493,1027659.0,1238.5599975000002,1237.081820309091,12.050048999999944,68.19209343801377,-0.5560542499647948,8.382562666665763,35.6879833328525,102425.08927498647,-96159.82315847205,48.0,0.0,68.0,25.199951000000056,1247.983317,1254.5166829999998,1256.5333660000001,1263.0667319999998,1245.9666339999999,1239.433268,1237.416585,1.2923959850990347,-8837073.0,+1
2016-08-22,1245.050049,1254.449951,1241.0,1247.099976,1234.1641849999999,1375323.0,1239.1699951,1238.6345436727272,6.09997599999997,60.7340532881524,-1.0215936463279427,5.771792931976961,33.560563539946486,858082.5746113888,-52785.16871438743,44.0,0.0,64.0,15.59997599999997,1247.5166423333333,1254.0332846666665,1260.9665933333335,1267.4832356666666,1240.5833336666665,1234.0666913333332,1227.1333826666664,0.4535314663971597,-10212396.0,-1
2016-08-23,1251.0,1254.0,1246.050049,1250.300049,1235.299316,1328631.0,1239.275,1240.6581898363636,1.0500489999999445,63.46616269502391,-0.5313320022767974,3.702893778505313,47.96258700601904,-3554004.7038368364,-211931.51121995345,40.0,80.0,60.0,24.64990200000011,1250.1166993333334,1254.1833496666668,1258.0666503333337,1262.1333006666669,1246.2333986666667,1242.1667483333333,1238.2834476666667,0.5345944899534564,-8883765.0,+1
2016-08-24,1252.050049,1264.199951,1247.050049,1251.449951,1245.5157470000001,1392734.0,1239.4599975,1242.8718172909091,1.8499750000000859,64.49057435277305,-1.094232795758159,2.9974544322903967,75.20617930071076,-2194433.12758074,-302045.2210545348,36.0,76.0,48.00000000000001,11.5,1254.233317,1261.416585,1271.3832189999998,1278.566487,1244.2666829999998,1237.0834149999998,1227.1167809999997,0.2565555185096733,-7491031.0,+1
2016-08-25,1264.0,1266.800049,1254.300049,1261.800049,1242.307739,2182472.0,1240.9200073000002,1246.9336448363636,14.600097999999889,72.4991727946638,-0.4281554881147295,1.6090281876236077,114.61132912985165,1520873.2978315959,-219185.2883778924,96.0,72.0,48.0,27.599975000000086,1260.9667156666667,1267.6333823333334,1273.466715666667,1280.1333823333334,1255.1333823333334,1248.4667156666667,1242.6333823333334,0.6,-5308559.0,+1
2016-08-26,1260.0,1261.900024,1253.900024,1258.550049,1240.876465,630284.0,1244.0850098,1250.1391069636363,31.650024999999914,67.02245913866179,-0.7064565553893036,-0.5553877773606928,90.0166844988498,-346410.2798828851,-224968.2425372103,96.0,68.0,48.0,15.09997599999997,1258.116699,1262.3333739999998,1266.1166989999997,1270.3333739999998,1254.3333739999998,1250.116699,1246.3333739999998,0.5812531249999893,-5938843.0,-1
2016-08-29,1255.5,1255.5,1236.199951,1257.099976,1222.121704,736046.0,1246.9700073999998,1252.5054644545453,28.84997599999997,64.51350883572373,-0.8306278980126995,-1.6505061936181846,36.65918691274724,-2361676.8545604483,-322091.36126553937,92.0,64.0,44.0,13.449951000000056,1249.5999756666668,1263.0000003333334,1268.900024666667,1282.3000493333334,1243.6999513333335,1230.2999266666668,1224.3999023333336,1.0829001004090701,-6674889.0,-1
2016-08-30,1245.099976,1270.5,1243.949951,1238.099976,1252.2773439999999,2466902.0,1247.9100099000002,1250.8927314727273,9.400024999999914,41.19750023817308,-2.7656870678617183,-0.6095282283367851,46.69854121423805,582295.3434202663,-280982.87468891183,88.0,60.0,-40.0,7.9499510000000555,1250.8499756666668,1257.7500003333334,1277.400024666667,1284.3000493333334,1231.1999513333335,1224.2999266666668,1204.6499023333336,-0.22033763478177001,-9141791.0,-1
2016-08-31,1269.0,1295.0,1265.5,1268.650024,1274.536255,2790341.0,1252.0450074000003,1254.6636431272727,41.349975000000086,64.79981806516366,-2.203175250836118,1.3054426253968359,226.75173771046795,-333555.39162150805,-283372.5345494844,96.0,56.00000000000001,-40.0,17.14990200000011,1276.3833413333334,1287.2666826666668,1305.8833413333332,1316.7666826666668,1257.7666826666668,1246.8833413333334,1228.2666826666668,0.10678047457627221,-6351450.0,+1
2016-09-01,1288.0,1290.0,1275.400024,1291.199951,1267.133057,1306169.0,1257.6750001,1261.7827237818183,56.299927000000025,73.76749231695499,-0.3177298494983231,5.011618922498656,229.9918825036787,371646.24735951953,-253598.9535536205,96.0,52.0,24.0,15.350097999999889,1285.533325,1295.6666260000002,1300.1333010000003,1310.2666020000001,1281.0666500000002,1270.9333490000001,1266.4666740000002,1.08218855976202,-5045281.0,+1
2016-09-02,1285.5,1289.0,1281.150024,1283.699951,1268.515015,988797.0,1260.7949952000001,1266.514533036364,31.199951000000056,67.19767638691982,-0.9448201505016676,8.609451362882055,177.11033943410965,1923343.7638850883,-154647.01185186094,92.0,48.0,28.0,8.0,1284.6166583333334,1288.0832926666667,1292.4666343333333,1295.9332686666667,1280.2333166666667,1276.7666823333334,1272.3833406666668,0.3248324580865005,-6034078.0,-1
2016-09-06,1290.050049,1303.900024,1290.050049,1285.099976,1283.617676,1377221.0,1264.5949951999999,1270.9336204545455,38.0,67.81507146804685,-1.560299412858179,11.44716101632821,183.43966155312984,1443570.477822374,-82000.76232121383,88.0,44.0,28.0,22.35009799999989,1293.016683,1295.9833170000002,1306.8666580000004,1309.8332920000003,1282.133342,1279.166708,1268.283367,-0.35740663791811494,-4656857.0,+1
2016-09-07,1301.0,1305.0,1283.099976,1300.400024,1270.143799,1004111.0,1269.6049927,1277.443625690909,50.099975000000086,73.98852800731174,-0.381424212271971,13.231803874795105,163.34769024384963,-925303.8028335453,-120332.71870813801,96.0,40.0,28.0,26.550048999999944,1296.1666666666667,1309.2333573333335,1318.066690666667,1331.1333813333335,1287.3333333333335,1274.2666426666667,1265.4333093333335,0.7899556639755297,-3652746.0,+1
2016-09-08,1290.0,1295.25,1283.599976,1286.75,1272.759644,726345.0,1273.1349976,1280.5608997454544,35.300048999999944,61.788237274649894,-1.5132669983416251,15.525882075253776,109.3235579348707,-2293506.378398571,-219113.3396031578,96.0,36.0,39.99999999999999,56.90002400000003,1288.5333253333333,1293.4666746666667,1300.1833493333334,1305.1166986666667,1281.8166506666666,1276.8833013333333,1270.1666266666666,0.2703877691582457,-4379091.0,-1
2016-09-09,1290.0,1294.5,1278.300049,1289.400024,1273.746704,1003442.0,1275.8949951,1283.5181772727274,27.599975000000086,63.14941392651166,-1.293530348258704,17.45589888009613,87.77300966833036,528497.3008286835,-185131.03776534682,92.0,32.0,44.0,21.34997599999997,1287.4000243333332,1296.4999996666666,1303.599975333333,1312.6999506666666,1280.3000486666665,1271.2000733333332,1264.1000976666664,0.6851857144506207,-3375649.0,+1
2016-09-12,1274.699951,1284.400024,1271.5,1290.400024,1263.382202,996432.0,1279.0799926,1286.1554552545454,31.849975000000086,63.71224187661697,-1.2106116086235463,19.566480136418022,58.95014200846609,107827.10858140861,-171814.75838594884,88.0,28.000000000000004,44.0,10.049927000000025,1282.100016,1292.7000320000002,1295.00004,1305.6000560000002,1279.8000080000002,1269.199992,1266.8999840000001,1.465115413738764,-2379217.0,+1
2016-09-14,1275.0,1277.0,1265.400024,1279.900024,1253.067017,962377.0,1281.3599974,1286.3045518727274,22.80004800000006,53.76373518806382,-2.081258374792701,20.017046997923217,27.587017138081855,-948223.0274804557,-207106.04334479006,84.0,24.0,44.0,20.200072999999975,1274.100016,1282.8000080000002,1285.6999920000003,1294.3999840000001,1271.2000320000002,1262.5000400000001,1259.6000560000002,1.2500025862122506,-3341594.0,-1
2016-09-15,1272.0,1283.900024,1269.849976,1269.449951,1263.0860599999999,875453.0,1284.4949949000002,1284.139088890909,31.349975000000086,45.589010948227255,-2.947765257048088,20.814578125473872,21.711239930999227,-3148002.0429390157,-340783.1342354368,80.0,20.0,56.0,21.90002400000003,1274.3999836666667,1278.9499913333334,1288.4500316666667,1293.0000393333335,1264.8999433333333,1260.3499356666666,1250.8498953333333,-0.028471432980151555,-4217047.0,-1
2016-09-16,1283.800049,1304.5,1283.800049,1279.599976,1281.100464,1631454.0,1285.5899901,1283.2490854545454,10.94995199999994,53.51092735819998,-2.1061379767827555,22.740685456234814,56.08102387061183,-442359.62908718555,-345400.247637789,76.0,16.0,60.0,16.80004800000006,1289.3000083333334,1294.7999676666668,1309.9999593333337,1315.4999186666669,1274.1000166666668,1268.6000573333333,1253.4000656666667,-0.20290255759542444,-2585593.0,+1
2016-09-19,1297.0,1302.5,1288.0,1297.849976,1273.5,1473708.0,1286.2549926,1285.4781738,6.650024999999914,64.29563949883122,-0.5928709784411302,28.11490426007208,67.41672820016203,2091272.7605920767,-234642.38362734046,72.0,12.0,60.0,16.199951000000056,1296.1166586666666,1304.2333173333332,1310.6166586666668,1318.7333173333332,1289.7333173333332,1281.6166586666666,1275.2333173333332,0.6793086896551703,-1111885.0,+1
2016-09-20,1292.650024,1295.0,1284.050049,1290.150024,1271.8217769999999,944562.0,1286.8999999,1286.1863613272728,6.450072999999975,57.771214702356865,-1.2313412935323358,29.343542701940578,42.20145442470274,-780838.9325652326,-259469.49948815376,68.0,8.0,60.0,17.90002400000003,1289.7333576666667,1295.4166663333335,1300.683308666667,1306.3666173333336,1284.4667153333335,1278.7834066666667,1273.5167643333334,0.5570778353254782,-2056447.0,-1
2016-09-21,1292.0,1298.0,1287.900024,1288.449951,1276.31311,1064100.0,1287.2349974,1286.4681706181818,3.349975000000086,56.31536980492199,-1.3723092039800948,26.20546403910612,39.75605609024417,805159.5042248964,-211077.27204665143,64.0,4.0,60.0,25.0,1291.4499916666666,1294.9999593333332,1301.5499676666664,1305.0999353333332,1284.8999833333332,1281.3500156666666,1274.8000073333333,0.05444834720399601,-3120547.0,-1
2016-09-22,1305.0,1316.949951,1300.550049,1293.0,1290.033813,1638950.0,1286.494995,1287.516352909091,-7.40002400000003,59.469515937297196,-1.9664150386751036,24.190071693738673,63.4483580649945,1788752.6547639102,-120175.91173708037,60.0,0.0,60.0,14.05004800000006,1303.5,1306.449951,1319.899902,1322.8498530000002,1290.050049,1287.100098,1273.6501469999998,-0.46037159246438747,-1481597.0,+1
2016-09-23,1306.050049,1318.449951,1301.5,1306.900024,1295.758789,1219202.0,1288.5099974,1291.2263581818181,20.15002400000003,67.69211415437391,-0.947142356316354,22.320201635709054,71.88268539635698,502087.751436619,-91891.19977463946,96.0,0.0,60.0,35.050048999999944,1308.9499916666666,1316.3999833333332,1325.899942666667,1333.3499343333333,1299.4500323333332,1292.0000406666666,1282.5000813333331,0.3185864077129198,-262395.0,+1
2016-09-26,1306.099976,1308.900024,1293.699951,1312.699951,1279.422607,1394193.0,1290.8399900999998,1295.6245315636365,23.299927000000025,70.56697641394777,-0.4715240666732373,18.31319575990483,57.4709520371167,-1487993.763937194,-155350.40723657378,96.0,0.0,60.0,22.90002400000003,1305.0999753333333,1316.4999996666666,1320.300048333333,1331.7000726666665,1301.2999266666666,1289.8999023333333,1286.0998536666666,1.2499939967393598,1131798.0,+1
2016-09-27,1299.0,1306.150024,1294.849976,1296.150024,1281.297974,1014203.0,1291.4149900999998,1296.5899922727272,5.75,54.57723349278968,-1.8286873505315369,16.12413036392968,36.63399773691113,-158453.22553338006,-155491.44443188317,92.0,24.0,60.0,13.799927000000025,1299.050008,1303.25004,1310.3500559999998,1314.550088,1291.9499919999998,1287.7499599999999,1280.6499439999998,0.11504800687572776,117595.0,-1
2016-09-28,1299.900024,1300.0,1289.0,1298.050049,1278.534058,1247413.0,1293.2299926000003,1297.796366618182,18.150024999999914,55.90090668006047,-1.672877347960967,14.659471190276008,22.251812322695557,102163.67821492496,-143779.84794793735,88.0,20.0,60.0,10.09997599999997,1295.6833496666666,1302.3666993333331,1306.6833496666668,1313.3666993333331,1291.3666993333331,1284.6833496666666,1280.3666993333331,0.8227317272727223,1365008.0,+1
2016-09-29,1297.949951,1306.0,1267.949951,1295.25,1261.013184,4112503.0,1295.8099975000005,1298.163640690909,25.800048999999944,53.2616824258926,-1.9024930855895417,12.599576182530427,-2.876502250028797,-107171.25499973378,-142115.8209957463,84.0,16.0,60.0,28.5,1289.733317,1311.5166829999998,1327.7833660000001,1349.5667319999998,1273.4666339999999,1251.683268,1235.416585,0.717477367768961,-2747495.0,-1
2016-09-30,1277.099976,1281.0,1267.400024,1277.5,1256.423096,1034607.0,1295.5999999,1294.8345502363636,-2.0999759999999696,39.58996222334575,-3.3580673783634483,11.71179929357777,-61.11656786841404,-7262.466771122382,-135986.12307644522,80.0,12.0,96.0,25.449951000000056,1275.300008,1283.1999919999998,1288.8999840000001,1296.7999679999998,1269.6000159999999,1261.700032,1256.00004,0.7426466046704783,-3782102.0,-1
2016-10-03,1281.0,1289.900024,1276.400024,1272.849976,1270.5878910000001,975137.0,1293.0999999,1290.6981822545454,-25.0,36.73931132007919,-3.739388809077912,12.281861775126572,-44.668492722946134,-702746.5225901142,-161747.95941797565,76.0,8.0,96.0,15.200072999999975,1279.7166746666667,1283.0333253333333,1293.2166746666667,1296.5333253333333,1269.5333253333333,1266.2166746666667,1256.0333253333333,-0.26296651851852304,-4757239.0,-1
2016-10-04,1288.599976,1295.0,1282.300049,1287.199951,1272.907715,693878.0,1292.8049925999999,1289.6254460909092,-2.950072999999975,49.64888493077975,-2.5626307971371594,12.561987686536895,-9.84846810512836,1665945.288182698,-78670.99361794496,72.0,4.0,68.0,17.849975000000086,1288.1666666666667,1294.0332843333335,1300.866617666667,1306.7332353333336,1281.3333333333335,1275.4667156666667,1268.6333823333334,0.3858205437170655,-4063361.0,+1
2016-10-05,1298.0,1300.050049,1276.400024,1289.550049,1269.502197,911755.0,1292.9150023999998,1289.0336381636364,1.100097999999889,51.518436027061846,-2.369912924782274,10.180816469900037,-6.899962605122719,254194.75,-63540.732544401995,68.0,0.0,68.0,11.0,1288.6667073333333,1300.9333906666666,1312.3167323333332,1324.5834156666665,1277.2833656666667,1265.0166823333334,1253.6333406666668,0.5560258392961513,-3151606.0,+1
2016-10-06,1287.099976,1295.599976,1279.050049,1286.099976,1265.4057619999999,723928.0,1292.225,1287.7945424545455,-6.90002400000003,48.46990490958205,-2.6528333510917568,8.58465583745874,-13.266184968623625,932836.8682340253,-18250.841599927986,64.0,0.0,68.0,38.050048999999944,1286.916667,1294.783285,1303.466594,1311.333212,1278.233358,1270.36674,1261.683431,0.42597934117775954,-3875534.0,-1
2016-10-07,1284.0,1287.75,1276.25,1281.949951,1264.07312,834366.0,1289.7299927,1285.9263517272727,-24.950072999999975,44.79123097326936,-2.9931527710562023,5.8669452802676005,-38.58747109097625,-733560.722319806,-50764.927087195196,60.0,32.0,68.0,27.84997599999997,1281.983317,1287.7166339999999,1293.4833170000002,1299.2166339999999,1276.2166339999999,1270.483317,1264.7166339999999,0.4956479130434831,-4709900.0,-1
2016-10-10,1285.0,1287.900024,1278.75,1280.599976,1267.77478,1179828.0,1286.5199952,1284.2663486909094,-32.099975000000086,43.55061785773359,-3.103856371387897,4.289200588879794,-38.55673420703797,238515.0440767969,-37615.83748883191,56.00000000000001,28.000000000000004,68.0,13.5,1282.4166666666667,1286.0833333333335,1291.5666906666665,1295.2333573333335,1276.9333093333335,1273.2666426666667,1267.7832853333334,0.2021826390837842,-5889728.0,-1
2016-10-13,1279.0,1279.0,1256.449951,1284.349976,1246.453491,1129839.0,1285.3399904,1283.8717997454544,-11.80004800000006,48.15336768856775,-2.7963406757314373,2.146683134435307,-93.60886756894769,-85116.05596339396,-39774.93832858473,52.0,24.0,68.0,22.15002400000003,1273.2666423333333,1290.0833336666665,1295.816691333333,1312.6333826666664,1267.5332846666665,1250.7165933333333,1244.9832356666666,1.2372489744922497,-4759889.0,+1
2016-10-14,1265.75,1268.0,1254.0,1262.75,1245.5157470000001,1016779.0,1281.8099855000003,1279.7645287636362,-35.300048999999944,31.229664393725287,-4.5676291146121875,-2.0755759615203715,-160.15154670297412,-515021.5978239791,-61377.05921473903,48.0,96.0,68.0,23.650024999999914,1261.5833333333333,1269.1666666666665,1275.583333333333,1283.1666666666665,1255.1666666666665,1247.5833333333333,1241.1666666666665,0.625,-5776668.0,-1
2016-10-17,1265.5,1266.400024,1232.75,1261.800049,1221.7266849999999,1283840.0,1278.4649904000003,1276.1263584909093,-33.449951000000056,30.682453587210134,-4.6455290726400715,-4.2784569663772345,-198.94288023671976,180292.34491603382,-50392.086299703886,44.0,96.0,64.0,16.549927000000025,1253.6500243333332,1274.5500486666665,1287.3000483333335,1308.2000726666665,1240.9000246666665,1220.0000003333332,1207.2500006666664,0.8632995031444827,-7060508.0,-1
2016-10-18,1243.199951,1260.0,1239.0,1237.699951,1241.616699,652742.0,1274.4849855,1268.7145331454544,-39.800048999999944,20.280237107760996,-5.884789783258982,-6.64089110134978,-224.83064356363306,864326.3966177164,-8813.973439821113,40.0,96.0,28.0,11.5,1245.5666503333334,1252.1333006666669,1266.5666503333332,1273.1333006666669,1231.1333006666669,1224.5666503333334,1210.1333006666669,-0.061907095238092597,-7713250.0,-1
2016-10-19,1261.099976,1263.0,1248.0,1257.849976,1242.110352,761226.0,1272.9849855,1265.6899859636364,-15.0,39.9279819995004,-4.001163653209691,-9.271542497325981,-136.62334165123391,24639.939815424877,-7293.341019128113,36.0,92.0,28.000000000000004,9.15002400000003,1256.2833253333333,1264.5666506666666,1271.2833253333333,1279.5666506666666,1249.5666506666666,1241.2833253333333,1234.5666506666666,0.6566650666666647,-6952024.0,+1
2016-10-20,1260.25,1267.449951,1251.0,1258.349976,1239.2971189999998,800089.0,1270.099988,1263.0290751454543,-28.849975000000086,40.348909616552945,-3.9478064623032334,-9.465082887653352,-106.9305410755202,-225570.8104197829,-17215.04417370334,32.0,88.0,28.0,24.150024999999914,1258.933309,1266.866618,1275.38326,1283.316569,1250.416667,1242.483358,1233.966716,0.44680838259031563,-6151935.0,+1
2016-10-21,1256.0,1272.949951,1250.0,1255.5,1254.3009029999998,989102.0,1266.6949831,1260.3745318727272,-34.050048999999944,38.57136968554594,-4.183927091963547,-9.067557840656036,-89.64122396124141,134230.48213324626,-10331.156614296533,28.000000000000004,84.0,-48.0,30.34997599999997,1259.483317,1268.9666339999999,1282.4332679999998,1291.916585,1246.0166829999998,1236.533366,1223.0667319999998,0.23965192779714373,-7141037.0,-1
2016-10-24,1271.75,1276.849976,1261.050049,1270.699951,1247.243286,813916.0,1265.1549805999998,1261.1027078545455,-15.400024999999914,51.673022544870534,-2.4437031599504886,-11.014050321904506,-34.37330002475658,364549.851561377,6708.889211870459,24.0,80.0,-52.0,33.65002400000003,1269.5333253333333,1278.0166016666667,1285.3332523333333,1293.8165286666667,1262.2166746666667,1253.7333983333333,1246.4167476666667,0.6107561129871104,-6327121.0,+1
2016-10-25,1268.0,1268.0,1244.050049,1263.550049,1234.1641849999999,1375449.0,1263.3149904,1260.8109021090909,-18.39990200000011,46.31192291640089,-3.039007411089161,-14.329856036566298,-70.87347682146645,2553322.693534336,122464.062135619,20.0,76.0,-56.0,22.800048999999944,1258.533366,1273.0166829999998,1282.4833169999997,1296.9666339999999,1249.0667319999998,1234.5834149999998,1225.1167809999997,0.8141979079623151,-7702570.0,-1
2016-10-26,1243.349976,1265.0,1235.050049,1250.300049,1223.3061519999999,1341635.0,1260.2849976999998,1258.4445491272725,-30.299927000000025,37.9032072367331,-4.142208731553035,-17.144266666008434,-91.91592611585729,30743.360698906046,118294.93934304114,16.0,72.0,-56.0,25.300048999999944,1250.1166993333334,1265.1833496666668,1280.0666503333337,1295.1333006666669,1235.2333986666667,1220.1667483333333,1205.2834476666667,0.5091828030035833,-9044205.0,-1
2016-10-27,1239.0,1257.0,1224.150024,1239.300049,1235.940918,2905965.0,1255.7800050000003,1254.6291039090906,-45.049927000000025,32.28759331100551,-5.05807397873059,-18.789774533914624,-110.6275074828691,1991624.1766611487,203446.26831204613,12.0,68.0,-56.0,16.449951000000056,1240.1500243333332,1256.1500246666665,1273.000000333333,1289.0000006666664,1223.3000486666665,1207.3000483333333,1190.4500726666665,0.4611883125881105,-11950170.0,-1
2016-10-28,1254.5,1261.900024,1240.099976,1252.099976,1242.80127,1330134.0,1254.7150026000002,1253.9600077272728,-10.65002400000003,43.52228404155707,-3.6353000896266106,-20.656702908683428,-54.363316146452256,-711319.1644721729,161866.02136730886,8.0,96.0,-56.0,22.949951000000056,1251.3666586666666,1262.6333413333332,1273.1667066666664,1284.4333893333333,1240.8332933333331,1229.5666106666665,1219.033245333333,0.550457503579807,-10620036.0,+1
2016-11-01,1256.0,1263.849976,1247.050049,1259.050049,1243.541626,850604.0,1254.4400026,1254.748197981818,-2.75,48.84031114264238,-2.426610683624655,-23.231618532543735,-29.654076286446198,59750.414802024134,157224.40288706866,4.0,92.0,-56.0,21.34997599999997,1256.6500246666667,1266.2500003333334,1273.449951666667,1283.0499273333335,1249.4500733333334,1239.8500976666667,1232.6501463333334,0.7142888180406963,-9769432.0,+1
2016-11-02,1251.099976,1255.699951,1241.5,1259.800049,1230.067749,1618608.0,1256.6500124000002,1255.7227518727273,22.10009799999989,49.43318031060074,-2.363527162314204,-22.703055729407424,-39.541006442494144,3070508.2011212213,289646.3937158939,0.0,88.0,-56.0,26.64990200000011,1252.3333333333333,1263.1666666666665,1266.5332843333335,1277.3666176666666,1248.9667156666665,1238.1333823333332,1234.7667646666664,1.288740292131985,-8150824.0,+1
2016-11-03,1245.0,1260.0,1231.75,1246.150024,1238.75415,1578953.0,1255.4800172000002,1253.8136630727274,-11.69995199999994,39.757703942099276,-2.783896271186438,-21.533608856948376,-53.380562046840126,-3202810.5649872064,130898.35013848013,0.0,84.0,-56.0,29.949951000000056,1245.9666746666667,1260.1833493333334,1274.2166746666667,1288.4333493333334,1231.9333493333334,1217.7166746666667,1203.6833493333334,0.5097353628318595,-9729777.0,-1
2016-11-04,1252.800049,1252.800049,1241.75,1254.949951,1227.649414,1433730.0,1255.1400147000002,1253.7172874,-3.400024999999914,47.413980802385815,-1.8593221077588165,-16.34324297153762,-35.13947332208393,1033907.1911882461,171944.20654983315,0.0,80.0,-56.0,32.84997599999997,1249.8333333333333,1257.9166666666665,1260.8833823333334,1268.9667156666665,1246.8666176666666,1238.7832843333333,1235.8165686666666,1.1945604042117932,-8296047.0,+1
2016-11-07,1252.0,1254.849976,1240.0,1243.699951,1233.325195,1417848.0,1253.9600098,1251.6372758181817,-11.800048999999944,39.92848885663381,-2.81445223716674,-15.034144715821412,-41.98511684106817,974743.6851510308,208435.09194079667,4.0,76.0,-88.0,22.599975000000086,1246.183309,1252.366618,1261.033285,1267.216594,1237.516642,1231.333333,1222.666666,0.24915535217027038,-9713895.0,-1
2016-11-08,1251.099976,1258.0,1240.099976,1249.449951,1238.112549,1337041.0,1251.8350098,1250.8172651272728,-21.25,45.04511257209067,-2.326274615469357,-13.519090505321401,-28.0363258167005,112154.0880388704,204058.68267252727,0.0,72.0,-88.0,16.799927000000025,1249.183309,1258.266642,1267.083333,1276.166666,1240.366618,1231.283285,1222.466594,0.5223442717171815,-8376854.0,+1
2016-11-09,1200.0,1257.400024,1195.349976,1254.300049,1235.101929,3411367.0,1250.9100098000001,1251.2654540727274,-9.25,49.2520316542357,-1.9144990838799343,-11.622574409126628,-76.40908900345804,742615.0452641622,228538.5173357834,12.0,68.0,-88.0,17.550048999999944,1235.6833496666666,1276.0167233333332,1297.7333976666664,1338.0667713333332,1213.9666753333331,1173.6333016666665,1151.916627333333,0.9500407316364996,-4965487.0,+1
2016-11-10,1263.75,1283.0,1254.099976,1251.25,1262.049683,2675184.0,1251.0050049000001,1251.3272704727274,0.9499510000000555,46.66018953057005,-2.6815878378378377,-13.032098628254062,36.78660255714626,975503.280655388,262491.46112303814,8.0,96.0,-84.0,28.25,1262.7833253333333,1271.4666746666667,1291.6833493333334,1300.3666986666667,1242.5666506666666,1233.8833013333333,1213.6666266666666,-0.09861500461037565,-7640671.0,-1
2016-11-11,1274.0,1282.0,1265.599976,1278.550049,1259.335205,1784830.0,1254.9300048999999,1256.3354603090909,39.25,65.44200160863745,-0.3758404560810858,-13.195846516003712,93.82389135320406,666215.9697007008,280842.5751492955,4.0,92.0,-80.0,11.050048999999944,1275.3833416666666,1285.1667073333333,1291.7833656666667,1301.5667313333333,1268.7666833333333,1258.9833176666666,1252.3666593333332,0.7896374419939843,-5855841.0,+1
2016-11-15,1277.5,1289.0,1250.650024,1275.800049,1238.556763,3128131.0,1257.3000121999999,1260.1300137818182,23.700072999999975,62.86900175598781,-1.1092395798319374,-10.65113573765575,75.53425875935983,179383.17238801796,276230.784114692,0.0,88.0,-72.0,14.949951000000056,1271.816691,1292.983358,1310.166667,1331.333334,1254.633382,1233.466715,1216.283406,0.6558028875950257,-8983972.0,-1
2016-11-16,1268.0,1268.0,1240.050049,1254.75,1228.2910160000001,2161936.0,1256.8700073,1259.6663752,-4.3000489999999445,46.66443226374671,-2.8781512605042017,-6.745716740972284,-0.986095874573318,483934.8005785708,285671.8757721411,0.0,84.0,-72.0,17.90002400000003,1254.266683,1268.4833170000002,1282.2166339999999,1296.4332680000002,1240.5333660000001,1226.316732,1212.583415,0.5259383460099815,-11145908.0,-1
2016-11-17,1238.300049,1248.900024,1225.150024,1244.349976,1214.323486,1203906.0,1255.325,1257.390005872727,-15.450072999999975,40.68614700315142,-3.7521028571428596,-4.888003758131617,-66.58244417920633,3355081.293446498,425190.48566643015,92.0,80.0,-56.0,62.05004800000006,1239.4666746666667,1253.7833253333333,1263.2166746666667,1277.5333253333333,1230.0333253333333,1215.7166746666667,1206.2833253333333,0.8084190315789448,-12349814.0,-1
2016-11-18,1236.0,1236.0,1209.199951,1230.199951,1195.766235,1719975.0,1253.7299927000001,1252.8218151454546,-15.950072999999975,33.873426783015645,-4.94118058823529,-4.580382818525095,-129.26244212275057,-856484.8532882911,366932.51571394276,88.0,76.0,-88.0,28.90002400000003,1225.1333006666666,1241.0666503333332,1251.9333496666663,1267.8666993333331,1214.2666013333333,1198.3332516666667,1187.4665523333333,0.783580656886114,-14069789.0,-1
2016-11-21,1219.5,1219.5,1188.349976,1211.400024,1183.2301029999999,1388130.0,1249.375,1245.1254572,-43.549927000000025,26.95433014938763,-6.521006386554619,-5.032353476561411,-207.09640091195055,79431.22003419804,353864.2750012271,84.0,72.0,-88.0,30.75,1206.4166666666667,1224.4833573333335,1237.566690666667,1255.6333813333335,1193.3333333333335,1175.2666426666667,1162.1833093333335,0.7399688680817722,-15457919.0,-1
2016-11-22,1206.800049,1206.800049,1189.349976,1198.699951,1182.588623,2504446.0,1244.875,1235.9118119272728,-45.0,23.252195656679163,-7.588239411764701,-3.795779090404494,-202.90459479275498,-32874.67086612863,336285.23200725636,80.0,96.0,-88.0,38.34997599999997,1198.2833253333333,1207.2166746666667,1215.7333983333333,1224.6667476666667,1189.7666016666667,1180.8332523333333,1172.3165286666667,0.5358129447366838,-17962365.0,-1
2016-11-23,1203.0,1203.0,1181.099976,1198.050049,1169.460083,883173.0,1239.7350098000002,1227.3981844727273,-51.39990200000011,23.065140657829588,-7.642853025210089,-5.24982171484362,-174.1629918302173,-1972922.9661630958,231321.222999513,76.0,92.0,-84.0,35.75,1194.0500083333334,1207.0000406666668,1215.9500323333336,1228.9000646666668,1185.1000166666668,1172.1499843333334,1163.1999926666667,0.77397508788118,-18845538.0,-1
2016-11-24,1184.0,1186.300049,1160.900024,1184.75,1150.4584960000002,3821499.0,1232.7800048999998,1217.4009099636362,-69.55004899999994,19.38314787158818,-8.760504201680671,-5.733991142681816,-192.28501418829765,-127704.41079236503,215001.87600897308,72.0,96.0,12.0,29.59997599999997,1177.316691,1193.733358,1202.716716,1219.1333829999999,1168.333333,1151.916666,1142.9333080000001,0.9389745088833594,-22667037.0,-1
2016-11-25,1169.0,1193.199951,1158.0,1165.5,1173.951538,1492490.0,1224.2050048999997,1205.1681818,-85.75,15.303349336426294,-10.378151260504202,-9.2241410039926,-170.5733532113882,637561.8746718372,234209.14867546692,68.0,96.0,12.0,35.150024999999914,1172.233317,1186.4666339999999,1207.4332679999998,1221.666585,1151.2666829999998,1137.033366,1116.0667319999998,0.21306847841918838,-24159527.0,-1
2016-11-28,1180.25,1198.900024,1178.099976,1189.300049,1169.1639400000001,1032545.0,1215.2800049000002,1198.821826181818,-89.25,34.86217189127585,-8.378147142857149,-11.91779818232203,-103.35433890123929,139397.05872782794,229899.5082233015,64.0,96.0,12.0,41.849975000000086,1188.766683,1199.4333900000001,1209.5667310000003,1220.2334380000002,1178.633342,1167.966635,1157.833294,0.5384638054681384,-23126982.0,+1
2016-11-29,1184.699951,1192.949951,1176.5,1184.449951,1163.5375980000001,983161.0,1206.1449951,1193.2163618363636,-91.35009799999989,33.06666359262445,-8.78571840336134,-14.630165867728465,-97.58888253805888,-18695.01890115313,218599.7569903717,60.0,92.0,-16.0,22.05004800000006,1184.6333006666666,1192.7666013333333,1201.083251666667,1209.2165523333333,1176.3166503333332,1168.1833496666666,1159.8666993333331,0.48328113560946345,-24110143.0,-1
2016-11-30,1185.0,1202.0,1181.099976,1178.75,1184.118408,1610710.0,1198.5449951,1188.2354536363637,-76.0,30.908058406453605,-9.264705882352942,-21.957762613304567,-77.56312594125036,578729.6259802846,234969.29648991325,56.00000000000001,88.0,-16.0,21.90002400000003,1187.2833253333333,1193.4666746666667,1208.1833493333334,1214.3666986666667,1172.5666506666666,1166.3833013333333,1151.6666266666666,-0.11243891394574314,-25720853.0,-1
2016-12-01,1202.300049,1207.900024,1193.0,1199.599976,1181.79895,1119246.0,1194.0699951,1188.4272683454544,-44.75,45.83265853243742,-7.512607058823533,-28.210258466087225,-44.544323097126764,-1704712.4193649355,146801.94576923823,52.0,84.0,-24.0,37.150024999999914,1200.1666666666667,1207.3333333333335,1215.0666906666665,1222.2333573333335,1192.4333093333335,1185.2666426666667,1177.5332853333334,0.4429506959183392,-24601607.0,+1
2016-12-02,1189.0,1201.949951,1176.699951,1197.25,1173.7539060000001,1015668.0,1190.7749999999999,1189.0054510545453,-32.949951000000056,44.58031293414859,-7.7100840336134455,-32.704503843589464,-53.59322208447086,667392.2479278287,170465.14132190146,48.0,80.0,-28.0,35.199951000000056,1191.966634,1207.2333170000002,1217.2166339999999,1232.4833170000002,1181.9833170000002,1166.716634,1156.7333170000002,0.813863326732671,-25617275.0,-1
2016-12-05,1187.599976,1198.949951,1176.5,1189.099976,1180.9104,1137984.0,1188.5449952,1188.7009012363635,-22.30004800000006,40.18621606552382,-8.394960000000003,-37.318748692211784,-54.12961811971884,1809504.286240548,244966.92063638545,44.0,76.0,-32.0,33.40002400000003,1188.183309,1199.866618,1210.63326,1222.316569,1177.416667,1165.733358,1154.966716,0.5612473719875798,-26755259.0,-1
2016-12-06,1195.0,1202.849976,1190.199951,1196.349976,1179.0349119999998,675741.0,1188.3099977,1190.1199886545455,-2.349975000000086,45.681628370261194,-6.129172284003424,-40.95719221929221,-33.4284173022239,-6.584887421391768,233831.7612943942,40.0,72.0,-32.0,16.449951000000056,1196.4666343333333,1202.7333176666666,1209.1166593333332,1215.3833426666665,1190.0832926666667,1183.8166093333334,1177.4332676666668,0.4861670233853258,-26079518.0,+1
2016-12-07,1201.849976,1205.900024,1167.0,1194.449951,1166.350708,1407048.0,1187.9499879,1191.2363438,-3.600097999999889,44.44679413580044,-4.735200614275313,-41.55242825375058,-39.86957311682735,819982.4242954915,260474.97324898958,36.0,68.0,-31.999999999999993,20.90002400000003,1189.1166583333334,1211.2333166666667,1228.0166823333334,1250.1333406666668,1172.3332926666667,1150.2166343333333,1133.4332686666667,0.7056538319873539,-27486566.0,-1
2016-12-08,1187.0,1205.550049,1187.0,1181.599976,1184.0198970000001,1077424.0,1187.6349855,1190.0817961818182,-3.1500240000000304,36.70438803973429,-4.784522779243626,-40.38988293028319,-31.571810321855253,-267866.5821595419,236459.44800314723,32.0,64.0,-32.0,29.15002400000003,1191.3833416666666,1195.7666833333333,1209.9333906666666,1214.3167323333332,1177.2166343333333,1172.8332926666667,1158.6665853333334,-0.29110564613603157,-28563990.0,-1
2016-12-09,1199.099976,1202.300049,1188.0,1199.5,1182.835327,1096988.0,1191.0349855000002,1192.2390715454544,34.0,50.549723099431716,-1.78491744756805,-38.67031274571036,-17.210197017051797,-202739.39316425708,216495.8643137197,28.000000000000004,60.0,-32.0,25.25,1196.6000163333333,1205.2000326666666,1210.9000653333333,1219.5000816666666,1190.8999836666667,1182.2999673333334,1176.5999346666667,0.8041930485692772,-27467002.0,+1
2016-12-12,1192.0,1192.150024,1181.099976,1198.300049,1169.1639400000001,856318.0,1191.9349855,1193.5599921818182,9.0,49.708676855101444,-0.8657205151255444,-35.91735184571644,-21.8043150463127,1281740.981186879,264916.0968988633,24.0,56.00000000000001,-32.0,22.449951000000056,1190.516683,1199.9333900000001,1201.5667310000003,1210.9834380000002,1188.883342,1179.466635,1177.833294,1.5565609307760364,-28323320.0,-1
2016-12-13,1180.25,1190.349976,1178.550049,1184.449951,1170.940796,631717.0,1191.9349855,1192.1990768181818,0.0,40.6919852754839,-2.1147148067876653,-30.050120404523113,-26.96671684946141,-252024.8062693658,241418.78311848926,20.0,52.0,-32.0,13.75,1184.449992,1190.3499350000002,1196.2499190000003,1202.1498620000002,1178.5500080000002,1172.650065,1166.7500810000001,0.49999478810335846,-28955037.0,-1
2016-12-14,1187.0,1188.0,1173.400024,1186.25,1160.526855,1078536.0,1192.6849855,1191.165443090909,7.5,42.26253647941541,-1.952387368692133,-27.85426466704257,-25.54096332863631,252596.41065120403,241926.85709724904,16.0,48.0,-32.0,38.90002400000003,1182.550008,1191.6999919999998,1197.1499840000001,1206.2999679999998,1177.1000159999999,1167.950032,1162.50004,0.8801367892659547,-27876501.0,+1
2016-12-15,1164.199951,1194.5,1163.599976,1175.699951,1161.415283,1235372.0,1190.294983,1188.0772550000002,-23.900024999999914,35.84353339279225,-2.903785039506859,-24.78486261243961,-32.740080406710184,764620.9384330201,265685.6789761478,12.0,44.0,-32.0,18.550048999999944,1177.933309,1192.266642,1208.833333,1223.166666,1161.366618,1147.033285,1130.466594,0.39158464731289766,-29111873.0,-1
2016-12-16,1176.599976,1185.0,1171.550049,1176.599976,1167.04187,813957.0,1188.2299806,1185.5872537272726,-20.65002400000003,36.788585034464816,-2.8226212753693707,-20.435515508908793,-31.57521057565952,-735516.0119698021,220176.51120587732,8.0,40.0,-31.999999999999996,20.700072999999975,1177.716675,1183.8833009999998,1191.1666259999997,1197.333252,1170.4333499999998,1164.2667239999998,1156.9833989999997,0.3754606243546913,-28297916.0,+1
2016-12-19,1176.800049,1179.5,1170.5,1182.300049,1161.563354,790109.0,1187.5499879000001,1184.5090843454545,-6.799927000000025,42.93163803226142,-2.3085917978120705,-18.88594071257762,-31.39777098559487,1065581.000398004,258603.98798733766,4.0,36.0,-32.00000000000001,18.40002400000003,1177.4333496666666,1184.3666993333331,1186.4333496666668,1193.3666993333331,1175.3666993333331,1168.4333496666666,1166.3666993333331,1.3111165555555493,-27507807.0,+1
2016-12-20,1176.0,1185.0,1171.699951,1176.75,1166.6469730000001,1047498.0,1185.5899903,1182.545450181818,-19.59997599999997,38.70565737817515,-2.809092192787258,-15.442665583866983,-30.54706328042355,-1017550.6147347749,200596.96059087798,0.0,32.0,-32.0,19.75,1177.8166503333334,1183.9333496666668,1191.1166993333331,1197.2333986666667,1170.6333006666669,1164.5166013333335,1157.333251666667,0.37970153343043817,-28555305.0,-1
2016-12-21,1184.0,1185.0,1175.0,1181.900024,1164.771362,664719.0,1184.3349976,1181.8745472181818,-12.549927000000025,44.54971111743109,-2.3446658343656055,-10.822063153234012,-20.388077584737797,-647293.1497063949,162056.50103191097,0.0,28.000000000000004,-32.0,14.59997599999997,1180.6333413333334,1186.2666826666668,1190.6333413333332,1196.2666826666668,1176.2666826666668,1170.6333413333334,1166.2666826666668,0.690002400000003,-27890586.0,+1
2016-12-22,1176.400024,1179.5,1168.400024,1180.0,1157.960449,701429.0,1184.175,1181.0863658363635,-1.5999759999999696,42.812078874282065,-2.339870217583447,-8.451906174535225,-42.37348542567922,-1215114.9105663481,99457.80050471734,0.0,24.0,-32.0,30.90002400000003,1175.9666746666667,1183.5333253333333,1187.0666506666666,1194.6333013333333,1172.4333493333334,1164.8666986666667,1161.3333733333334,1.0450451424399478,-28592015.0,-1
2016-12-23,1171.0,1189.25,1169.300049,1173.099976,1170.940796,1188129.0,1181.5349976,1179.072725109091,-26.40002400000003,36.79791083312474,-2.9632349163270106,-6.633228423685068,-41.69453360916138,-130774.07943444469,88992.71505293724,0.0,20.0,-32.0,13.449951000000056,1177.216675,1185.1333009999998,1197.1666259999997,1205.083252,1165.1833499999998,1157.2667239999998,1145.2333989999997,0.1904729991567405,-29780144.0,-1
2016-12-26,1178.550049,1186.099976,1170.099976,1186.25,1159.8359380000002,1045966.0,1180.3299927,1179.9299982727273,-12.050048999999944,51.713982988514005,-1.7752302442808539,-3.5495858010788197,-25.046154970744727,526501.6838477058,108879.48636179036,0.0,16.0,-32.0,9.0,1180.8166506666666,1191.5333253333333,1196.8166506666666,1207.5333253333333,1175.5333253333333,1164.8166506666666,1159.5333253333333,1.009376500000002,-28734178.0,+1
2016-12-27,1179.300049,1186.900024,1173.900024,1175.0,1169.904297,1224824.0,1179.3849976000001,1178.960908690909,-9.449951000000056,41.94266865065791,-2.791582196225522,-4.354543706641834,-38.51626304630065,385938.7267205232,121473.08819627823,28.000000000000004,12.0,-32.0,13.300048999999944,1178.600016,1183.3000080000002,1191.6000159999999,1196.3000080000002,1170.3000080000002,1165.600016,1157.3000080000002,0.08461353846153613,-29959002.0,-1
2016-12-28,1189.900024,1194.949951,1181.0,1185.199951,1171.434326,1626960.0,1179.2799927,1180.0181729454546,-1.0500489999999445,51.52472549834596,-1.839058072284256,-5.696782379117167,12.608590463337709,849653.6452742406,154572.20442709472,24.0,8.0,-28.000000000000004,10.0,1187.0499673333334,1193.0999346666667,1200.9999183333334,1207.0498856666668,1179.1499836666667,1173.1000163333333,1165.2000326666666,0.30107281380415163,-28332042.0,+1
2016-12-29,1185.0,1207.949951,1181.449951,1186.75,1189.646118,2025204.0,1180.3849976,1181.376356090909,11.050048999999944,52.88813775489421,-1.9117139579548126,-5.225261528977626,54.386562500124455,-980786.7897204355,102964.97742038876,20.0,4.0,-24.0,13.5,1192.0499673333334,1202.6499836666667,1218.5499673333334,1229.1499836666667,1176.1499836666667,1165.5499673333334,1149.6499836666667,0.20000184905660168,-26306838.0,+1
2016-12-30,1200.0,1212.0,1199.949951,1205.199951,1190.633301,1016635.0,1183.2449950999999,1185.8881657999998,28.599975000000086,66.01567505579992,-0.6109657681940651,-5.369778182310029,153.81538390410532,-1923003.2800740753,10875.511170640322,96.0,0.0,-20.0,19.949951000000056,1205.716634,1211.4833170000002,1217.7666830000003,1223.5333660000001,1199.4332680000002,1193.6665850000002,1187.3832190000003,0.4356828756463998,-25290203.0,+1
2017-01-02,1209.449951,1210.099976,1192.050049,1206.199951,1181.650757,927164.0,1185.6349853000002,1190.0617941454545,23.89990200000011,66.59775328830617,-0.5211185085354847,-5.178980908249741,117.82385604585104,-857586.75,-28600.046155297907,96.0,52.0,-16.0,16.0,1202.7833253333333,1213.5166016666667,1220.8332523333333,1231.5665286666667,1195.4666746666667,1184.7333983333333,1177.4167476666667,0.7839312591125766,-24363039.0,+1
2017-01-03,1200.800049,1201.949951,1185.75,1197.099976,1174.543701,961875.0,1187.6699829,1192.146337909091,20.34997599999997,56.44633811731136,-1.3387263252470827,-3.7369976446088913,61.27677325637119,-1399439.5841713345,-90910.93424693598,92.0,48.0,16.000000000000004,13.0,1194.933309,1204.116618,1211.13326,1220.316569,1187.916667,1178.733358,1171.716716,0.7006179216221043,-25324914.0,-1
2017-01-04,1189.849976,1192.0,1183.800049,1189.900024,1170.200439,1741780.0,1188.4699829,1192.551799927273,8.0,49.550983597849886,-1.9856222821203928,-3.46083166522817,17.853934842933466,-2573575.563107861,-203759.32646788724,88.0,44.0,16.0,19.949951000000056,1188.566691,1193.333333,1196.766642,1201.533284,1185.133382,1180.36674,1176.933431,0.743903835522925,-27066694.0,-1
2017-01-05,1189.0,1194.5,1183.099976,1185.5,1170.891357,1694096.0,1189.0199829,1192.0118030363637,5.5,45.62126458972712,-2.380952380952381,-2.822372701645236,14.186092071688087,-48069.30936951631,-196682.50750887036,84.0,40.0,16.0,26.5,1187.699992,1192.3000080000002,1199.1000159999999,1203.7000320000002,1180.8999840000001,1176.299968,1169.49996,0.21052797783583824,-28760790.0,-1
2017-01-06,1190.099976,1198.400024,1188.199951,1186.199951,1178.245361,1381315.0,1190.3299804000003,1191.4990699636364,13.099975000000086,46.40149415079751,-2.318063701707093,-1.4981651791292734,44.57657643066219,147432.34737186012,-181040.92319610988,80.0,36.0,96.0,25.25,1190.9333086666668,1193.6666663333335,1201.133381666667,1203.8667393333335,1183.4665933333335,1180.7332356666668,1173.2665203333336,-0.19607702807617208,-27379475.0,+1
2017-01-09,1198.849976,1204.150024,1192.150024,1193.650024,1179.775269,1143449.0,1191.0699828000004,1192.1027142545456,7.40002400000003,54.43123221727246,-1.6486950584007158,0.22780355434406374,93.31926803803674,-975398.4437866296,-217148.0832229517,76.0,32.0,44.0,18.049927000000025,1196.650024,1201.150024,1208.650024,1213.150024,1189.150024,1184.650024,1177.150024,0.125,-26236026.0,+1
2017-01-10,1196.199951,1216.800049,1195.300049,1195.199951,1198.678101,1386529.0,1193.0899779000001,1192.8536175636366,20.199951000000056,56.01310173232268,-1.9323758322719389,2.607252748441624,132.83474919039242,366431.4249732394,-190621.74194130665,72.0,28.000000000000004,44.0,20.449951000000056,1202.4333496666666,1209.5666503333332,1223.9333496666663,1231.0666503333332,1188.0666503333332,1180.9333496666666,1166.5666503333332,-0.0046557209302273955,-24849497.0,+1
2017-01-11,1217.5,1238.099976,1215.5,1214.349976,1218.074585,2335851.0,1196.0049804,1196.7190717636363,29.150024999999914,70.57517626873556,-2.0849794136068,4.284501846748981,262.00695314418823,-1510983.0204012825,-250638.16368948744,96.0,24.0,44.0,13.299927000000025,1222.649984,1229.7999679999998,1245.24996,1252.3999439999998,1207.1999919999998,1200.050008,1184.6000159999999,-0.050886071737422725,-22513646.0,+1
2017-01-12,1235.0,1243.699951,1225.5,1234.0,1219.061646,729079.0,1200.7299804000002,1203.6272571454545,47.25,78.86086713331335,-0.8473793496301159,8.123296467973887,275.66457837806433,470088.01964357926,-217877.88262889345,96.0,20.0,44.0,11.40002400000003,1234.3999836666667,1243.2999673333334,1252.5999346666667,1261.4999183333334,1225.1000163333333,1216.2000326666666,1206.9000653333333,0.4670342244328006,-21784567.0,+1
2017-01-13,1239.0,1239.699951,1228.599976,1235.0,1216.5939939999998,962603.0,1203.7099853,1209.8581698,29.800048999999944,79.20471361377176,-0.7600202124932262,10.112957593434203,208.45126642435616,-557659.9479556258,-233322.52196192674,96.0,16.0,44.0,12.90002400000003,1234.433309,1240.266642,1245.533284,1251.3666170000001,1229.166667,1223.333334,1218.0666919999999,0.5765800373424247,-20821964.0,+1
2017-01-16,1233.5,1249.449951,1232.800049,1232.5,1231.54834,941466.0,1206.3399901999999,1215.0927179272728,26.300048999999944,75.6549246615258,-1.473332324041279,13.21431884616436,177.44767131278155,-1105635.3962639691,-272973.10715747415,92.0,12.0,44.0,17.950072999999975,1238.25,1243.699951,1254.899902,1260.3498530000002,1227.050049,1221.600098,1210.4001469999998,-0.018021067030901592,-21763430.0,-1
2017-01-17,1247.0,1252.400024,1236.25,1247.650024,1222.516479,889903.0,1211.3949949999999,1222.6036331636362,50.55004800000006,81.46381399975242,-0.4118258974477011,14.30032073240045,167.29414256626288,-3626237.4183205324,-425394.2122103406,96.0,8.0,44.0,23.150024999999914,1245.4333493333334,1254.6166986666667,1261.5833733333334,1270.7667226666667,1238.4666746666667,1229.2833253333333,1222.3166506666666,0.7058827900193838,-20873527.0,+1
2017-01-18,1240.900024,1256.0,1240.849976,1238.5,1226.563599,1153222.0,1216.2549926,1227.5318158909092,48.59997599999997,69.84930422656905,-1.512532411408816,14.276985806518724,131.4568387224254,-4691072.817650361,-619288.6942757962,96.0,4.0,72.0,42.900024999999914,1245.1166586666666,1249.3833413333332,1260.2666826666668,1264.5333653333332,1234.2333173333332,1229.9666346666666,1219.0832933333331,-0.15511368166809272,-22026749.0,-1
2017-01-19,1244.900024,1244.900024,1235.0,1242.599976,1220.344849,878103.0,1221.9649901999999,1232.3218128727272,57.09997599999997,71.9192183382932,-1.1581697493517744,15.85433751773894,96.2116153797187,-970740.2855693421,-635263.766607321,96.0,0.0,76.0,29.349975000000086,1240.8333333333333,1246.6666666666665,1250.7333573333335,1256.5666906666665,1236.7666426666665,1230.9333093333332,1226.8666186666665,0.7676724824101382,-21148646.0,+1
2017-01-20,1236.0,1245.0,1230.0,1236.300049,1220.3942869999998,3485517.0,1226.975,1234.9281872,50.10009799999989,64.11520294396479,-1.702675108038034,17.866289250713635,73.89250124960749,1104694.6931948299,-556174.7457072231,92.0,16.0,80.0,11.099975000000086,1237.1000163333333,1244.2000326666666,1252.1000163333333,1259.2000326666666,1229.2000326666666,1222.1000163333333,1214.2000326666666,0.420003266666663,-24634163.0,-1
2017-01-23,1236.0,1250.0,1235.800049,1236.349976,1228.587158,1198462.0,1231.2449952,1236.632728290909,42.69995199999994,64.15077433092407,-1.6983598962834943,20.871575846190126,73.40826547902847,19425.363955599834,-530011.1043589129,88.0,12.0,80.0,16.64990200000011,1240.716675,1245.6333009999998,1254.9166259999997,1259.833252,1231.4333499999998,1226.5167239999998,1217.2333989999997,0.03872738715788688,-23435701.0,+1
2017-01-24,1250.0,1271.5,1249.25,1244.650024,1251.19165,2565466.0,1236.1900025,1239.0700062545454,49.450072999999975,69.87825322439596,-2.2899766311300613,24.751527846389763,96.64062698694342,-1590363.534645147,-578208.9420991964,84.0,8.0,88.0,19.90002400000003,1255.1333413333334,1261.0166826666668,1277.3833413333332,1283.2666826666668,1238.7666826666668,1232.8833413333334,1216.5166826666668,-0.2067404943820211,-20870235.0,+1
2017-01-25,1272.599976,1295.599976,1270.099976,1267.550049,1273.944092,3909246.0,1241.5100098,1244.771832890909,53.200072999999975,80.03347579431878,-2.344135681313103,28.28420156938182,130.06778330503144,1492909.0,-484067.2174583237,96.0,4.0,92.0,15.15002400000003,1277.7500003333332,1285.4000246666665,1303.250000333333,1310.9000246666665,1259.9000246666665,1252.2500003333332,1234.4000246666665,-0.09999713725490295,-16960989.0,+1
2017-01-27,1299.0,1300.0,1288.0,1290.599976,1275.227417,1713059.0,1247.1700074,1253.6972812909091,56.59997599999997,85.65162729831523,-0.7826830974188203,33.01266472790235,135.21786915149812,-1549716.0884639886,-532505.8025040358,96.0,0.0,96.0,9.90002400000003,1292.8666586666666,1297.7333173333332,1304.8666586666668,1309.7333173333332,1285.7333173333332,1280.8666586666666,1273.7333173333332,0.21666466666666415,-15247930.0,+1
2017-01-30,1292.949951,1292.949951,1280.550049,1291.900024,1268.366943,1329907.0,1252.8600098,1261.830011581818,56.90002400000003,85.90964567107964,-0.6744359700249767,35.53857581959255,103.92954046811865,-1178353.5801274644,-561862.5196687371,96.0,0.0,76.0,15.0,1288.4666746666667,1296.3833003333334,1300.8665766666668,1308.7832023333335,1283.9833983333333,1276.0667726666666,1271.5834963333332,0.9153277985584067,-13918023.0,+1
2017-01-31,1282.400024,1292.699951,1277.0,1284.949951,1270.045166,1525260.0,1258.1050049,1267.6645463454545,52.449951000000056,77.33169760712929,-1.2531264779350495,35.067338726744765,82.58330405096531,410902.70556460804,-517645.9185217668,92.0,0.0,76.0,14.199951000000056,1284.8833006666666,1292.7666013333333,1300.583251666667,1308.4665523333333,1277.0666503333332,1269.1833496666666,1261.3666993333331,0.5063678861163342,-15443283.0,-1
2017-02-01,1286.199951,1310.0,1280.5,1286.650024,1288.8491210000002,2727666.0,1262.0050049000001,1272.854549818182,39.0,77.9530195786824,-1.9281565648224581,35.4985665854515,81.9531188338993,-153274.11272458668,-501083.56371280405,88.0,0.0,76.0,35.15002400000003,1292.3833413333334,1304.2666826666668,1321.8833413333332,1333.7666826666668,1274.7666826666668,1262.8833413333334,1245.2666826666668,0.2084753898305095,-12715617.0,+1
2017-02-02,1305.699951,1305.699951,1292.599976,1305.699951,1281.939575,1492909.0,1268.725,1280.7990854727273,67.19995100000006,83.72173858707225,-0.35508249380676665,36.29346547806085,84.48109988192435,-46940.57338626087,-480440.700516143,96.0,0.0,92.0,50.94995199999994,1301.3332926666667,1310.0666093333334,1314.4332676666668,1323.1665843333335,1296.9666343333333,1288.2333176666666,1283.8666593333332,1.0,-11222708.0,+1
2017-02-03,1299.0,1316.0,1296.5,1298.699951,1294.130249,2001276.0,1274.3349975,1286.2490765636364,56.099975000000086,75.3612615272,-1.4215323746918607,35.70752467546663,77.69198176793596,-877848.1152714372,-498504.6739141109,92.0,0.0,96.0,32.449951000000056,1303.733317,1310.9666339999999,1323.2333170000002,1330.4666339999999,1291.4666339999999,1284.233317,1271.9666339999999,0.11281800000000285,-13223984.0,-1
2017-02-06,1312.300049,1320.0,1311.449951,1311.050049,1297.1407470000001,1077555.0,1281.8099975000002,1292.9245404727276,74.75,79.52383340646266,-0.7330017199017245,37.012295723330226,82.38892969601025,-309659.5017554755,-489920.80245235475,96.0,16.0,96.0,12.399902000000111,1314.1666666666667,1316.8833823333334,1322.716715666667,1325.4334313333334,1308.3333333333335,1305.6166176666668,1299.7832843333335,-0.046771895693242645,-12146429.0,+1
2017-02-07,1316.0,1318.0,1302.949951,1314.099976,1290.280518,852980.0,1289.5849975,1298.7954456545456,77.75,80.46429138396815,-0.4832124488124513,39.33398968899587,68.72253851272643,146757.60715300677,-460980.8747430201,96.0,12.0,92.0,15.699951000000056,1311.683309,1320.416667,1326.733358,1335.466716,1305.366618,1296.63326,1290.316569,0.740863036392769,-11293449.0,+1
2017-02-08,1307.550049,1318.699951,1298.150024,1307.150024,1288.799927,1235240.0,1295.8349975,1301.9890868363636,62.5,71.79425890225016,-1.0524140868140843,42.85009892397284,55.69126645188002,-856103.0374148878,-478940.97304628685,92.0,8.0,88.0,29.5,1307.9999996666668,1317.8499753333335,1328.549926666667,1338.3999023333336,1297.3000483333335,1287.4500726666668,1276.7501213333335,0.4379577601419211,-12528689.0,-1
2017-02-09,1309.400024,1319.900024,1292.550049,1305.650024,1280.903198,1116344.0,1299.644995,1303.773637109091,38.099975000000086,69.9181214822501,-1.1752642096642072,46.263320597771326,47.154298110287336,-875239.9859333223,-496954.56454115215,88.0,4.0,96.0,19.049927000000025,1306.0333656666667,1319.5166823333334,1333.3833406666668,1346.8666573333335,1292.1667073333333,1278.6833906666666,1264.8167323333332,0.478975757747495,-13645033.0,-1
2017-02-10,1298.349976,1308.75,1298.0,1297.650024,1286.776245,824184.0,1300.3499998,1303.410915109091,7.050048000000061,60.23202044311345,-1.8304648648648625,48.37046464817195,35.9777880464396,-170546419.58227065,-8226475.7017106805,84.0,0.0,92.0,19.5,1301.4666746666667,1304.9333493333334,1312.2166746666667,1315.6833493333334,1294.1833493333334,1290.7166746666667,1283.4333493333334,-0.032555906976741364,-14469217.0,-1
2017-02-13,1307.550049,1315.0,1299.199951,1303.599976,1293.291138,698948.0,1301.519995,1304.001819872727,11.69995199999994,64.45752254544757,-1.3431633087633112,47.5159401067267,37.31028632906335,-961885.6978888001,-7896267.065173322,80.0,0.0,80.0,21.300048999999944,1305.933309,1312.666667,1321.733358,1328.466716,1296.866618,1290.13326,1281.066569,0.27848173129082887,-13770269.0,+1
2017-02-14,1314.0,1314.0,1304.0,1310.199951,1294.179443,611515.0,1304.0449950000002,1305.579993690909,25.25,68.71245799568189,-0.8026248157248111,43.767365837024954,37.23992765777804,-64147.32631819275,-7540261.6224980885,76.0,0.0,84.0,15.050048999999944,1309.3999836666667,1314.7999673333334,1319.3999836666667,1324.7999673333334,1304.7999673333334,1299.3999836666667,1294.7999673333334,0.6199951000000056,-13158754.0,+1
2017-02-15,1312.0,1324.0,1307.449951,1311.099976,1305.13623,1531735.0,1306.4899902000002,1306.862717509091,24.44995199999994,69.29091664853753,-1.0530631836734718,40.26197150359303,39.85583483377331,964810.5025050233,-7153667.434997946,72.0,0.0,84.0,20.549927000000025,1314.183309,1320.916667,1330.733358,1337.466716,1304.366618,1297.63326,1287.816569,0.22054466424842165,-11627019.0,+1
2017-02-16,1323.0,1333.0,1320.25,1322.199951,1310.762817,1260925.0,1308.1399902,1309.7190740181818,16.5,75.68747394805187,-0.8752065640194444,38.08370900324735,52.20034568694165,-2539353.1057329564,-6943925.87457681,96.0,0.0,84.0,27.349975000000086,1325.1499836666667,1330.0499673333334,1337.8999836666667,1342.7999673333334,1317.2999673333334,1312.3999836666667,1304.5499673333334,0.1529373333333377,-10366094.0,+1
2017-02-17,1445.0,1454.0,1360.449951,1327.900024,1359.278564,100564990.0,1311.0599975000002,1313.3118074363638,29.200072999999975,78.35847262824265,-9.306271291512914,37.110293111565625,132.35285383950784,690363.4668467819,-6596912.722693918,96.0,0.0,84.0,10.75,1380.783325,1401.1166990000002,1474.3333740000003,1494.666748,1307.5666500000002,1287.2332760000002,1214.0166010000003,-0.3479413142798038,90198896.0,+1
2017-02-20,1361.199951,1415.449951,1359.150024,1377.050049,1390.914795,2641679.0,1317.6599975000001,1325.309998618182,66.0,89.66022652287728,-5.678963173431739,36.077250215788126,120.358097313295,401819.3841620388,-6278788.536018647,96.0,0.0,80.0,17.34997599999997,1383.8833413333334,1408.6166586666668,1440.1832683333337,1464.9165856666668,1352.3167316666668,1327.5834143333334,1296.0168046666668,0.3179404655355931,92840575.0,+1
2017-02-21,1406.050049,1421.800049,1397.400024,1409.099976,1397.281616,1565007.0,1327.1599975000001,1341.9354492545453,95.0,92.57693203764912,-3.31365490774908,37.09571436617534,139.80256134885474,-232697.03524524084,-6003966.195074401,92.0,16.0,76.0,10.40002400000003,1409.4333496666666,1421.4666753333331,1433.8333746666663,1445.866700333333,1397.0666503333332,1385.0333246666667,1372.6666253333333,0.479505738211333,94405582.0,+1
2017-02-22,1415.0,1418.800049,1394.849976,1415.550049,1381.09314,1324194.0,1338.0000000000002,1358.0063677090907,108.40002499999991,93.03327930060009,-2.8376347601476057,36.75164747004101,120.79387142831918,643698.5860180288,-5701799.614115654,88.0,12.0,72.0,16.550048999999944,1409.7333580000002,1424.6167400000004,1433.683431,1448.5668130000004,1400.6666670000004,1385.7832850000002,1376.7165940000004,0.8643010399174982,95729776.0,+1
2017-02-23,1403.800049,1421.349976,1387.050049,1399.150024,1376.305908,8623745.0,1347.3500000000001,1369.124553890909,93.5,78.81772785998808,-4.047968708487082,36.80079240946816,97.78161915217042,269383.8894265782,-5430382.182136461,84.0,8.0,96.0,21.90002400000003,1402.5166829999998,1417.9833169999997,1436.8166099999999,1452.2832439999997,1383.6833899999997,1368.2167559999998,1349.3834629999997,0.35276970122997864,87106031.0,-1
2017-02-27,1390.900024,1398.349976,1378.599976,1394.300049,1375.6147460000002,1170344.0,1357.0150025000003,1377.6609264363638,96.65002499999991,74.91184878352027,-4.405900442804432,37.419713030993535,73.38427674882796,-492738.41360453074,-5205943.829021374,80.0,4.0,96.0,131.80004899999994,1390.4166670000002,1402.2333580000004,1410.166667,1421.9833580000004,1382.4833580000004,1370.6666670000002,1362.7333580000004,0.7949404050632899,85935687.0,-1
2017-02-28,1392.900024,1396.25,1384.5,1393.599976,1372.1599119999998,732002.0,1366.0150025,1384.3127398000001,90.0,74.29861323042955,-4.457566346863471,38.8617651343925,68.05944329642509,-151507.63215885626,-4976196.729163987,76.0,0.0,96.0,87.54992700000003,1391.4499919999998,1398.3999839999997,1403.1999919999998,1410.1499839999997,1386.6499839999997,1379.6999919999998,1374.8999839999997,0.774466042553189,85203685.0,-1
2017-03-01,1396.449951,1396.5,1386.400024,1390.099976,1373.689941,870434.0,1374.005005,1388.6918258909088,79.90002499999991,70.94825569438296,-4.715868929889301,41.405692159154796,60.363712483888115,-408958.1454780224,-4768594.975360079,72.0,0.0,76.0,44.75,1391.0,1395.599976,1401.099976,1405.699952,1385.5,1380.900024,1375.400024,0.36633275168178125,84333251.0,-1
2017-03-02,1394.550049,1396.0,1376.25,1391.650024,1362.2890630000002,1150497.0,1382.0600098,1391.9000111636365,80.55004800000006,71.60261135318473,-4.601474243542433,43.71832970712694,50.02240296023679,208394.93359608031,-4542368.161316617,68.0,0.0,76.0,23.950072999999975,1387.966674666667,1399.6833493333338,1407.7166746666671,1419.4333493333338,1379.9333493333338,1368.216674666667,1360.1833493333338,0.779748050632913,85483748.0,+1
2017-03-03,1384.5,1384.5,1369.0,1380.099976,1359.2290039999998,623206.0,1387.8500123,1391.5436413818181,57.900024999999914,59.98603044189527,-5.453876309963102,45.88234239106146,32.536189274243576,-1257993.4641963004,-4393078.402356602,64.0,0.0,76.0,34.299927000000025,1377.8666586666666,1386.7333173333332,1393.3666586666668,1402.2333173333332,1371.2333173333332,1362.3666586666666,1355.7333173333332,0.7161274838709658,84860542.0,-1
2017-03-06,1376.800049,1389.900024,1373.099976,1377.0,1362.930664,919781.0,1392.7600099000001,1389.5709118727273,49.09997599999997,57.11635743701526,-5.682656826568266,49.812115254567516,30.437545305828536,-3127775.698313155,-4335564.6430819,60.0,8.0,76.0,20.55004800000006,1380.0,1386.900024,1396.800048,1403.700072,1370.099976,1363.199952,1353.299928,0.23214362244679398,83940761.0,-1
2017-03-07,1382.25,1387.5,1376.199951,1380.75,1368.310303,778219.0,1393.1300050000002,1387.3872737090908,3.6999510000000555,59.80060547046826,-5.405904059040591,54.331206472890926,28.19310557087729,-1034083.3239087445,-4185497.310392211,56.00000000000001,4.0,76.0,11.75,1381.4833170000002,1386.7666830000003,1392.7833660000001,1398.0667320000002,1375.4666340000003,1370.1832680000002,1364.1665850000004,0.4026574575030574,84718980.0,+1
2017-03-08,1387.900024,1399.199951,1381.050049,1386.199951,1374.23291,945536.0,1390.8400025000003,1386.127263890909,-22.900024999999914,63.6192709128914,-5.003693653136527,58.87641328743348,32.58005283121615,-446594.5975909551,-4015547.1870830627,52.0,0.0,72.0,10.09997599999997,1388.8166503333334,1396.583251666667,1406.9665523333338,1414.733153666667,1378.4333496666668,1370.6667483333333,1360.2834476666667,0.28374268907898675,85664516.0,+1
2017-03-09,1381.650024,1398.699951,1381.650024,1392.199951,1376.2070310000001,877329.0,1388.5049927000002,1386.3745272545455,-23.35009799999989,67.5366209613794,-4.560889225092247,56.726838905924524,30.033739566179054,-326897.12609235424,-3847881.2752198484,48.0,0.0,68.0,19.75,1390.8499753333333,1400.0499266666666,1407.899902333333,1417.0998536666666,1382.9999996666666,1373.8000483333333,1365.9500726666665,0.6187666961858552,86541845.0,+1
2017-03-10,1395.0,1408.0,1393.150024,1394.199951,1382.030884,1465176.0,1388.0099854000002,1387.4099742181818,-4.950072999999975,68.82759624527506,-4.413287749077487,50.177910380484946,34.1529570213218,-2064867.632277665,-3766835.200540658,44.0,20.0,64.0,22.65002400000003,1398.4499916666666,1403.7499593333332,1413.2999676666664,1418.5999353333332,1388.8999833333332,1383.6000156666666,1374.0500073333333,0.07070226914845029,88007021.0,+1
2017-03-14,1422.099976,1424.150024,1406.650024,1400.099976,1392.4941410000001,1788755.0,1388.5899781,1389.608154327273,5.799927000000025,72.5440779649685,-1.814892469865741,43.68184740183597,45.52997429571464,-858858.426123644,-3634654.4380671573,40.0,16.0,52.0,16.80004800000006,1410.3000080000002,1413.9499920000003,1427.8000080000002,1431.4499920000003,1396.4499920000003,1392.8000080000002,1378.9499920000003,-0.37428845714286063,89795776.0,+1
2017-03-15,1410.949951,1420.0,1410.550049,1410.699951,1398.317993,1067965.0,1390.2999756,1393.6281494,17.099975000000086,77.985068220474,-1.0149849267180011,38.947191381015045,45.90797606174537,2403072.161387858,-3360212.319910111,36.0,12.0,52.00000000000001,11.300048999999944,1413.75,1416.949951,1423.199951,1426.399902,1407.5,1404.300049,1398.050049,0.015862727753838103,90863741.0,+1
2017-03-16,1418.099976,1422.849976,1413.650024,1416.599976,1399.0582279999999,1245027.0,1392.9499756,1398.4099676545452,26.5,80.47064271408715,-0.5697504330272012,35.63129981422094,48.615624653218866,396648.69871081144,-3189445.909972796,32.0,8.0,52.0,18.449951000000056,1417.6999919999998,1421.7499599999996,1426.8999439999998,1430.9499119999996,1412.5500079999997,1408.50004,1403.3500559999998,0.3206486294711058,92108768.0,+1
2017-03-17,1418.550049,1427.5,1412.849976,1417.349976,1407.448608,847616.0,1395.5199708,1402.8463313636364,25.69995199999994,80.78878369789649,-0.7640213774934159,32.52909670556369,47.39984506382159,409355.36624417093,-3025864.033781116,28.000000000000004,4.0,48.0,17.049927000000025,1419.2333173333334,1425.6166586666668,1433.8833413333336,1440.2666826666668,1410.9666346666668,1404.5832933333334,1396.3166106666667,0.30716673228658126,92956384.0,+1
2017-03-20,1426.650024,1439.849976,1425.949951,1425.849976,1417.566284,2035586.0,1400.0949708000003,1408.3608777636362,45.75,84.16259802294918,-1.0441138270938075,29.630437973267817,64.04908863415824,1517456.9323986263,-2819349.4444093094,24.0,0.0,24.0,15.800048999999944,1430.5499676666666,1435.1499843333331,1444.4499926666663,1449.050009333333,1421.2499593333332,1416.6499426666667,1407.3499343333333,-0.007192433107140921,94991970.0,+1
2017-03-21,1434.0,1445.0,1434.0,1436.099976,1422.353638,1389320.0,1406.0049684,1414.9072423454545,59.09997599999997,87.27258958854921,-0.6612202080237763,26.66317331537539,77.86949147034032,-3144643.382097798,-2834135.532486059,20.0,0.0,24.0,29.950072999999975,1438.3666586666666,1442.7333173333332,1449.3666586666668,1453.7333173333332,1431.7333173333332,1427.3666586666666,1420.7333173333332,0.19090690909090632,96381290.0,+1
2017-03-22,1427.699951,1437.0,1425.800049,1440.949951,1412.4334720000002,1409136.0,1412.0249635000002,1421.2608755454546,60.199951000000056,88.50498059766674,-0.3008951708766675,24.97652492141151,67.26046072458803,-2086012.98276923,-2800129.9620443843,16.0,0.0,24.0,19.90002400000003,1434.5833333333333,1443.3666176666666,1445.783284333333,1454.5665686666666,1432.1666666666665,1423.3833823333332,1420.9667156666665,1.3526757393849345,97790426.0,+1
2017-03-23,1434.400024,1435.0,1422.900024,1430.900024,1412.4334720000002,1230618.0,1416.4949708000001,1424.692704727273,44.700072999999975,71.86672969267266,-1.0475465081723603,24.022167358253682,56.62241373543798,-7470641.0450988365,-3012425.920365041,12.0,0.0,24.0,12.150024999999914,1429.600016,1436.3000080000002,1441.6999920000003,1448.3999840000001,1424.2000320000002,1417.5000400000001,1412.1000560000002,0.6611583361818255,96559808.0,-1
2017-03-24,1433.0,1434.449951,1422.0,1430.900024,1405.967896,952591.0,1420.3649781000001,1427.3118053090911,38.700072999999975,71.86672969267266,-1.0475465081723603,23.169705422211564,55.39186816271804,5786682.960390208,-2612466.425785257,8.0,0.0,24.000000000000004,14.65002400000003,1429.1166583333334,1436.2333166666667,1441.5666093333334,1448.6832676666668,1423.7833656666667,1416.6667073333333,1411.3334146666666,0.714864178983515,96559808.0,-1
2017-03-27,1424.0,1424.0,1404.050049,1424.349976,1391.655029,1466021.0,1423.3799806000002,1428.0363503818182,30.150024999999914,61.78768700063403,-1.5341771173848462,21.646404208132708,26.85852272551804,387365.26318888983,-2476110.4399227956,4.0,0.0,24.0,22.5,1417.466675,1430.8833009999998,1437.4166259999997,1450.833252,1410.9333499999998,1397.5167239999998,1390.9833989999997,1.0175426997289352,95093787.0,-1
2017-03-28,1418.300049,1424.699951,1413.099976,1409.849976,1401.87146,2015350.0,1424.3549806000003,1425.5763495454544,9.75,45.49130423539496,-2.6114430906389328,19.749455463775348,20.898361087254365,-579725.1979669883,-2389911.110742986,0.0,4.0,20.0,19.15002400000003,1415.8833009999998,1418.6666259999997,1427.483276,1430.2666009999998,1407.0666509999996,1404.2833259999998,1395.4666759999996,-0.28017301761426,93078437.0,-1
2017-03-29,1420.800049,1434.800049,1420.0,1420.199951,1410.163086,2143943.0,1425.3049806000001,1424.8208896181818,9.5,55.218858164888715,-1.8424999257057908,18.274293890201307,40.34955945400855,-285758.2684815124,-2294267.799731101,76.0,0.0,16.0,11.199951000000056,1425.0,1430.0,1439.800049,1444.800049,1415.199951,1410.199951,1400.399902,0.01351015797312943,95222380.0,+1
2017-03-30,1428.0,1479.949951,1425.050049,1428.599976,1447.277832,8580273.0,1426.5049806,1425.419979690909,12.0,61.63105567738327,-3.7184530085840946,19.39808711562341,84.97526187729271,240922.4456110569,-2179031.8794882754,72.0,28.000000000000004,12.0,18.049927000000025,1444.533325333333,1464.0166016666662,1499.4332273333334,1518.9165036666664,1409.1166996666661,1389.633423333333,1354.216797666666,0.06466180941452351,103802653.0,+1
2017-03-31,1453.800049,1454.0,1436.550049,1466.199951,1423.933105,2412848.0,1431.3899781000002,1432.6372470363635,48.849975000000086,77.94315816674029,-0.9956914072116143,22.22181882739892,94.361740681872,168048.73366198412,-2072346.397072354,96.0,24.0,8.0,12.449951000000056,1452.25,1467.949951,1469.699951,1485.399902,1450.5,1434.800049,1433.050049,1.6991395563231104,106215501.0,+1
2017-04-03,1446.0,1450.099976,1426.0,1442.550049,1414.703735,1037263.0,1433.0599854000002,1434.6663508363636,16.700072999999975,59.56471060931236,-2.708273531051388,24.32337809164983,53.1596550508266,-494000.4707956738,-2000603.4004234143,92.0,20.0,4.0,26.849975000000086,1439.5500083333334,1453.1000166666668,1463.6499843333331,1477.1999926666667,1429.0000406666668,1415.4500323333334,1404.9000646666668,0.6867247087714927,105178238.0,-1
2017-04-05,1435.25,1446.5,1427.550049,1433.199951,1413.864624,1436020.0,1432.7699829,1434.6917991272726,-2.900024999999914,53.77994336832803,-3.3853507845194892,25.250655917873246,38.2235597717996,-397832.98764286656,-1927750.1998424802,88.0,16.0,-4.0,11.599975000000086,1435.75,1443.949951,1454.699951,1462.899902,1425.0,1416.800049,1406.050049,0.29814863373525846,103742218.0,-1
2017-04-06,1431.5,1443.0,1425.050049,1432.349976,1419.935425,1531104.0,1431.9099854,1434.6154342363639,-8.599975000000086,53.237626103084,-3.446900806617291,24.775190819440922,27.08917729447383,146948.0035958853,-1833445.736049827,84.0,12.0,76.0,24.950072999999975,1433.466675,1441.8833009999998,1451.4166259999997,1459.833252,1423.9333499999998,1415.5167239999998,1405.9833989999997,0.4066822800797619,102211114.0,-1
2017-04-07,1431.050049,1445.0,1428.599976,1438.5,1420.2807619999999,1162090.0,1432.669983,1435.8136187090909,7.59997599999997,56.868770301869866,-3.0015534574576375,22.973304222096203,32.88752331801357,981060.8718297902,-1705513.617509844,80.0,8.0,44.0,59.75,1437.3666586666666,1446.1333413333332,1453.7666826666668,1462.5333653333332,1429.7333173333332,1420.9666346666666,1413.3332933333331,0.6036591165964155,103373204.0,+1
2017-04-10,1443.0,1443.0,1432.650024,1438.849976,1415.641602,848469.0,1433.4649782,1436.9372538000002,7.949951999999939,57.08756633819546,-2.976210323208164,20.178932320882723,29.829450417449586,-1038140.1087017707,-1675178.458018568,76.0,4.0,72.0,25.40002400000003,1438.1666666666667,1443.6833093333335,1448.516642666667,1454.0332853333334,1433.3333333333335,1427.8166906666668,1422.9833573333335,0.5990305678003464,104221673.0,+1
2017-04-11,1434.0,1441.199951,1431.5,1434.150024,1420.922485,1089065.0,1434.444983,1437.0618075818184,9.80004800000006,52.927217573356266,-3.3165522738050353,18.63717461485112,18.12190634564783,-8670.61949184642,-1599428.1017218987,72.0,0.0,72.0,40.199951000000056,1435.6166583333334,1439.7333166666667,1445.3166093333334,1449.4332676666668,1430.0333656666667,1425.9167073333333,1420.3334146666666,0.2731997305965788,103132608.0,-1
2017-04-12,1439.0,1449.949951,1435.5,1439.5,1425.068237,891273.0,1437.4099854,1437.9809015818182,29.65002400000003,57.03933513267915,-2.9291395369331568,16.452820567597655,36.25559848830548,-2316944.7281997628,-1632042.493834529,68.0,0.0,72.0,18.949951000000056,1441.649983666667,1447.7999673333338,1456.0999346666667,1462.2499183333339,1433.3500163333338,1427.2000326666669,1418.9000653333337,0.2768175476858008,104023881.0,+1
2017-04-13,1443.0,1448.900024,1437.050049,1443.699951,1421.712158,1201059.0,1439.7599854000002,1439.1245316909092,23.5,60.18950199803277,-2.625004619012438,15.057062772224072,39.81057668742603,-2643465.1607067883,-1678016.251419632,64.0,0.0,72.0,17.949951000000056,1443.216674666667,1449.3833003333339,1455.0666496666668,1461.233275333334,1437.5333253333338,1431.3666996666668,1425.6833503333337,0.5611743484690949,105224940.0,+1
2017-04-17,1440.300049,1443.800049,1428.25,1440.300049,1418.257324,1784264.0,1440.9299927000002,1439.2227250727274,11.700072999999975,56.3313211221636,-2.8712048522314704,15.921981055252445,14.523606541691368,-5147967.354367246,-1835741.3015536147,60.0,0.0,72.0,16.40002400000003,1437.4500326666666,1446.6500653333333,1453.0000816666666,1462.2001143333332,1431.1000163333333,1421.8999836666667,1415.5499673333334,0.7749203234021955,103440676.0,-1
2017-04-18,1440.0,1455.0,1438.0,1436.800049,1428.621826,909715.0,1437.9900025000002,1438.4718262181818,-29.39990200000011,52.34573081834779,-3.1246535740671537,15.796044627737501,36.96905677350435,-1281742.0110630111,-1810559.5156222235,56.00000000000001,0.0,72.0,10.34997599999997,1443.2666829999998,1448.5333659999997,1460.2666829999998,1465.5333659999997,1431.5333659999997,1426.2666829999998,1414.5333659999997,-0.07058535294117974,102530961.0,-1
2017-04-19,1447.0,1456.75,1438.0,1447.300049,1430.299927,1084536.0,1438.4650025000003,1440.1645619454546,4.75,61.72080433508512,-2.364307408560103,15.244155094397911,52.59823035392124,1213638.4267212045,-1673095.972788431,52.0,0.0,72.0,9.699951000000056,1447.350016333333,1456.7000326666662,1466.1000163333329,1475.4500326666662,1437.9500326666662,1428.600016333333,1419.2000326666662,0.4960026133333304,103615497.0,+1
2017-04-20,1453.0,1466.050049,1452.949951,1449.0,1443.280151,1445343.0,1440.0450074000003,1442.0800160363635,15.800048999999944,63.07773065206993,-2.241207291950587,9.559261697788088,87.37069655631825,-2723349.9955491745,-1720834.7920048286,48.0,36.0,68.0,15.799927000000025,1456.0,1459.050049,1469.100098,1472.1501469999998,1445.949951,1442.899902,1432.8498530000002,-0.3015207214480448,105060840.0,+1
2017-04-21,1466.0,1499.0,1453.300049,1462.150024,1477.2855220000001,4314508.0,1443.0250122,1446.0991099636362,29.80004800000006,71.95201247067206,-2.6321411428571406,7.573204234620562,147.45171204816762,2396885.3551213476,-1533665.6944081844,44.0,32.0,64.0,11.849975000000086,1471.4833576666667,1489.6666663333335,1517.183308666667,1535.3666173333336,1443.9667153333335,1425.7834066666667,1398.2667643333334,0.19365392755016467,109375348.0,+1
2017-04-24,1498.099976,1539.0,1497.0,1496.599976,1513.265259,5051738.0,1448.8350098,1455.8400124727273,58.09997599999997,83.75472579822195,-2.9444461111111133,8.436886057139418,306.6278866559829,572781.1438688594,-1437918.110850137,96.0,28.000000000000004,60.0,15.550048999999944,1510.8666586666666,1524.7333173333332,1552.8666586666668,1566.7333173333332,1482.7333173333332,1468.8666586666666,1440.7333173333332,-0.009524380952381676,114427086.0,+1
2017-04-25,1535.050049,1545.5,1529.599976,1533.050049,1517.213623,2264445.0,1458.2550171000003,1471.151837781818,94.20007299999997,89.26807474566016,-0.8606948496370589,10.969490557110703,344.96676897960896,-521791.3372343563,-1396275.9847766922,96.0,24.0,56.00000000000001,17.0,1536.0500083333334,1542.5000406666668,1551.9500323333336,1558.4000646666668,1526.6000166666668,1520.1499843333334,1510.6999926666667,0.21698539574531261,116691531.0,+1
2017-04-26,1542.949951,1553.0,1468.449951,1537.050049,1530.638062,1948963.0,1468.5450196,1485.478207218182,102.90002499999991,89.7102581209644,-1.0969704951856984,13.193610229973729,203.3826653899161,1459691.7411321278,-1266459.269962655,96.0,20.0,52.0,19.949951000000056,1519.5,1570.550049,1604.050049,1655.100098,1486.0,1434.949951,1401.449951,0.8113549171331638,118640494.0,+1
2017-04-27,1546.099976,1573.949951,1546.099976,1550.650024,1548.356445,4045105.0,1479.660022,1500.4063898363638,111.15002400000003,91.14206171098799,-1.5797096697554334,16.657894497977168,253.796577977182,16614.89471218718,-1208137.7170228893,96.0,16.0,12.0,18.75,1556.899983666667,1567.6999913333339,1584.7499586666668,1595.549966333334,1539.8500163333338,1529.0500086666668,1512.0000413333337,0.16337709459344385,122685599.0,+1
2017-04-28,1559.900024,1559.900024,1537.099976,1568.599976,1526.541626,1359432.0,1492.1500245000002,1516.5772905636363,124.90002499999991,92.69092908104463,-0.3627224772184887,22.421997784829955,186.80183167957964,-339557.0567516686,-1168656.777919652,96.0,12.0,12.0,50.0,1555.1999919999998,1573.3000079999997,1578.00004,1596.1000559999998,1550.4999599999996,1532.3999439999998,1527.6999119999996,1.381576038787283,124045031.0,+1
2017-05-02,1547.0,1550.900024,1530.349976,1546.5,1520.717651,1001760.0,1502.7700196,1526.4591042909094,106.19995100000006,74.24756251001696,-1.861076776292598,27.883465914848784,127.62016800247119,-558711.5980829989,-1140931.997017986,92.0,8.0,68.0,76.84997599999997,1542.5833333333333,1554.8166906666665,1563.1333813333335,1575.3667386666666,1534.2666426666665,1522.0332853333332,1513.7165946666664,0.7858874100926666,123043271.0,-1
2017-05-03,1554.25,1554.25,1539.349976,1540.599976,1524.369995,626991.0,1513.1500123000003,1533.3372781818182,103.79992700000003,69.95951455983953,-2.2610919765371813,32.62013076910216,110.24252552002044,-670381.0635744316,-1119543.3182250971,88.0,4.0,72.0,48.90002400000003,1544.7333173333334,1550.1166586666668,1559.6333413333336,1565.0166826666668,1535.2166346666668,1529.8332933333334,1520.3166106666667,0.08389248232083367,122416280.0,-1
2017-05-04,1539.25,1542.900024,1522.599976,1544.300049,1514.992676,1282757.0,1522.8500123000001,1539.0009212181817,97.0,71.16457335022176,-2.010231057663875,38.567660966652284,80.59452921823373,132596.23977515224,-1062627.8837705404,84.0,0.0,76.0,84.55004899999994,1536.600016333333,1550.6000566666662,1556.9000643333334,1570.9001046666663,1530.3000086666661,1516.299968333333,1509.999960666666,1.0689665856947683,123699037.0,+1
2017-05-05,1542.099976,1542.900024,1526.300049,1534.800049,1512.426025,689474.0,1531.4300172000003,1541.1736551636363,85.80004899999994,63.605677039114795,-2.6543207092184313,45.11297803526122,65.9442251306467,-22268.429016025173,-1015338.817645335,80.0,0.0,80.0,36.89990200000011,1534.666707333333,1543.0333656666662,1551.2666823333334,1559.6333406666663,1526.4333906666661,1518.066732333333,1509.833415666666,0.5120489639291599,123009563.0,-1
2017-05-08,1538.0,1540.0,1528.550049,1532.199951,1514.992676,936813.0,1538.4350099,1541.3136431272728,70.04992700000003,61.541363454632304,-2.8306045213055504,50.00172537207959,54.63100281328462,180580.44243188447,-960978.8512781885,76.0,0.0,84.0,22.80004800000006,1533.5833333333333,1538.6166176666666,1545.033284333333,1550.0665686666666,1527.1666666666665,1522.1333823333332,1515.7167156666665,0.31877009779343973,122072750.0,-1
2017-05-09,1534.800049,1545.599976,1532.650024,1534.800049,1515.930298,836459.0,1542.2550172,1540.6527411454545,38.200072999999975,62.92957380028051,-2.6543207092184313,56.09531654485636,50.728982968293984,-225211.36112639602,-927534.8744531071,72.0,0.0,84.0,38.25,1537.6833496666666,1542.7166753333331,1550.6333016666663,1555.666627333333,1529.7667233333332,1524.7333976666666,1516.8167713333332,0.1660257119099688,122909209.0,+1
2017-05-10,1540.0,1555.0,1537.050049,1535.75,1531.773193,585561.0,1542.5250123,1539.4700107454546,2.6999510000000555,63.48520881806334,-2.589915066209596,61.68018529545816,48.246984182007374,149892.11780008592,-878560.92025978,68.0,12.0,84.0,14.90002400000003,1542.600016333333,1548.1499836666662,1560.549967333333,1566.0999346666663,1530.2000326666662,1524.650065333333,1512.2500816666661,-0.07242632584344885,123494770.0,+1
2017-05-11,1551.0,1560.0,1541.0,1551.800049,1526.4428710000002,968936.0,1544.0000123000002,1541.1563810545454,14.75,71.74222384475303,-1.5017392274892256,65.87077930087526,49.400067889413926,272470.40236943326,-826241.3146857248,64.0,8.0,84.0,20.30004800000006,1550.9333496666666,1560.8666993333331,1569.9333496666668,1579.8666993333331,1541.8666993333331,1531.9333496666666,1522.8666993333331,0.5684236315789445,124463706.0,+1
2017-05-12,1545.900024,1556.900024,1536.199951,1546.400024,1531.6251220000001,1536901.0,1543.5750123,1541.5927468181817,-4.25,65.95256150656941,-1.8678550401877345,63.72714655424534,37.37711285783467,-27501.339327217862,-789934.9521694289,60.0,4.0,80.0,18.0,1546.4999996666666,1556.800048333333,1567.2000726666665,1577.500121333333,1536.099975333333,1525.7999266666666,1515.399902333333,0.4927554120219763,122926805.0,-1
2017-05-15,1550.0,1557.199951,1542.25,1551.650024,1533.352539,701195.0,1541.8800171000003,1543.0609307636364,-16.94995199999994,68.7789827584715,-1.51191075906548,60.554131231476276,35.68774908428175,-871552.0545821681,-793644.8204609171,56.00000000000001,0.0,76.0,11.449951000000056,1550.3666583333334,1558.4833166666667,1565.3166093333334,1573.4332676666668,1543.5333656666667,1535.4167073333333,1528.5834146666666,0.6287662079962667,123628000.0,+1
2017-05-16,1555.0,1562.0,1548.25,1553.400024,1539.521851,897594.0,1542.5700195000002,1545.1554774727274,6.90002400000003,69.74498141405661,-1.3932626653580618,55.370862705966374,35.32693643773053,143213.1320997077,-751060.3680717977,52.0,20.0,72.0,13.400024999999914,1554.5500080000002,1560.8500160000003,1568.3000080000002,1574.6000160000003,1547.1000160000003,1540.8000080000002,1533.3500160000003,0.3745472000000022,124525594.0,+1
2017-05-17,1558.800049,1565.400024,1551.5,1559.650024,1537.054199,868118.0,1544.4750243,1548.2609328363637,19.05004800000006,73.16634465921486,-0.9695194735458535,47.935922255759124,36.15604770229354,48337.43385733499,-714724.1043477461,48.0,16.0,56.0,20.199951000000056,1558.850016,1566.2000320000002,1572.75004,1580.1000560000002,1552.3000080000002,1544.949992,1538.3999840000001,0.5863316494993112,125393712.0,+1
2017-05-18,1549.0,1561.5,1548.099976,1557.150024,1537.004639,776820.0,1545.7600218000002,1550.5654782363636,12.849975000000086,69.53702067371273,-1.139016750270737,43.1796677681657,26.814698166097006,-5079131.929400755,-913106.2782137921,44.0,12.0,56.0,24.25,1555.5833333333333,1563.0666906666665,1568.983357333333,1576.4667146666666,1549.6666666666665,1542.1833093333332,1536.2666426666665,0.6753755067901401,124616892.0,-1
2017-05-19,1559.5,1569.900024,1545.25,1557.099976,1541.101196,713534.0,1547.9900145000001,1552.627288090909,22.299927000000025,69.45743630881616,-0.8702187634201888,38.786406334978665,25.29074850513881,52849.30447976747,-869199.2062731758,40.0,8.0,56.0,20.700072999999975,1557.4166666666667,1569.5833333333335,1582.0666906666665,1594.2333573333335,1544.9333093333335,1532.7666426666667,1520.2832853333334,0.4807287814405355,123903358.0,-1
2017-05-22,1565.099976,1580.0,1563.099976,1561.25,1555.660889,715013.0,1550.8950194000001,1555.0381945454546,29.050048999999944,72.47183521078132,-1.2660364618501012,34.18476208139418,37.86405252970333,-665224.4386631497,-859927.6259272656,36.0,4.0,56.00000000000001,14.949951000000056,1568.1166586666666,1573.1333413333332,1585.0166826666668,1590.0333653333332,1556.2333173333332,1551.2166346666666,1539.3332933333331,-0.10946588004845238,124618371.0,+1
2017-05-23,1580.0,1583.550049,1565.0,1576.0,1548.849976,770043.0,1555.0150144999998,1559.6027364727272,41.199951000000056,80.40348327696776,-0.5085749049070925,31.44649007946873,47.46571901894649,904090.7321776157,-779744.9732861345,96.0,0.0,32.0,13.75,1574.850016333333,1584.7000326666662,1593.4000653333333,1603.2500816666661,1566.1499836666662,1556.2999673333331,1547.5999346666663,0.5929903473570357,125388414.0,+1
2017-05-24,1569.050049,1575.449951,1562.0,1569.099976,1546.530273,866847.0,1558.3500121,1562.1636385636366,33.34997599999997,69.58194006942172,-0.9733638155031292,28.73668559046223,36.91030835526595,-539255.6645976905,-768813.6410730236,96.0,0.0,32.0,13.90002400000003,1568.8499756666668,1575.6999513333335,1582.2999266666666,1589.1499023333336,1562.2500003333334,1555.4000246666667,1548.8000493333334,0.5278811796414679,124521567.0,-1
2017-05-25,1567.099976,1629.400024,1567.099976,1566.75,1596.279785,5022701.0,1559.8450072,1563.690909090909,14.949951000000056,66.08660734076727,-4.0937024972236955,25.439947798393177,71.7516865401912,522204.91269967775,-710130.9795379008,92.0,0.0,32.0,13.40002400000003,1587.75,1608.400024,1650.050048,1670.700072,1546.099976,1525.449952,1483.799928,-0.005617587967186948,119498866.0,-1
2017-05-26,1606.650024,1632.0,1601.099976,1617.150024,1605.0155029999999,1360789.0,1566.9200072,1574.1100030545454,70.75,84.8810382792828,-0.9686872798434422,24.00546982992455,129.2370051037033,-609602.6771499092,-705561.5112475374,96.0,0.0,32.0,24.65002400000003,1616.75,1632.400024,1647.650024,1663.300048,1601.5,1585.849976,1570.599976,0.5194186256942728,120859655.0,+1
2017-05-29,1619.800049,1648.0,1617.650024,1626.0,1610.8394779999999,1479085.0,1574.3550047999997,1584.851819927273,74.34997599999997,86.40728078516297,-1.4202711426726922,20.857158493198995,144.50582911423314,236464.75702853344,-662742.1354168069,96.0,0.0,32.0,22.90002400000003,1630.5500080000002,1643.4499920000003,1660.8999840000001,1673.7999680000003,1613.1000160000003,1600.2000320000002,1582.7500400000004,0.27512298527023477,122338740.0,+1
2017-05-30,1630.0,1633.5,1616.150024,1631.900024,1608.026245,1108546.0,1582.2050048,1595.314550690909,78.5,87.3867445217922,-1.039378695932858,19.573123161257172,121.25095044089075,-244688.6469575639,-643739.7041232049,96.0,8.0,96.0,22.300048999999944,1627.1833493333334,1638.2166746666667,1644.5333253333333,1655.5666506666666,1620.8666986666667,1609.8333733333334,1603.5167226666667,0.9077822355489154,123447286.0,+1
2017-05-31,1625.0,1643.0,1623.150024,1629.050049,1615.083862,1329728.0,1589.1450073000003,1603.8318314545454,69.40002499999991,84.01261539038998,-1.2233667527437093,19.901700213833465,116.37147238860726,116298.26033825206,-609192.5239204114,92.0,4.0,96.0,14.0,1631.7333576666667,1640.3166913333334,1651.583333666667,1660.1666673333334,1620.4667153333335,1611.8833816666668,1600.6167393333335,0.29723083796171457,122117558.0,-1
2017-06-01,1639.0,1639.849976,1620.550049,1636.199951,1607.5820310000001,839885.0,1597.0500000000002,1612.3872757636364,79.04992700000003,85.61987404994917,-0.76178495803744,22.776573191203852,104.43113709013876,-1163920.072698602,-634407.4125012383,88.0,0.0,92.0,62.30004800000006,1632.1999919999998,1643.8499349999997,1651.4999189999999,1663.1498619999998,1624.5500079999997,1612.9000649999998,1605.2500809999997,0.8108788183499394,122957443.0,+1
2017-06-02,1634.0,1646.099976,1626.199951,1628.599976,1613.159058,803386.0,1604.2000000000003,1618.123635036364,71.5,76.22163296444691,-1.252422466107168,25.26097595115789,93.78846573801619,-913782.5096183178,-647106.2805520146,84.0,16.0,96.0,65.25,1633.6333009999998,1641.0666509999996,1653.5333259999998,1660.9666759999996,1621.1666259999997,1613.733276,1601.2666009999998,0.12060411984406676,122154057.0,-1
2017-06-05,1633.699951,1638.949951,1625.0,1634.25,1614.442383,724975.0,1611.5000000000002,1623.5872713999997,73.0,78.2678888866166,-0.8876694641704326,29.504099759319615,80.57053096566665,-148921.86877538188,-624461.5345621677,80.0,12.0,96.0,30.84997599999997,1632.7333170000002,1640.4666340000003,1646.6832680000002,1654.4165850000004,1626.5166830000003,1618.7833660000001,1612.5667320000002,0.6630847663909331,122879032.0,+1
2017-06-06,1635.0,1643.800049,1630.0,1635.550049,1617.798462,1250658.0,1617.4550049000002,1627.960007581818,59.550048999999944,78.75331860877102,-0.803741187863141,35.451149278352204,76.11132741915706,-629409.4564366641,-624686.4401019176,76.0,8.0,88.0,17.34997599999997,1636.4500326666666,1642.9000653333333,1650.2500816666666,1656.7001143333332,1629.1000163333333,1622.6499836666667,1615.2999673333334,0.4021760357517547,124129690.0,+1
2017-06-07,1640.400024,1644.900024,1630.349976,1638.949951,1619.624634,638569.0,1624.4400024,1631.8681796,69.84997500000009,80.09497631647368,-0.5842510652033535,40.133756535080465,68.95675761244065,480431.02518998156,-574453.8280431948,72.0,4.0,88.0,19.84997599999997,1638.0666503333334,1645.7833246666669,1652.6166983333337,1660.333372666667,1631.2332766666668,1623.5166023333334,1616.6832286666668,0.5910616239891476,124768259.0,+1
2017-06-08,1643.900024,1659.400024,1641.650024,1640.800049,1623.5235599999999,1062192.0,1631.8450073000001,1634.8427335272727,74.05004899999994,80.85408337444545,-1.1920004302691605,42.97792381748832,72.72699271459685,529001.7961977341,-524296.7542140615,68.0,0.0,88.0,19.299927000000025,1647.283365666667,1652.9167073333338,1665.0333656666667,1670.6667073333338,1635.1667073333338,1629.533365666667,1617.4167073333338,-0.04788591549296258,125830451.0,+1
2017-06-09,1640.099976,1670.0,1640.099976,1644.75,1645.2890630000002,1326318.0,1634.6050049,1637.1890958363638,27.59997599999997,82.4983221906879,-1.6072565245066834,47.600308069057974,67.95417133011732,-231865.29682123382,-511004.41524166026,96.0,0.0,68.0,19.900024999999914,1651.6166586666666,1663.1333413333332,1681.5166826666668,1693.0333653333332,1633.2333173333332,1621.7166346666666,1603.3332933333331,0.15551907249305302,127156769.0,+1
2017-06-12,1664.0,1676.0,1660.0,1666.800049,1647.213867,992853.0,1638.6850098000002,1643.0427402181817,40.800048999999944,88.73160242464694,-0.5833830691185831,53.15193952771324,79.02893582083932,-897476.9635014195,-528571.3492534675,96.0,0.0,68.0,13.949951000000056,1667.600016333333,1675.2000326666662,1683.6000163333329,1691.2000326666662,1659.2000326666662,1651.600016333333,1643.2000326666662,0.42500306249999653,128149622.0,+1
2017-06-13,1661.75,1691.9000239999998,1661.0,1668.75,1655.061157,1262905.0,1642.3700074,1648.5091020727273,36.84997599999997,89.12674917977657,-1.4533256105971286,52.14491707524576,75.96241362191299,772797.59983104,-469418.2152041717,96.0,0.0,68.0,13.800048999999944,1673.8833413333332,1686.7666826666664,1704.7833653333328,1717.6667066666662,1655.8666586666666,1642.9833173333334,1624.9666346666668,0.2508088666856715,129412527.0,+1
2017-06-14,1675.0,1679.949951,1667.0,1676.699951,1649.632202,964590.0,1647.1349976000004,1654.75091,47.64990200000011,90.66643611084498,-0.9542389836764639,50.41420360700613,65.79998812666153,-305245.69933845446,-461955.8281193664,96.0,8.0,68.0,14.55004800000006,1674.5499673333334,1682.0999346666667,1687.4999183333334,1695.0498856666668,1669.1499836666667,1661.6000163333333,1656.2000326666666,0.7490337994329102,130377117.0,+1
2017-06-15,1668.0,1675.599976,1653.599976,1671.199951,1642.870605,881673.0,1650.6349976000001,1659.1263560727273,35.0,81.45862814288768,-1.2995211681910144,47.87390790138147,48.423141825323405,-659472.841137731,-470933.87416565564,92.0,4.0,68.0,20.450072999999975,1666.7999676666666,1679.9999593333332,1688.7999676666664,1701.9999593333332,1657.9999593333332,1644.7999676666666,1635.9999593333332,0.7999988636363675,129495444.0,-1
2017-06-16,1665.0,1674.699951,1658.099976,1664.349976,1647.7073970000001,938776.0,1654.2099976000004,1661.6199885090912,35.75,71.08434956047384,-1.7295528648946668,46.62080899790112,41.7864490201558,854586.0758353996,-410682.9673474258,88.0,0.0,96.0,29.90002400000003,1665.716634333333,1673.3332926666662,1682.3166093333334,1689.9332676666663,1656.7333176666662,1649.116659333333,1640.133342666666,0.3765065911243823,128556668.0,-1
2017-06-19,1671.0,1696.0,1668.400024,1669.25,1671.0522460000002,956383.0,1657.7099976000002,1664.3545343999997,35.0,73.83478955060498,-1.67501565435191,44.24209644539815,52.38528150668947,234212.26852086218,-381369.5475352309,84.0,0.0,96.0,31.25,1677.8833413333334,1687.3666586666668,1705.4833173333332,1714.9666346666668,1659.7666826666668,1650.2833653333334,1632.1667066666669,0.030796258663412266,129513051.0,+1
2017-06-20,1690.0,1694.0,1679.8499760000002,1692.9000239999998,1664.78418,915066.0,1663.4449951000001,1670.7527210181818,57.34997499999986,82.89548124229343,-0.19411246086413259,43.93491225328012,61.033369795157064,161665.94821933622,-356686.1159100232,96.0,12.0,96.0,30.900023999999803,1688.9166666666667,1697.9833573333333,1703.0666906666668,1712.133381333333,1683.8333333333335,1674.766642666667,1669.6833093333337,0.9222633120622119,130428117.0,+1
2017-06-21,1682.5999760000002,1701.25,1679.5999760000002,1686.550049,1676.7773439999999,852733.0,1668.2050049000002,1674.953639909091,47.60009799999989,74.86395264090754,-0.9174567639257329,43.023340932102656,54.725152026606885,-7464.85196533538,-340812.42209435557,92.0,8.0,88.0,12.949951000000056,1689.1333416666669,1698.6667073333335,1710.7833656666664,1720.3167313333333,1677.0166833333337,1667.483317666667,1655.366659333334,0.3210191822420063,129575384.0,-1
2017-06-22,1694.949951,1716.0,1691.199951,1698.699951,1676.086426,1668865.0,1673.9949951,1680.498175563636,57.89990200000011,79.29319221423331,-1.069885528756954,42.83316835504411,66.09317320537248,1471079.4644461107,-258453.69997887977,96.0,4.0,88.0,23.099975000000086,1701.966634,1712.7333170000002,1726.7666830000003,1737.5333660000001,1687.9332680000002,1677.1665850000002,1663.1332190000003,0.30241875731777856,131244249.0,+1
2017-06-23,1702.0,1702.75,1675.199951,1698.0,1656.986084,1304367.0,1679.3199951000001,1684.862721909091,53.25,78.3751694543705,-1.1131725417439702,42.25288992810874,47.62089325897408,-460750.5231538813,-267649.01012319804,96.0,0.0,88.0,16.599975000000086,1691.9833170000002,1708.7666830000003,1719.5333660000001,1736.3167320000002,1681.2166340000003,1664.4332680000002,1653.6665850000004,0.8275865135484873,129939882.0,-1
2017-06-27,1689.0,1695.0,1656.25,1678.6500239999998,1646.128052,1500108.0,1680.5049926000002,1684.740908981818,11.849974999999858,57.23743602999854,-2.309831539888695,41.16003431733611,23.442450146542157,-96073.72558453454,-259850.1335532588,92.0,8.0,84.0,31.65002400000003,1676.6333413333332,1697.0166826666664,1715.3833413333332,1735.7666826666664,1658.2666826666664,1637.8833413333332,1619.5166826666664,0.5780651354838658,128439774.0,-1
2017-06-28,1665.0,1675.0,1657.800049,1667.650024,1644.943481,1112259.0,1680.394995,1682.4036419636363,-1.0999759999999696,48.63386295780741,-2.990103648732218,39.67505852780732,6.85015850238456,152259.43652413372,-241117.88036792274,88.0,4.0,84.0,24.75,1666.816691,1675.833333,1684.016642,1693.033284,1658.633382,1649.61674,1641.433431,0.5726745965729817,127327515.0,-1
2017-06-29,1667.0,1681.9000239999998,1651.099976,1666.449951,1652.495361,2296927.0,1679.369995,1679.8681794181819,-10.25,47.73071376984878,-3.064319666048234,36.073618294509515,3.9869107634400516,-1653057.34305302,-305296.94685360906,84.0,0.0,84.0,21.650023999999803,1666.4833170000002,1681.8666580000004,1697.2833649999998,1712.6667060000002,1651.0666100000005,1635.6832690000003,1620.2665620000007,0.49837503499995095,125030588.0,-1
2017-06-30,1653.800049,1660.0,1643.0,1663.050049,1641.565186,1082608.0,1678.5550048000002,1676.9009165090906,-8.149902000000111,44.99902940778451,-3.274579529993819,31.57096187989282,-17.305091266943787,-1343670.399565647,-352495.74015870166,80.0,0.0,92.0,29.449951000000056,1655.350016333333,1667.7000326666662,1672.3500163333329,1684.7000326666662,1650.7000326666662,1638.350016333333,1633.7000326666662,1.1794146470588203,123947980.0,-1
2017-07-03,1652.599976,1667.5,1647.25,1652.050049,1648.073486,876083.0,1677.3250121,1672.0818336363636,-12.299927000000025,37.07737698200708,-3.954851638837357,25.341901937313878,-20.295508403204813,-281011.8152339261,-349246.4708439391,76.0,0.0,96.0,27.550048999999944,1655.600016333333,1663.9500326666662,1675.8500163333329,1684.2000326666662,1643.7000326666662,1635.350016333333,1623.4500326666662,0.23703945679012073,123071897.0,-1
2017-07-04,1660.25,1666.699951,1652.0,1658.599976,1642.856812,941520.0,1676.2600097000002,1668.677281618182,-10.65002400000003,43.86667797623504,-3.5497850340136075,22.938458265014106,-17.91101304645394,-241916.7437842904,-344367.8468866823,72.0,4.0,84.0,41.75,1659.0999756666668,1666.1999513333335,1673.7999266666666,1680.8999023333336,1651.5000003333334,1644.4000246666667,1636.8000493333334,0.44897945578185566,124013417.0,+1
2017-07-05,1653.099976,1659.5,1645.0,1653.349976,1638.286011,1003550.0,1672.3050048999999,1664.5118209454547,-39.55004799999983,39.88639640376401,-3.874460358688932,21.837138814538093,-37.611926825108654,935690.5922160862,-286183.372382011,68.0,0.0,84.0,20.84997499999986,1652.6166586666666,1660.2333173333332,1667.1166586666668,1674.7333173333332,1645.7333173333332,1638.1166586666666,1631.2333173333332,0.5758604137931014,123009867.0,-1
2017-07-06,1652.550049,1663.0,1651.349976,1648.75,1647.626465,1142919.0,1668.525,1660.2290927818183,-37.800048999999944,36.53495383591056,-4.158936301793445,20.276994793892527,-39.23304240265305,-857632.4752755102,-312158.3316044428,64.0,4.0,84.0,30.800047999999833,1654.3666586666666,1657.3833413333332,1666.0166826666668,1669.0333653333332,1645.7333173333332,1642.7166346666666,1634.0832933333331,-0.22317344582294105,121866948.0,-1
2017-07-07,1660.849976,1669.599976,1658.0,1658.150024,1656.6188960000002,1379349.0,1664.4700073,1658.342733509091,-40.549927000000025,47.029473656560675,-3.577611379097091,15.314652945119633,-22.906614289004047,393442.58371177124,-280085.56272643304,60.0,0.0,80.0,23.449951000000056,1661.9166666666667,1665.8333333333335,1673.5166426666665,1677.4333093333335,1654.2333573333335,1650.3166906666668,1642.6333813333335,0.012933130206478939,123246297.0,+1
2017-07-10,1668.0,1748.0,1661.050049,1667.199951,1665.7109380000002,327313.0,1661.3900024000002,1658.8390869090908,-30.800048999999944,55.249766637666056,-4.899942328684047,11.571881308837874,62.40581522528056,-267538.3106995691,-279515.2330888483,56.00000000000001,4.0,76.0,20.25,1692.0833333333333,1723.1166176666666,1779.033284333333,1810.0665686666666,1636.1666666666665,1605.1333823333332,1549.2167156666665,0.07072921754723137,123573610.0,+1
2017-07-11,1677.550049,1690.800049,1667.099976,1676.349976,1669.735229,1102570.0,1661.1599975999998,1661.559082109091,-2.3000479999998333,62.1095163272792,-4.345059066100669,5.575506923915327,18.64078427426709,-27645.095238082067,-268066.590459268,96.0,0.0,68.0,14.699951000000056,1678.0833336666667,1689.0666913333334,1701.783406666667,1712.7667643333334,1665.3666183333335,1654.3832606666667,1641.6665453333335,0.39029415647791504,124676180.0,+1
2017-07-12,1680.0,1685.0,1658.550049,1680.4000239999998,1670.579834,1434723.0,1662.4349975999999,1665.0572687272725,12.749999999999773,64.86053715961694,-4.099452759248041,-0.3020898431225305,8.268368780193672,-760622.230723013,-290455.48319852917,92.0,0.0,68.0,14.5,1674.6500243333332,1690.7499996666666,1701.099975333333,1717.1999506666666,1664.3000486666665,1648.2000733333332,1637.8500976666664,0.826087541712263,126110903.0,+1
2017-07-13,1688.0,1693.300049,1679.6500239999998,1681.25,1672.8652339999999,1120251.0,1663.9150025000004,1668.4781782545456,14.800048999999944,65.46767039444342,-4.0479078229229835,-3.7433857882822394,54.41634701609663,-638794.3895441021,-306289.0698506007,88.0,0.0,60.0,11.65002400000003,1684.7333576666667,1689.8166913333337,1698.3833826666666,1703.4667163333338,1676.1666663333335,1671.0833326666666,1662.5166413333334,0.11721414429645223,127231154.0,+1
2017-07-14,1683.9000239999998,1686.050049,1672.0,1683.550049,1669.287964,610813.0,1665.9650025,1672.0481867090907,20.5,67.23523106700546,-3.908426379624018,-5.541729663615342,38.61243842449629,415928.9070226635,-273460.979992725,84.0,4.0,60.0,20.84997599999997,1680.533366,1689.0667319999998,1694.583415,1703.1167809999997,1675.0166829999998,1666.483317,1660.9666339999999,0.8220646774968535,127841967.0,+1
2017-07-17,1682.550049,1687.6500239999998,1677.0,1679.949951,1671.672852,599835.0,1668.7549927000002,1674.5909046181819,27.89990200000011,61.54576192014366,-4.126746452395388,-7.199366248403749,47.67852863124946,-3159429.766326412,-404641.3793715291,80.0,0.0,52.00000000000001,89.84997599999997,1681.5333249999996,1686.0666499999993,1692.1833489999995,1696.716673999999,1675.4166259999995,1670.8833009999998,1664.7666019999997,0.2769900800223652,127242132.0,-1
2017-07-18,1679.699951,1687.8499760000002,1677.349976,1682.3499760000002,1672.8652339999999,580547.0,1671.1299927000002,1677.0627197636363,23.750000000000227,63.895835669563404,-3.981202183141286,-8.106109318031258,56.63228341255702,-2349304.13130058,-493035.14082284964,76.0,52.0,96.0,23.700072999999975,1682.5166426666667,1687.6833093333335,1693.016642666667,1698.1833093333337,1677.1833093333332,1672.0166426666665,1666.683309333333,0.47619047619048754,127822679.0,+1
2017-07-19,1685.0,1696.199951,1681.8499760000002,1683.550049,1681.5596920000003,996811.0,1674.1500000000003,1679.3209118181817,30.200072999999975,65.12549590024292,-3.908426379624018,-5.99598018864981,89.16203447974888,-354907.0424832171,-486756.59089832084,72.0,48.0,92.0,26.449951000000056,1687.1999919999998,1692.5500079999995,1701.5499669999997,1706.8999829999993,1678.2000329999996,1672.850017,1663.8500579999998,0.11847219246024918,128819490.0,+1
2017-07-20,1693.9000239999998,1715.0,1688.1500239999998,1692.300049,1700.0416260000002,924619.0,1678.5050049000004,1682.620920727273,43.550048999999944,72.89266761016228,-3.377801758641604,-4.2406166887965355,154.25829691436667,-5250712.105820105,-703300.0233947657,68.0,44.0,88.0,13.650025000000142,1698.4833576666667,1708.8166913333337,1725.3333336666672,1735.6666673333339,1681.9667153333335,1671.6333816666665,1655.1167393333333,0.15456345286863984,129744109.0,+1
2017-07-21,1714.0999760000002,1715.25,1700.0,1710.9000239999998,1692.241455,968377.0,1683.7800049,1688.5109241999999,52.74999999999977,82.46920759926826,-2.2498469375379138,-0.5443104956650586,200.4416820102817,2887760.2594835027,-540070.0105366624,64.0,40.0,80.0,14.050048999999944,1708.7166746666664,1717.433349333333,1723.9666746666662,1732.683349333333,1702.183349333333,1693.4666746666664,1686.933349333333,0.7147556721311347,130712486.0,+1
2017-07-24,1710.0,1740.0,1695.0,1703.050049,1724.0880129999998,4919544.0,1687.3650147,1692.0145685818184,35.85009799999989,70.36390621800811,-2.7258915100060674,3.6492510521293298,190.35944787826216,-41445.76903098478,-517405.27228640433,60.0,36.0,80.0,10.650023999999803,1712.6833496666666,1730.3666993333331,1757.6833496666668,1775.3666993333331,1685.3666993333331,1667.6833496666666,1640.3666993333331,0.17888997777777654,125792942.0,-1
2017-07-25,1759.0,1759.0,1733.050049,1735.0999760000002,1728.609131,2790117.0,1693.2400147000003,1700.6936524545454,58.75000000000023,82.47937226137019,-1.439760481927699,7.337238448482594,284.87016308068013,-723178.3498047682,-526758.5939917845,56.00000000000001,32.0,24.0,10.500000000000227,1742.3833416666666,1751.7166343333333,1768.3332926666667,1777.6665853333334,1725.7666833333333,1716.4333906666666,1699.8167323333332,0.07899540927843171,128583059.0,+1
2017-07-26,1742.0,1755.0,1732.5,1739.6500239999998,1736.4591059999998,973836.0,1699.1650147000003,1709.1318359636366,59.25,83.57902353896722,-1.165661204819289,10.617399527815678,217.93066512801408,396571.5514466255,-484789.04192640213,96.0,28.000000000000004,24.0,14.349974999999858,1742.3833413333332,1752.2666826666664,1764.8833413333332,1774.7666826666664,1729.7666826666664,1719.8833413333332,1707.2666826666664,0.3177788444444357,129556895.0,+1
2017-07-27,1756.0,1798.800049,1751.550049,1747.550049,1778.29187,4490428.0,1705.7950196000002,1717.9291149272728,66.30004899999994,85.41314233038065,-3.01506050844925,14.69987284406102,244.2537666567893,1021872.867366614,-416304.40968581045,92.0,24.0,24.0,31.449951000000056,1765.9667156666667,1780.3833823333334,1813.216715666667,1827.6333823333334,1733.1333823333334,1718.7167156666667,1685.8833823333334,-0.08465608465608465,134047323.0,+1
2017-07-28,1772.0,1786.5,1761.0999760000002,1789.6500239999998,1767.2126460000002,2313849.0,1716.4050171000001,1733.1754793636362,106.09997499999986,91.352344761281,-0.5383000786111957,19.314270850169805,215.55635251588427,-86892.52320242702,-401331.14211838384,96.0,20.0,24.0,22.949951000000056,1779.0833333333333,1797.0666906666663,1804.4833573333328,1822.4667146666661,1771.6666666666665,1753.6833093333335,1746.2666426666667,1.1240165757323626,136361172.0,+1
2017-07-31,1777.550049,1791.0,1766.550049,1778.5,1773.075195,1842285.0,1726.2600220000004,1744.4654762545456,98.55004899999994,81.24359623684302,-1.194260996282625,24.836558088574066,169.07082258683565,-39795.65034077651,-384897.7106739471,92.0,16.0,24.0,45.0,1778.6833496666666,1790.8166503333332,1803.1333006666669,1815.2666013333333,1766.3666993333331,1754.2333986666665,1741.916748333333,0.4887515316492875,134518887.0,-1
2017-08-01,1781.8499760000002,1809.1500239999998,1772.199951,1784.4000239999998,1785.793823,2129215.0,1736.4650268000003,1755.0363857090908,102.0500479999996,82.43062153472374,-1.4472414497361081,30.72394907783064,151.10935762850937,445319.5390425952,-347160.5629595588,88.0,12.0,24.000000000000007,55.949951000000056,1788.5833329999998,1804.9667149999996,1825.5334059999996,1841.9167879999993,1768.0166419999998,1751.63326,1731.066569,0.33017723672697025,136648102.0,+1
2017-08-02,1807.0,1807.0,1782.050049,1797.199951,1780.279175,1849479.0,1747.8300170000002,1766.0790992,113.64990200000011,84.83333564423972,-0.6987733726453316,36.86977437266546,130.0346978689279,891830.9785647248,-290842.76561754587,96.0,8.0,68.0,22.5,1795.4166666666667,1808.7832843333335,1820.366617666667,1833.7332353333336,1783.8333333333335,1770.4667156666667,1758.8833823333334,0.6072116935219664,138497581.0,+1
2017-08-03,1788.0,1792.0,1774.4000239999998,1791.6500239999998,1768.65332,1064196.0,1757.7650144999998,1774.0463731999998,99.34997499999986,79.40085059062841,-1.0233020351669453,42.576773751925884,93.23736957412237,1488082.5665250593,-209982.5232474274,92.0,4.0,68.0,59.15002500000014,1786.0166826666664,1797.633341333333,1803.6166586666666,1815.2333173333332,1780.0333653333328,1768.4167066666662,1762.4333893333326,0.9801149728840429,137433385.0,-1
2017-08-04,1777.0,1796.75,1766.1500239999998,1779.949951,1778.888062,886267.0,1764.6700072,1778.0799980181819,69.04992700000025,68.6995812779298,-1.7074568073098921,48.47234003293033,71.06149187919189,1880113.5716099753,-114978.15529936356,88.0,0.0,76.0,38.949951000000056,1780.9499916666664,1795.749959333333,1811.5499676666666,1826.3499353333332,1765.1499833333328,1750.3500156666662,1734.5500073333326,0.4509783602444709,136547118.0,-1
2017-08-07,1786.0,1796.449951,1785.0,1790.25,1777.198853,479665.0,1773.3900023000003,1782.7309058,87.19995100000006,72.46866691973234,-1.1051676013659375,53.91972280724303,72.4478513048555,-824584.1668566709,-147232.97400651392,84.0,8.0,76.0,24.449951000000056,1790.5666503333334,1796.1333006666669,1802.0166013333337,1807.583251666667,1784.6833496666668,1779.1166993333334,1773.2333986666667,0.4585172460563346,137026783.0,+1
2017-08-08,1792.0999760000002,1797.25,1766.0999760000002,1788.550049,1766.616455,1008843.0,1778.7350096000002,1785.4872779272728,53.45007299999975,70.84411111918473,-1.2045712195364597,56.70706270367282,54.101983743194985,-642566.6306610364,-169748.14021808314,80.0,4.0,76.0,36.95007299999975,1783.9666750000004,1801.8333740000005,1815.1166990000004,1832.9833980000003,1770.6833500000007,1752.8166510000005,1739.533326000001,0.7207080482506174,136017940.0,-1
2017-08-09,1771.0,1777.050049,1758.3499760000002,1777.9000239999998,1753.251709,817514.0,1782.5600096000003,1785.335462363636,38.25,60.96481992050127,-1.8273250627981166,61.2931862291357,32.247608210136725,1393803.9602399594,-98677.59019726297,76.0,0.0,88.0,24.949951000000056,1771.100016333333,1783.850056666666,1789.800089333333,1802.5501296666657,1765.1499836666662,1752.3999433333333,1746.4499106666665,1.0454530311191763,135200426.0,-1
2017-08-10,1760.0,1766.0,1752.8499760000002,1764.449951,1749.2771,1947111.0,1784.2499998000003,1782.0427244363636,16.89990200000011,50.66850056230812,-2.6138100384577574,61.28978629377707,16.781654385037296,1380002.9605315353,-31464.837891408446,72.0,0.0,88.0,22.799927000000253,1761.0999756666668,1769.3499753333333,1774.2499996666668,1782.499999333333,1756.1999513333335,1747.949951666667,1743.0499273333337,0.8821257664624819,133253315.0,-1
2017-08-11,1745.0,1758.0,1731.1500239999998,1760.449951,1737.949585,1589959.0,1781.3299925000001,1777.7154428363638,-29.200072999999747,47.89289918967833,-2.8477076464959166,60.497883794593236,0.5713176446687022,342179.83504781977,-14480.989121443514,68.0,0.0,88.0,30.599976000000197,1749.8666583333331,1768.5832926666665,1776.7166343333336,1795.4332686666667,1741.7333166666663,1723.016682333333,1714.883340666666,1.091245928860422,131663356.0,-1
2017-08-14,1753.0,1774.949951,1748.0,1749.050049,1746.047729,894271.0,1778.3849974000002,1771.8463622000002,-29.449951000000056,40.582417566703,-3.5143100989132794,59.07637229451416,4.929693902399015,-422719.48921149265,-33037.28458008212,64.0,8.0,76.0,16.5,1757.3333333333333,1766.6666666666665,1784.2832843333335,1793.6166176666666,1739.7167156666665,1730.3833823333332,1712.7667646666664,0.03896292798454225,130769085.0,-1
2017-08-16,1762.3499760000002,1789.800049,1748.550049,1757.199951,1769.94519,1106708.0,1775.6649901,1767.9945355818181,-27.200072999999747,47.22724632659823,-3.0377494530269207,52.51234390723084,10.050664426260322,-1020481.4414014891,-77921.10989014612,60.0,4.0,76.0,31.150023999999803,1765.1833496666666,1781.8166503333332,1806.4333496666663,1823.0666503333332,1740.5666503333332,1723.9333496666666,1699.3166503333332,0.20969459393939663,131875793.0,+1
2017-08-17,1776.25,1780.949951,1753.75,1781.25,1754.195801,1363717.0,1774.0699950000003,1769.009991927273,-15.949951000000056,61.78062628587495,-1.631437219451795,48.35334687819909,14.301088175813584,1346284.7911552475,-13184.478024446364,56.00000000000001,0.0,76.0,30.200072999999747,1771.9833170000002,1790.2166340000003,1799.1832680000002,1817.4165850000004,1763.0166830000003,1744.7833660000001,1735.8167320000002,1.011031233107734,133239510.0,+1
2017-08-18,1760.0,1761.0,1743.0,1765.4000239999998,1741.029907,926866.0,1771.444995,1767.4336335636362,-26.25,51.07070018612756,-2.5582550879173627,43.03967181198459,-12.05803531805883,-132519.58117657466,-18608.800894997654,52.0,4.0,72.0,25.050047999999606,1756.4666746666664,1769.933349333333,1774.4666746666662,1787.933349333333,1751.933349333333,1738.4666746666664,1733.933349333333,1.2444457777777669,132312644.0,-1
2017-08-21,1754.0,1759.0,1738.199951,1752.1500239999998,1732.136597,1002431.0,1768.6650023000002,1763.9254570181815,-27.799927000000253,43.75440634651193,-3.3330409145437647,35.314467403713024,-28.884723047025997,1610254.642857143,55430.44654828153,48.0,0.0,68.0,33.29992700000025,1749.783325,1761.3666990000002,1770.5833740000003,1782.166748,1740.5666500000002,1728.9832760000002,1719.7666010000003,0.6706750065829068,131310213.0,-1
2017-08-22,1751.300049,1754.0,1736.800049,1743.199951,1735.9124760000002,1652389.0,1763.9599974000002,1759.295447690909,-47.050048999999944,39.35970134670201,-3.856391081160477,27.770379167726787,-45.681940173122136,-936936.9214781618,10322.838910715886,44.0,0.0,56.0,26.949951000000056,1744.6666666666667,1752.5332843333335,1761.866617666667,1769.7332353333336,1735.3333333333335,1727.4667156666667,1718.1333823333334,0.37208838560063867,129657824.0,-1
2017-08-23,1750.0,1777.949951,1750.0,1747.0,1761.2009280000002,840131.0,1759.8049925000003,1756.2118117999999,-41.550048999999944,42.20363202015745,-3.51288056206089,21.252599250081403,-23.429993498308725,66190.28832902393,12862.26842972989,40.0,0.0,56.0,41.25,1758.3166503333334,1766.6333006666669,1786.2666013333337,1794.583251666667,1738.6833496666668,1730.3666993333334,1710.7333986666667,-0.1073347141109476,130497955.0,+1
2017-08-24,1774.9000239999998,1774.949951,1759.1500239999998,1772.449951,1751.3140870000002,1969569.0,1759.2599852000003,1758.5108951636364,-5.4500729999997475,57.57792731047387,-1.4603296923303368,13.668904123709808,-3.583863201963479,291830.4914465477,25542.642203221614,36.0,0.0,56.00000000000001,27.199951000000056,1768.8499753333333,1778.5499266666668,1784.6499023333333,1794.349853666667,1762.7499996666666,1753.050048333333,1746.9500726666663,0.8417714208426431,132467524.0,+1
2017-08-28,1762.4000239999998,1771.1500239999998,1758.3499760000002,1762.5,1751.065674,376946.0,1759.0649901000002,1759.0999887636362,-1.9499510000000555,51.40892298863284,-2.046224054173414,5.679163682458693,-19.860289017386624,1161172.347974606,77162.17428373914,32.0,0.0,48.0,38.25,1764.0,1769.6500239999998,1776.8000479999994,1782.4500719999994,1756.8499760000002,1751.1999520000004,1744.0499280000006,0.32421940917721015,132090578.0,-1
2017-08-29,1759.0,1759.0,1738.0,1762.25,1735.067993,1229649.0,1759.244995,1759.6790814727274,1.8000489999999445,51.24973231439349,-2.0609450905343736,-0.7513980237426949,-61.448960729218605,-933851.9707148969,31206.985874710186,28.000000000000004,4.0,48.0,27.200072999999747,1753.0833333333333,1768.1666666666665,1774.083333333333,1789.1666666666665,1747.1666666666665,1732.0833333333333,1726.1666666666665,1.1547619047619047,130860929.0,-1
2017-08-30,1751.949951,1770.0,1750.050049,1746.1500239999998,1757.3258059999998,673580.0,1758.9549925000001,1757.2981776545457,-2.9000250000001415,41.66314031030837,-3.0089784189607065,-4.880986443884012,-58.31806098545441,573996.8385919188,55879.2519073106,24.0,0.0,44.0,17.199951000000056,1755.4000243333332,1760.7499996666666,1775.349975333333,1780.6999506666666,1740.8000486666665,1735.4500733333332,1720.8500976666664,-0.19549045508934487,130187349.0,-1
2017-08-31,1772.0,1779.8499760000002,1756.4000239999998,1768.550049,1765.175537,1825859.0,1760.0900023,1759.042733381818,11.350097999999889,55.13557126673383,-1.2568014776536123,-8.594129771394819,9.55383079434662,-1778315.1672599015,-27493.2216911991,20.0,52.0,40.0,34.75,1768.2666829999998,1780.1333419999999,1791.7166350000005,1803.5832940000003,1756.6833899999995,1744.8167309999994,1733.233437999999,0.5181257940314734,132013208.0,+1
2017-09-01,1781.0,1781.449951,1761.0999760000002,1776.449951,1756.381714,573793.0,1759.6099973999999,1762.0172695090907,-4.8000489999999445,58.98962501830361,-0.789572842033901,-8.586356638858888,52.31208823213914,-3051244.882328012,-164936.47899287255,16.0,48.0,36.0,27.949951000000056,1772.9999593333334,1784.8999426666667,1793.3499343333335,1805.2499176666665,1764.5499676666668,1752.6499843333336,1744.199992666667,0.7542994524563281,132587001.0,+1
2017-09-04,1765.0,1765.0,1746.0999760000002,1767.5999760000002,1739.7878420000002,910631.0,1759.8299926,1763.469992890909,2.199952000000394,53.094006544643875,-1.3129922141373056,-9.565321219497491,-34.063531498980126,-3246573.6258827527,-305010.89476059447,12.0,44.0,32.0,14.099974999999858,1759.5666506666669,1773.0333253333336,1778.4666746666664,1791.9333493333334,1754.1333013333337,1740.666626666667,1735.233277333334,1.137564693039555,131676370.0,-1
2017-09-05,1757.0,1764.9000239999998,1751.0,1750.9000239999998,1744.2094730000001,920609.0,1759.7049926000002,1761.8463622363638,-1.25,43.60517287536763,-2.300687477682948,-13.916222292582688,-52.3259338303951,-890152.9887103593,-331608.262667402,8.0,40.0,24.000000000000004,24.5,1755.6000159999996,1760.2000319999993,1769.5000399999994,1774.100055999999,1746.3000079999995,1741.6999919999998,1732.3999839999997,-0.007192505566911139,130755761.0,-1
2017-09-06,1743.75,1762.800049,1738.0,1755.3499760000002,1748.730713,1437908.0,1760.9199951,1761.0545410363636,12.150025000000142,46.54257484518285,-2.0375013012552703,-13.580210356144335,-62.46349953277427,-129884.67146847445,-322439.0085219962,4.0,36.0,24.0,19.949951000000056,1752.0500083333334,1766.1000166666668,1776.850057333333,1790.9000656666667,1741.2999676666668,1727.2499593333334,1716.4999186666669,0.6995944241884456,132193669.0,+1
2017-09-07,1760.0999760000002,1776.75,1760.0999760000002,1759.9000239999998,1755.3385010000002,1736605.0,1762.2099975,1760.8690917454546,12.900023999999803,49.637431521448626,-1.2808658579823782,-11.979177106264387,38.34248207554369,-29126.145151961748,-309106.6056415401,0.0,32.0,-32.0,33.699952000000394,1765.5833333333333,1771.0666906666663,1782.2333573333328,1787.7167146666661,1754.4166666666665,1748.9333093333335,1737.7666426666667,-0.012009111818721486,133930274.0,+1
2017-09-08,1773.4000239999998,1790.0,1771.0,1766.550049,1776.304565,2077916.0,1761.6200072999998,1761.6581920181818,-5.899902000000111,54.11703136240373,-1.3867505026611504,-8.437955113794715,112.08013756541638,-331048.78469948267,-310103.97741690115,0.0,28.000000000000004,-32.0,20.34997499999986,1775.850016333333,1780.7000326666662,1794.8500163333329,1799.7000326666662,1761.7000326666662,1756.850016333333,1742.7000326666662,-0.23420794736842399,136008190.0,+1
2017-09-11,1793.0,1829.0,1790.199951,1787.6500239999998,1811.777954,2869419.0,1764.1350097000002,1766.3909223272726,25.150023999999803,65.3880660314127,-2.3901720231213988,-3.8041168085442223,271.7898483672283,-1627999.9508255601,-370008.33984456747,12.0,24.0,-32.0,30.34997499999986,1802.283325,1814.3666990000002,1841.0833740000003,1853.166748,1775.5666500000002,1763.4832760000002,1736.7666010000003,-0.06571968504473426,138877609.0,+1
2017-09-12,1827.699951,1839.9000239999998,1818.300049,1823.3499760000002,1823.5527339999999,1671920.0,1770.2450073000002,1777.1572798363636,61.0999760000002,76.60665437275196,-0.9506604498731173,-1.877944217221284,354.841696976893,277399.5681481663,-340580.70766307955,96.0,20.0,-32.0,16.599976000000197,1827.1833496666668,1836.0666503333337,1848.7833246666664,1857.6666253333335,1814.4666753333338,1805.583374666667,1792.866700333334,0.23379318726064663,140549529.0,+1
2017-09-13,1835.0,1849.0,1824.0,1835.199951,1830.160522,1248844.0,1779.1499999999999,1788.9672695999998,89.04992700000025,79.18999798912543,-0.7885742285714253,1.2111145192075128,310.8359166071462,-388224.9900057062,-342746.3568604717,96.0,16.0,-32.0,24.800048999999944,1836.0666503333334,1848.1333006666669,1861.0666503333332,1873.1333006666669,1823.1333006666669,1811.0666503333334,1798.1333006666669,0.4479980400000022,141798373.0,+1
2017-09-14,1840.1500239999998,1852.5,1831.5,1841.8499760000002,1827.726074,2038504.0,1786.4799927000001,1800.3672652363634,73.29992700000025,80.5787382647554,-0.6073580838323241,5.49196783370644,250.43287819730105,2003943.6929710004,-236078.62732267746,96.0,12.0,-32.0,21.400023999999803,1841.949992,1852.3999840000001,1862.9499919999998,1873.3999840000001,1831.3999840000001,1820.949992,1810.3999840000001,0.4928560000000094,143836877.0,+1
2017-09-15,1836.0,1851.800049,1833.449951,1839.4000239999998,1837.215454,941833.0,1792.7749999999999,1809.9890891090906,62.95007299999975,78.35592512335424,-0.747075905332204,12.331337072931547,186.96533132567245,2093512.6064907282,-130188.11669479529,96.0,8.0,-28.000000000000004,30.099976000000197,1841.550008,1849.6500649999998,1859.9001059999996,1868.0001629999997,1831.299967,1823.19991,1812.949869,0.3242529276955242,142895044.0,-1
2017-09-18,1853.550049,1864.449951,1852.5,1848.949951,1848.6424559999998,1021232.0,1800.9099975,1820.2027165636364,81.34997499999986,80.74493460698565,-0.877963149916562,16.203793581384616,180.03413552075097,2817817.7865366973,3812.1516339090385,92.0,4.0,-12.0,62.449951000000056,1855.2999673333334,1858.0999346666667,1867.2499183333334,1870.0498856666668,1846.1499836666667,1843.3500163333333,1834.2000326666666,-0.29707644826325463,143916276.0,+1
2017-09-19,1864.9000239999998,1868.0,1847.550049,1860.449951,1837.960693,1060367.0,1811.8649902,1831.0281626545454,109.54992700000025,83.3053061961327,-0.42679756924815965,18.827443608279054,151.91618674806153,4412801.7447959,204220.76950490876,96.0,0.0,76.0,52.25,1858.6666666666667,1869.7832843333335,1879.116617666667,1890.2332353333336,1849.3333333333335,1838.2167156666667,1828.8833823333334,0.6308035652506001,144976643.0,+1
2017-09-20,1848.0,1861.449951,1845.25,1849.699951,1837.116089,861532.0,1821.2999877,1837.9072464363637,94.34997499999986,72.85611783112205,-1.0344855285471986,22.568475826259828,111.37336139511115,463735.39086681814,216016.88865772283,96.0,20.0,80.0,25.650023999999803,1852.1333006666666,1859.0166013333333,1868.333251666667,1875.2165523333333,1842.8166503333332,1835.9333496666666,1826.6166993333331,0.2746891641832769,144115111.0,-1
2017-09-21,1848.0,1848.5,1830.699951,1848.8499760000002,1827.4279789999998,1928124.0,1830.1949829,1842.916335218182,88.9499520000004,72.03182803391758,-1.0825338609383721,28.45278162698628,76.63849682196323,-1800516.9662329096,124356.2588899667,92.0,16.0,84.0,21.0,1842.683309,1854.666667,1860.483358,1872.466716,1836.866618,1824.88326,1819.066569,1.019661518909313,142186987.0,-1
2017-09-22,1834.800049,1838.949951,1820.0,1839.0999760000002,1812.523193,2060881.0,1837.4499756000002,1844.5354248727272,72.54992700000025,62.6501150663126,-1.6336927077444774,34.70113108202304,50.8066614697944,-1668022.4841171328,42884.49784418938,88.0,12.0,88.0,18.35009799999989,1832.683309,1845.366618,1851.63326,1864.316569,1826.416667,1813.733358,1807.466716,1.007916907014701,140126106.0,-1
2017-09-25,1822.449951,1822.449951,1792.5999760000002,1824.0999760000002,1788.327759,2537307.0,1841.0949708000003,1842.1081522181819,36.449952000000394,50.885311227290174,-2.4816293951384854,42.169387363653186,15.079855644352174,-307980.50649841,26936.0885558894,84.0,8.0,88.0,25.049927000000253,1813.0499676666668,1833.4999593333334,1842.8999426666667,1863.3499343333333,1803.6499843333336,1783.199992666667,1773.8000093333337,1.0552772657263583,137588799.0,-1
2017-09-26,1789.050049,1796.5999760000002,1785.0,1799.75,1780.925049,2859683.0,1838.7349732000002,1834.5908848000001,-23.599976000000197,37.644388538593944,-3.8581119276427356,47.81794309836141,-17.122514890870608,1111617.4307879468,76239.78593007386,80.0,4.0,96.0,20.449951000000056,1793.7833253333336,1802.566650666667,1805.3833013333337,1814.1666266666673,1790.966674666667,1782.1833493333334,1779.3666986666667,1.271554354940023,134729116.0,-1
2017-09-27,1796.0,1805.5999760000002,1770.0,1792.300049,1765.2253420000002,1834305.0,1834.4449829999999,1826.1481713090911,-42.89990200000011,34.47728902322265,-4.279251045788584,50.03040720784543,-26.340713022253897,-287359.1585045729,59712.56118304445,76.0,0.0,76.0,16.199951000000056,1789.3000083333336,1808.6000166666672,1824.899984333334,1844.1999926666674,1773.000040666667,1753.7000323333334,1737.4000646666668,0.6264062930828892,132894811.0,-1
2017-09-28,1774.0,1799.0,1763.300049,1776.5,1783.906006,6911616.0,1827.9099854,1815.6127198545455,-65.3499760000002,28.590975837653062,-5.172413793103448,46.48286839701268,-40.97764354312237,-90630.13714942189,52878.802167932336,72.0,12.0,76.0,19.0,1779.600016333333,1795.8999836666662,1815.299967333333,1831.5999346666663,1760.2000326666662,1743.900065333333,1724.5000816666661,0.3697470341065744,125983195.0,-1
2017-09-29,1800.0999760000002,1822.0,1796.25,1795.300049,1794.239868,1553408.0,1823.4999879000004,1809.683640509091,-44.09997499999986,42.15085082806006,-4.109663708309783,41.759901255515615,-6.441083324213044,410370.9880077041,69128.44697883107,68.0,8.0,76.0,28.849976000000197,1804.5166829999998,1812.7833659999997,1830.2666829999998,1838.5333659999997,1787.0333659999997,1778.7666829999998,1761.2833659999997,-0.036891300970875944,127536603.0,+1
2017-10-03,1808.0,1821.0,1797.0999760000002,1805.699951,1797.369995,1098606.0,1819.1749879000004,1806.4472701636366,-43.25,48.40448807643892,-3.5217664782362887,37.65971379338066,-5.287879271168811,-706837.4376909254,33857.27040293302,64.0,4.0,76.0,46.5,1807.933309,1818.7666419999998,1831.8333329999998,1842.6666659999996,1794.866618,1784.0332850000002,1770.9665940000002,0.3598312286213574,128635209.0,+1
2017-10-04,1807.9000239999998,1811.9000239999998,1793.3499760000002,1808.8499760000002,1785.5952149999998,1656276.0,1814.0149904000004,1804.5699952727273,-51.59997499999986,50.282830492742086,-3.3436983606557265,33.05535765221907,-15.450792772500806,121442.77170826001,37838.429553175156,60.0,0.0,76.0,39.0999760000002,1804.699992,1816.050008,1823.2500399999997,1834.6000559999995,1797.4999600000003,1786.1499440000005,1778.9499120000007,0.8355773526839569,130291485.0,+1
2017-10-05,1795.0,1805.0,1793.0999760000002,1797.0,1787.185059,834049.0,1808.7449953000003,1801.4763606545455,-52.699951000000056,43.421354014401985,-4.013566986998304,26.445310683179287,-33.51053117964944,-1172437.8309902619,-17174.127744253845,56.00000000000001,20.0,76.0,35.5999760000002,1798.3666586666668,1803.6333413333334,1810.2666826666666,1815.5333653333332,1791.7333173333336,1786.466634666667,1779.8332933333338,0.32773244827068143,129457436.0,-1
2017-10-06,1798.0,1804.449951,1794.0,1798.5999760000002,1788.675537,757665.0,1803.7199953000006,1799.6318116909092,-50.25,44.599118465057174,-3.923121763708299,16.697652788121786,-39.42540146587499,-1906292.7780526795,-103043.1573037278,52.0,16.0,60.0,35.699951000000056,1799.0166423333333,1804.0332846666665,1809.4665933333335,1814.4832356666666,1793.5833336666665,1788.5666913333332,1783.1333826666664,0.4401911549633269,130215101.0,+1
2017-10-09,1798.800049,1803.0,1790.5,1800.0999760000002,1784.104736,765623.0,1799.8199953000003,1798.9736263636364,-39.0,45.81916743760944,-3.838328094968898,9.19182816142552,-49.1349947278762,-357577.6375575069,-114612.90640617233,48.0,12.0,60.0,45.5,1797.8666586666668,1805.2333173333336,1810.3666586666668,1817.7333173333336,1792.7333173333336,1785.3666586666668,1780.2333173333336,0.7679980800000158,130980724.0,+1
2017-10-10,1799.0,1814.949951,1792.6500239999998,1795.5,1791.258911,949545.0,1796.9599977,1798.1881726727274,-28.599976000000197,42.506851604087714,-4.098360655737705,1.5817718796902227,-47.791862721322154,962090.8290570164,-65671.8275214819,44.0,8.0,60.0,25.699951000000056,1801.033325,1809.4166260000004,1823.3332520000001,1831.7165530000007,1787.1166990000002,1778.7333979999999,1764.816772,0.12780203271518176,130031179.0,-1
2017-10-11,1803.25,1815.25,1787.5999760000002,1802.699951,1778.788696,1316860.0,1797.2549928,1799.2318005454547,2.9499510000000555,49.14625924057089,-3.333427991340447,-5.647749554217171,-49.779558096091286,-313592.2222222222,-76940.93637151556,40.0,4.0,60.0,18.550047999999606,1801.8499756666668,1816.0999753333333,1829.4999996666668,1843.749999333333,1788.4499513333335,1774.199951666667,1760.7999273333337,0.5461107375530656,131348039.0,+1
2017-10-12,1795.0999760000002,1821.449951,1788.0,1790.1500239999998,1807.256836,1345390.0,1797.0399903,1797.939988036364,-2.1500250000001415,39.88305525813523,-3.335237267790809,-12.671388815634145,-58.93702002244885,183467.70772800728,-65104.17982153723,36.0,0.0,36.00000000000001,15.75,1799.8666583333334,1811.7333166666667,1833.3166093333334,1845.1832676666668,1778.2833656666667,1766.4167073333333,1744.8334146666666,0.06427584901394323,130002649.0,-1
2017-10-13,1826.699951,1856.550049,1822.0,1818.800049,1839.0538329999997,1608366.0,1801.2699951999998,1801.8963623454547,42.300048999999944,59.827787926274674,-2.1478762452015956,-15.683407405284925,71.73816390397008,-276803.8045191448,-74726.89003506486,32.0,0.0,36.0,10.449951000000056,1832.4500326666666,1842.9000653333333,1867.0000816666666,1877.4501143333332,1808.3500163333333,1797.8999836666667,1773.7999673333334,-0.09261784259698332,131611015.0,+1
2017-10-16,1860.0,1873.25,1842.0,1850.800049,1845.363525,818636.0,1806.8199952,1810.9018266727273,55.5,71.85966646706547,-1.2653206143440923,-16.604692182804683,176.54263094386965,-638833.751932887,-100368.11103042043,28.000000000000004,56.00000000000001,36.0,12.5,1855.350016333333,1868.7000326666662,1886.6000163333329,1899.9500326666662,1837.4500326666662,1824.100016333333,1806.2000326666662,0.28160156799999825,132429651.0,+1
2017-10-17,1850.0,1853.699951,1839.0999760000002,1857.1500239999998,1839.500854,653322.0,1811.9650024999999,1820.052741,51.45007299999975,73.66559728412122,-0.9074243201352795,-14.538377590154141,134.62981548297765,5903372.769147514,172529.20170494047,96.0,52.0,36.0,22.299927000000253,1849.983317,1860.8666579999997,1864.5832919999996,1875.4666329999995,1846.2666829999998,1835.383342,1831.666708,1.2363067744978866,133082973.0,+1
2017-10-18,1841.0,1875.0,1839.0,1851.25,1856.641357,981680.0,1816.2050049000002,1827.195467818182,42.4000239999998,68.92351632651602,-1.3372747747747749,-13.568755294511448,141.71931494916691,3061223.5896807644,303833.492067478,92.0,48.0,36.0,27.650023999999803,1855.0833333333333,1871.1666666666665,1891.083333333333,1907.1666666666665,1835.1666666666665,1819.0833333333333,1799.1666666666665,0.3402777777777778,132101293.0,-1
2017-10-19,1861.800049,1865.0,1840.6500239999998,1868.5,1836.668945,142502.0,1823.3550049,1836.7036487454548,71.5,74.46811752126091,-0.36599099099099097,-11.147409556040202,139.50830456061206,275284.306489289,302535.8018139239,96.0,44.0,36.0,33.449951000000056,1858.050008,1875.449992,1882.3999840000004,1899.7999680000003,1851.1000159999999,1833.7000319999997,1826.7500399999997,1.1437373079957027,132243795.0,+1
2017-10-23,1859.9000239999998,1869.699951,1836.050049,1848.4000239999998,1851.4744870000002,1040723.0,1828.3350097,1841.257288581818,49.800047999999606,60.06077931177952,-1.4977463963964075,-8.662757008701192,110.39550620729077,-1510673.743332942,220117.18612542996,92.0,40.0,32.0,66.40002500000014,1851.3833413333332,1866.7166336666664,1885.0332433333333,1900.3665356666666,1833.0667316666663,1817.733439333333,1799.4168296666662,0.3670136988809007,131203072.0,-1
2017-10-24,1863.0,1879.5999760000002,1853.0,1863.300049,1855.250244,2832218.0,1834.6550169999998,1847.6145684545454,63.20007299999975,65.73160731935307,-0.915417680540295,-3.446158686659601,135.0961991642171,1839537.857142857,293727.2166262222,88.0,36.0,-28.000000000000004,54.449951000000056,1865.3000083333336,1877.6000166666672,1891.899984333334,1904.1999926666674,1851.000040666667,1838.7000323333334,1824.4000646666668,0.3872202365896822,134035290.0,+1
2017-10-25,1860.0,1863.0,1785.0,1867.0999760000002,1783.707275,5341802.0,1841.8150146,1853.513651909091,71.5999760000002,67.10596630208966,-0.7020105677009174,1.9687492039558947,48.2140216354764,-1611773.8461538462,207113.53195440082,96.0,32.0,44.0,14.599974999999858,1838.3666586666668,1891.7333173333336,1916.3666586666668,1969.7333173333336,1813.7333173333336,1760.3666586666668,1735.7333173333336,1.0525637948717974,139377092.0,+1
2017-10-26,1768.0,1810.0,1757.8499760000002,1795.0999760000002,1783.955688,7142866.0,1841.0550171,1845.0200085272727,-7.5999749999998585,35.75509803046893,-4.745591437658201,6.427341636465826,-76.46043663726144,-400979.83529992634,179472.92435193137,92.0,28.000000000000004,44.0,36.0,1787.6499840000004,1817.4499920000005,1839.8000080000004,1869.6000160000003,1765.2999680000007,1735.4999600000006,1713.149944000001,0.7142853855637754,132234226.0,-1
2017-10-27,1804.4000239999998,1807.5,1779.0,1795.3499760000002,1779.682983,1868022.0,1841.5750123,1836.7100010545455,5.199952000000394,35.875122668565325,-4.731551226304183,12.581888447852407,-59.50901225792282,-900849.1327472177,130367.37630197001,88.0,96.0,52.0,24.349976000000197,1793.949992,1808.8999840000001,1822.4499919999998,1837.3999840000001,1780.3999840000001,1765.449992,1751.8999840000001,0.5736833684210595,134102248.0,+1
2017-10-30,1798.25,1816.0,1792.4000239999998,1791.050049,1803.480957,1355588.0,1838.8000123,1827.5236440909093,-27.75,34.592546265385494,-4.973038761851598,17.336750039985873,-47.265850121118646,-106010.59760113855,119622.9229427378,84.0,92.0,52.0,33.64990200000011,1799.816691,1807.2333580000002,1823.4166670000002,1830.8333340000004,1783.633382,1776.2167149999998,1760.0334059999998,-0.057202388680388794,132746660.0,-1
2017-10-31,1811.5,1811.5,1799.25,1815.0,1797.0222170000002,1170615.0,1835.2200074,1823.1963691272729,-35.800048999999944,46.81298781997804,-3.627989266018062,24.768566624948335,-27.388675462189195,-653866.908177018,84464.29425547614,80.0,88.0,52.0,31.199952000000394,1808.5833333333333,1817.9166666666665,1820.833333333333,1830.1666666666665,1805.6666666666665,1796.3333333333333,1793.4166666666665,1.2857142857142858,133917275.0,+1
2017-11-01,1815.0999760000002,1825.0,1812.0,1808.5,1809.641602,1047653.0,1830.3550050000003,1818.3381859636363,-48.6500239999998,44.22543961969784,-3.9930347612225394,27.90584688133663,-13.081144655915326,-292339.3804321331,67336.85449694844,76.0,84.0,64.0,78.30004899999994,1815.1666666666667,1818.3333333333335,1828.166666666667,1831.3333333333335,1805.3333333333335,1802.1666666666667,1792.3333333333335,-0.2692307692307692,132869622.0,-1
2017-11-02,1823.0,1829.800049,1816.949951,1821.199951,1810.535889,1184486.0,1827.3500001000004,1816.6736306909092,-30.050048999999944,50.4054934348916,-3.279794776319829,26.045289519297512,2.578525462358662,-235181.6799883305,53586.01202034484,72.0,80.0,64.0,109.25,1822.649983666667,1828.3500163333338,1835.5000816666666,1841.2001143333337,1815.4999183333339,1809.799885666667,1802.649820333334,0.3307367772603786,134054108.0,+1
2017-11-03,1825.699951,1840.0,1821.5999760000002,1822.0999760000002,1819.081299,952622.0,1822.7099977,1815.7190808545456,-46.4000239999998,50.85081411533893,-3.2292486114242203,21.55528466893179,12.223551147538782,737344.0685663105,84665.92368152512,68.0,76.0,-8.0,28.5,1827.8999840000004,1834.1999920000005,1846.3000080000004,1852.6000160000003,1815.7999680000007,1809.4999600000006,1797.399944000001,0.02717387759929038,135006730.0,+1
2017-11-06,1825.0,1840.0,1822.5999760000002,1830.699951,1816.9946289999998,1537061.0,1820.9399904000002,1817.1717996363639,-17.700072999999747,55.278215878829265,-2.7462667448671323,17.290216200666464,16.819116277950716,765827.1547039646,115627.79781890876,64.0,72.0,-8.0,23.599976000000197,1831.0999756666668,1839.5999753333333,1848.4999996666668,1856.999999333333,1822.1999513333335,1813.699951666667,1804.7999273333337,0.465515162507819,136543791.0,+1
2017-11-07,1838.0,1844.949951,1820.75,1828.5999760000002,1812.125732,1861594.0,1817.4699831000003,1818.5645242909095,-34.70007299999975,53.909962659210564,-2.8642031162197426,9.18870168229546,14.652499206443059,502255.9555508352,133201.8049885418,60.0,68.0,-8.0,20.449951000000056,1831.433309,1842.116618,1855.63326,1866.316569,1817.916667,1807.233358,1793.716716,0.32437983035586226,134682197.0,-1
2017-11-08,1825.199951,1833.5999760000002,1819.0,1823.699951,1814.36145,820786.0,1813.1299806000004,1819.6972457272727,-43.40002500000014,50.541784096639134,-3.139392662779646,4.405335914803118,-6.76069108966416,1281719.4356620258,185407.15183733657,56.00000000000001,64.0,-8.0,13.0,1825.433309,1831.866618,1840.0332850000004,1846.4665940000002,1817.2666419999998,1810.8333329999998,1802.6666659999996,0.3219149812301056,133861411.0,-1
2017-11-09,1827.0,1835.0,1821.0999760000002,1825.949951,1816.24939,778327.0,1816.2149781000003,1822.0281494363637,30.84997499999986,52.12650695366864,-3.0130307605934807,-2.1698257265691154,-5.4157464980127425,-516087.77176885906,153521.01894614584,52.0,60.0,-8.0,21.300048999999944,1827.3499756666668,1833.5999753333333,1841.2499996666668,1847.499999333333,1819.6999513333335,1813.449951666667,1805.7999273333337,0.34891846229905266,134639738.0,+1
2017-11-10,1821.699951,1834.800049,1812.3499760000002,1827.8499760000002,1810.436523,1936090.0,1819.4649781000003,1824.1436036,32.5,53.57588996577476,-2.906323750281798,-9.612753176227898,-21.96972164124924,-2278673.8576801457,42966.70637222341,48.0,56.00000000000001,-8.0,18.800048999999944,1825.0000003333334,1837.6500246666667,1847.4500733333332,1860.1000976666664,1815.199951666667,1802.5499273333337,1792.7498786666672,0.6904209175622803,136575828.0,+1
2017-11-13,1822.0,1823.1500239999998,1795.0,1822.0,1802.040161,833968.0,1822.5599732000003,1824.6045166727274,30.949951000000056,48.37311782406002,-3.234863348105548,-8.296538637408503,-78.81450707410113,-983796.8116319453,-3704.3626279661153,44.0,52.0,-8.0,17.900023999999803,1813.3833413333332,1831.7666826666664,1841.5333653333328,1859.9167066666662,1803.6166586666666,1785.2333173333334,1775.4666346666668,0.9591466067666652,135741860.0,-1
2017-11-14,1815.9000239999998,1819.0,1800.0,1813.550049,1790.911255,1178117.0,1822.4149781000003,1822.9663486363636,-1.4499510000000555,41.63455405704685,-2.803285204081636,-6.924236932663916,-96.73861160946784,-401079.33917412045,-21766.861561882237,40.0,48.0,-8.0,24.199951000000056,1810.850016333333,1821.7000326666662,1829.8500163333329,1840.7000326666662,1802.7000326666662,1791.850016333333,1783.7000326666662,0.7131604736842077,134563743.0,-1
2017-11-15,1798.0,1803.6500239999998,1788.0,1802.3499760000002,1788.824585,1537092.0,1821.7999757000002,1819.3181664363635,-6.150023999999803,34.32225915491067,-2.4399310516089274,-4.928123155053754,-161.67819705956205,-1103771.610327493,-70948.89559668276,36.0,44.0,-7.999999999999993,14.599976000000197,1798.0,1808.0,1813.6500239999996,1823.6500239999998,1792.3499760000002,1782.3499760000002,1776.6999520000004,0.9169299676473581,133026651.0,-1
2017-11-16,1804.0,1816.0,1795.199951,1800.25,1796.227173,1003243.0,1819.7049806000005,1815.3999890363639,-20.949951000000056,33.06587852704304,-2.5602080388614787,-6.463076675435332,-113.88721053549882,459173.29545454547,-46852.43236708146,32.0,40.0,-8.0,13.900023999999803,1803.8166503333334,1812.4333496666668,1824.6166993333331,1833.2333986666667,1791.6333006666669,1783.0166013333335,1770.833251666667,0.24279024534990076,132023408.0,-1
2017-11-17,1828.699951,1838.300049,1813.1500239999998,1807.699951,1813.963989,1589693.0,1818.2649781000002,1813.217256381818,-14.400025000000142,41.78839731172725,-2.1335090377971553,-6.494419561668565,-0.8398810771849672,-1014413.189469654,-90832.4667808348,28.000000000000004,36.0,-8.000000000000007,22.450072999999747,1819.716674666667,1826.283325333334,1844.8666996666668,1851.4333503333341,1801.1333003333339,1794.5666496666668,1775.9832753333337,-0.21670248836729653,133613101.0,+1
2017-11-20,1829.0,1839.699951,1829.0,1825.550049,1826.484009,598106.0,1817.7499879000002,1814.5418147272728,-5.149902000000111,57.20588187468299,-1.1111373489766265,-8.621344773300734,98.08387797989248,-283200.6057737859,-99576.47309869622,24.0,32.0,-8.0,32.8499760000002,1831.4166666666667,1833.8333333333335,1842.1166176666666,1844.5332843333335,1823.1333823333334,1820.7167156666667,1812.4334313333334,-0.32242680363676784,134211207.0,+1
2017-11-21,1837.449951,1850.0,1836.0999760000002,1838.1500239999998,1834.532593,568883.0,1818.7049927000003,1818.2509121999997,9.550047999999606,64.79922717617572,-0.6767547687036092,-8.82017031714804,184.14356750360218,-987015.3333440651,-139914.60310984938,20.0,28.000000000000004,-8.0,22.0,1841.4166666666667,1846.7333573333333,1855.3166906666668,1860.633381333333,1832.8333333333335,1827.516642666667,1818.9333093333337,0.14748521297514558,134780090.0,+1
2017-11-22,1849.699951,1860.0,1844.550049,1846.25,1843.475464,1415199.0,1820.9599976000002,1823.2590953454544,22.550048999999944,68.8933783170828,-0.7808063600227144,-7.993534494721871,215.4737136618868,-24937.473634408056,-134688.36995187477,16.0,24.0,-8.0,25.550048999999944,1850.2666829999998,1855.9833169999997,1865.7166339999999,1871.4332679999998,1840.5333659999997,1834.8167319999998,1825.0834149999996,0.11002953989951485,136195289.0,+1
2017-11-23,1859.0,1860.0,1838.0,1855.25,1831.154175,808145.0,1823.8900025000003,1829.4936412363634,29.300048999999944,72.929907500009,-0.26973310618966495,-6.204296393681943,163.19826300153815,1393598.762910311,-65220.773003593546,12.0,20.0,-8.0,20.800048999999944,1851.0833333333333,1864.1666666666665,1873.083333333333,1886.1666666666665,1842.1666666666665,1829.0833333333333,1820.1666666666665,0.7840909090909091,137003434.0,+1
2017-11-24,1843.0,1857.800049,1841.0,1842.8499760000002,1839.6499019999999,1300921.0,1825.3900025000003,1832.9409091454545,15.0,60.45790316842667,-0.973879840999421,-4.2984626415518505,111.02624336783786,200182.1333264627,-53157.00453404552,8.0,16.0,-7.9999999999999964,38.050048999999944,1847.216675,1853.4333499999998,1864.016724,1870.2333989999997,1836.6333009999998,1830.416626,1819.833252,0.11011729787217901,135702513.0,-1
2017-11-27,1849.0,1862.0,1845.5999760000002,1851.4000239999998,1845.760986,967618.0,1828.3300049000002,1837.6700039636364,29.400023999999803,65.19359749432802,-0.6012465116279181,-1.2846043104893852,116.04983844888687,418524.0678835084,-31716.955787793057,4.0,12.0,-8.0,32.0,1853.0,1860.4000239999998,1869.4000239999998,1876.8000479999996,1844.0,1836.5999760000002,1827.5999760000002,0.3536609458620107,136670131.0,+1
2017-11-28,1856.0,1871.0,1855.8499760000002,1857.550049,1853.511353,1272635.0,1832.7300049,1842.9827392545453,44.0,68.34050636418847,-0.7590265801354433,0.5220245497969245,128.860303384159,1474681.407268286,36755.69707839241,0.0,8.0,-8.000000000000004,24.449951000000056,1861.4666750000004,1867.0833740000005,1876.6166990000004,1882.2333980000003,1851.9333500000007,1846.3166510000005,1836.783326000001,0.11221586183624327,137942766.0,+1
2017-11-29,1865.0,1875.5,1855.800049,1865.3499760000002,1861.411011,818646.0,1839.0300049,1848.913643090909,63.0,72.03986063571924,-0.5713495074584747,4.440890734239247,119.71424936531301,1470015.4796711896,101903.8690144287,96.0,4.0,-8.0,21.849976000000197,1865.5500083333334,1875.2999676666668,1885.2499593333337,1894.9999186666669,1855.6000166666668,1845.8500573333333,1835.9000656666667,0.4847690737911087,138761412.0,+1
2017-11-30,1868.699951,1873.949951,1840.0,1873.300049,1841.9353030000002,1449078.0,1846.3350097999999,1855.1445602,73.05004899999994,75.41793227431609,-0.12383625105544924,10.30553971561676,90.41007939594972,-1026471.5672151507,50614.07645853869,96.0,0.0,-8.0,22.0,1862.4166666666667,1884.8333333333335,1896.3666176666666,1918.7832843333335,1850.8833823333334,1828.4667156666667,1816.9334313333334,0.9808570563179867,140210490.0,+1
2017-12-01,1854.9000239999998,1860.0,1844.0999760000002,1853.699951,1836.4702149999998,964537.0,1850.9350098,1856.483640418182,46.0,56.12755634516687,-1.2271347593582858,13.192305685867495,51.3017167521574,-2738588.7826461764,-76167.87168258482,92.0,0.0,-8.0,16.800048999999944,1852.5999756666668,1861.0999753333333,1868.4999996666668,1876.999999333333,1845.1999513333335,1836.699951666667,1829.2999273333337,0.6037711012260093,139245953.0,-1
2017-12-04,1854.9000239999998,1854.9000239999998,1830.0999760000002,1848.199951,1822.4597170000002,910483.0,1853.2000000000003,1855.9863570000002,22.64990200000011,51.834767029985954,-1.5367322825780998,16.657958597876586,25.14001226378897,-745116.7422311758,-106574.63852570261,88.0,48.0,-8.0,19.150023999999803,1844.399983666667,1858.6999913333336,1869.2000316666665,1883.5000393333332,1833.899943333334,1819.5999356666673,1809.0998953333344,0.7298362890265433,138335470.0,-1
2017-12-05,1826.0,1828.550049,1807.0,1834.0999760000002,1808.8963620000002,973340.0,1852.7949952000001,1852.5136253636365,-4.050047999999606,42.2713495825053,-2.330426343934692,18.87744380472168,-36.3678424603195,478390.15377760655,-79985.32978464308,84.0,44.0,-8.0,19.599976000000197,1823.216675,1839.4333499999998,1844.766724,1860.9833989999997,1817.8833009999998,1801.666626,1796.333252,1.2575366301951456,137362130.0,-1
2017-12-06,1819.949951,1821.3499760000002,1799.0,1820.449951,1791.855225,1598780.0,1850.2149903000002,1846.6327082363637,-25.800048999999944,35.048281593412554,-3.0987925133689807,20.039374174102704,-66.36247777271133,-493488.1378597063,-98780.91196987324,80.0,40.0,92.0,19.699951000000056,1813.5999756666668,1828.1999513333335,1835.949951666667,1850.5499273333337,1805.8499753333333,1791.2499996666666,1783.499999333333,0.9597303818133794,135763350.0,-1
2017-12-07,1806.6500239999998,1816.5999760000002,1803.0999760000002,1803.300049,1798.1649170000003,1057826.0,1845.0199952,1838.102718909091,-51.949951000000056,28.089981625903775,-4.064168364762176,18.689630638095423,-80.9812561317472,-305829.75346798706,-108192.22294706023,76.0,36.0,96.0,33.949951000000056,1807.6666670000002,1812.2333580000002,1821.1666670000002,1825.7333580000002,1798.7333580000002,1794.1666670000002,1785.2333580000002,0.014820222222203517,134705524.0,-1
2017-12-08,1814.0,1853.0,1814.0,1809.6500239999998,1828.719727,2239100.0,1841.7,1831.6718150545453,-33.199952000000394,33.712445744883425,-3.7067253588516853,17.055953471699013,-23.61940018044341,-6454901.057598841,-396678.98815850506,72.0,32.0,92.0,29.200072999999747,1825.550008,1837.1000159999999,1864.5500080000002,1876.1000159999999,1798.1000159999999,1786.550008,1759.1000159999999,-0.1115378461538512,136944624.0,+1
2017-12-11,1848.0,1851.75,1840.0,1840.4000239999998,1834.6816410000001,799558.0,1840.6000000000001,1831.4354557818183,-11.0,53.8668967796713,-1.975793751759088,14.833468666841782,25.098842712034028,1323023.378785808,-318510.6987519453,68.0,28.000000000000004,40.0,24.800047999999606,1844.050008,1848.1000159999999,1855.8000080000002,1859.8500159999999,1836.3500159999999,1832.300008,1824.6000159999999,0.034044595744664084,137744182.0,+1
2017-12-12,1849.0999760000002,1849.9000239999998,1815.949951,1846.4000239999998,1808.3498539999998,602647.0,1839.4849975,1832.4900056,-11.150025000000142,56.82252787679051,-1.6380509991556542,14.914145548176975,2.1927614659991965,-841869.3686907071,-342299.7292037072,64.0,24.0,40.0,41.199951000000056,1837.4166663333333,1858.8833816666665,1871.366739333333,1892.8334546666663,1824.9333086666668,1803.4665933333335,1790.983235666667,0.896907438166627,138346829.0,+1
2017-12-13,1820.050049,1845.0,1815.0999760000002,1819.9000239999998,1809.7906489999998,726865.0,1834.9400023000003,1828.9291013272725,-45.449952000000394,42.836507816747755,-3.1297481564874863,12.979436226417192,-38.67188421299074,133225.02901904538,-320684.9674663093,60.0,20.0,40.0,35.0999760000002,1826.6666666666667,1838.2333573333333,1856.5666906666668,1868.133381333333,1808.3333333333335,1796.766642666667,1778.4333093333337,0.16053659354921046,137619964.0,-1
2017-12-14,1824.0,1840.0,1812.0,1821.3499760000002,1826.3847660000001,920773.0,1829.744995,1826.4581874545454,-51.95007299999975,43.711192065818594,-3.048129693216989,9.702489532713344,-53.130897278770455,-1202995.7187130617,-360790.001613889,56.00000000000001,16.0,40.0,17.34997499999986,1824.449992,1836.8999840000001,1852.4499919999998,1864.8999840000001,1808.8999840000001,1796.449992,1780.8999840000001,0.3339277142857213,138540737.0,+1
2017-12-15,1856.0,1888.0,1855.5,1838.050049,1861.559937,3112531.0,1828.1800048000002,1827.9681972727271,-15.649902000000111,53.223263868265,-2.792059865846845,5.582695152090309,72.13674016057844,-315407.08837545884,-358727.1419212331,52.0,12.0,40.0,49.699951000000056,1860.5166829999998,1865.5333659999997,1893.0166829999998,1898.0333659999997,1833.0333659999997,1828.0166829999998,1800.5333659999997,-0.536921569230771,141653268.0,+1
2017-12-18,1855.0,1899.0,1809.300049,1873.449951,1867.0250239999998,3074497.0,1830.7050048,1836.1990965818181,25.25,66.90290138082017,-1.4194471666666635,0.9922987757540795,68.8524751975361,896959.5680579985,-301650.47328581347,96.0,8.0,40.0,42.0999760000002,1860.5833333333333,1911.8666176666666,1950.283284333333,2001.5665686666666,1822.1666666666665,1770.8833823333332,1732.4667156666665,0.7151609480812322,144727765.0,+1
2017-12-19,1879.800049,1893.6500239999998,1876.1500239999998,1878.949951,1872.5399170000003,1238028.0,1835.1900023000003,1844.970904981818,44.84997499999986,68.55163784339645,-1.1138916111111081,-1.3892777356081751,155.73283728456346,694681.6490388114,-256362.64954378502,96.0,4.0,40.0,33.95007299999975,1882.9166663333333,1889.6833086666668,1900.4166663333333,1907.1833086666668,1872.1833086666668,1865.4166663333333,1854.6833086666668,0.159995828571443,145965793.0,+1
2017-12-20,1898.9000239999998,1903.0999760000002,1863.6500239999998,1884.5,1856.293701,2335876.0,1841.5950072,1853.9363591090905,64.05004899999994,70.27570776725844,-1.0309836620717407,-3.5059480015320332,149.3425302790204,-2412589.3581211986,-354372.9544791221,92.0,0.0,40.0,31.300047999999606,1883.75,1903.8499760000002,1923.1999520000006,1943.2999280000006,1864.4000239999998,1844.3000479999996,1824.9500719999994,0.5285171449638263,148301669.0,+1
2017-12-21,1879.9000239999998,1885.0,1865.199951,1868.1500239999998,1856.4427489999998,1713636.0,1848.0800047,1858.764543981818,64.84997499999986,59.23700273860572,-1.9372513976465122,-4.799749788444387,97.46423962201543,1256278.8999025724,-281161.5065526814,96.0,0.0,40.00000000000001,28.0,1872.783325,1880.3666990000002,1892.5833740000003,1900.166748,1860.5666500000002,1852.9832760000002,1840.7666010000003,0.14899321713798566,146588033.0,-1
2017-12-22,1879.0,1880.0,1861.75,1868.300049,1864.7397460000002,1117726.0,1853.9450072,1862.4409156727272,58.65002500000014,59.30468140242151,-1.9289356168141896,-4.232250342785164,79.83305101419916,736911.6335931026,-234885.45472787297,92.0,52.0,40.0,66.6500239999998,1870.0166829999998,1878.2833659999997,1888.2666829999998,1896.5333659999997,1860.0333659999997,1851.7666829999998,1841.7833659999997,0.3589067945205449,147705759.0,+1
2017-12-26,1881.0,1882.800049,1856.699951,1876.6500239999998,1856.49231,1696424.0,1857.5700072,1866.5691005454546,36.25,63.225705099673426,-1.466102341991295,-0.2963623483278752,79.79030721866454,-1782053.8164442456,-305211.2893513445,88.0,48.0,88.0,89.69995100000006,1872.050008,1887.4000649999998,1898.1501059999996,1913.5001629999997,1861.299967,1845.94991,1835.199869,0.7643677429870123,149402183.0,+1
2017-12-27,1870.0999760000002,1870.300049,1851.1500239999998,1868.3499760000002,1844.9659420000003,872346.0,1859.7650024,1868.5290948727272,21.949952000000394,56.9339779764308,-1.9261681981198584,4.178716785280585,46.45539440199929,638650.8443227744,-262308.46509342996,84.0,44.0,92.0,20.200072999999747,1863.266683,1875.3833420000003,1882.4167080000004,1894.5333670000005,1856.2333170000002,1844.116658,1837.083292,0.8981686446884674,148529837.0,-1
2017-12-28,1858.9000239999998,1880.9000239999998,1858.0,1856.75,1866.1308589999999,2175130.0,1863.4499999999998,1867.9809126181817,36.8499760000002,49.06103201809463,-2.5691467555343612,5.266259854023247,54.6976079851482,-626674.5851750588,-278870.5614607767,80.0,40.0,92.0,39.449952000000394,1865.2166746666664,1872.433349333333,1888.1166986666663,1895.3333733333327,1849.533325333333,1842.3166506666666,1826.6333013333333,-0.05458509563134129,146354707.0,-1
2017-12-29,1876.800049,1879.199951,1868.1500239999998,1878.050049,1860.5167239999998,1586468.0,1869.1200073000002,1870.635466981818,56.70007299999975,60.60342028815438,-1.388499935327323,6.703143797288703,90.94536912287674,-218188.83886801626,-276112.30134292395,76.0,36.0,96.0,19.800048999999944,1875.1333413333334,1882.116658666667,1886.183268333334,1893.1665856666673,1871.0667316666668,1864.0834143333332,1860.0168046666665,0.8959357831051658,147941175.0,+1
2018-01-01,1872.699951,1880.75,1850.5,1872.4000239999998,1842.730225,1645129.0,1872.5550048,1871.2318336545454,34.34997499999986,56.6729964379444,-1.7016768698189035,12.540715551327139,57.84702783918854,-110287.68428719207,-268574.8187494816,72.0,32.0,40.0,18.25,1867.8833413333332,1885.2666826666664,1898.1333413333332,1915.5166826666664,1855.0166826666664,1837.6333413333332,1824.7666826666664,0.7239677355371835,146296046.0,-1
2018-01-02,1858.550049,1875.0,1858.550049,1854.5,1860.4669190000002,1194079.0,1870.6600097000003,1867.949105509091,-18.949951000000056,45.81193970486379,-2.6938626820313307,17.48920072010833,35.75539996519359,-326015.75471688807,-271185.7703843637,68.0,28.000000000000004,40.0,26.10009799999989,1862.6833496666666,1866.8166503333332,1879.1333006666669,1883.2666013333333,1850.3666993333331,1846.2333986666665,1833.916748333333,-0.24620432000070583,145101967.0,-1
2018-01-03,1875.0,1878.25,1851.199951,1872.3499760000002,1840.891968,1132822.0,1870.0000122000004,1868.2563721090908,-6.5999749999998585,55.6021085492879,-1.7044509954585796,21.54544648485762,42.194532816081235,239485.57150261707,-247973.43666222823,64.0,24.0,40.0,25.5,1867.2666423333333,1883.3333336666665,1894.316691333333,1910.3833826666664,1856.2832846666665,1840.2165933333333,1829.2332356666666,0.7818849052731913,146234789.0,+1
2018-01-04,1853.0,1865.5,1853.0,1852.6500239999998,1848.0960690000002,593444.0,1866.8150146,1865.1018287999998,-31.849976000000197,45.20235443938243,-2.796405557958967,20.81686445991727,2.256536986671486,-197821.73913174114,-245693.8140472061,60.0,20.0,40.0,22.900023999999803,1857.050008,1861.1000159999999,1869.5500080000002,1873.6000159999999,1848.6000159999999,1844.550008,1836.1000159999999,-0.02799808000001576,145641345.0,-1
2018-01-05,1863.0,1868.050049,1855.550049,1859.9000239999998,1851.772461,717717.0,1865.9900146,1863.8445577818181,-8.25,49.234371167583916,-2.3945431281353997,19.889143021923246,7.223840151615146,415157.0476765306,-215655.13851430893,56.00000000000001,16.0,40.0,22.449951000000056,1861.166707333333,1866.7833656666662,1873.6667073333333,1879.2833656666662,1854.2833656666662,1848.666707333333,1841.7833656666662,0.3479979999999887,146359062.0,+1
2018-01-08,1865.0,1870.699951,1857.75,1863.5999760000002,1848.7915039999998,1142577.0,1865.5200073,1863.410005309091,-4.7000729999997475,51.34258867830731,-2.1894573762801266,18.635107738186207,11.026094088272883,-2374835.3094282476,-313799.69173766987,52.0,12.0,40.0,30.25,1864.0166423333333,1870.2832846666665,1876.9665933333335,1883.2332356666666,1857.3333336666665,1851.0666913333332,1844.3833826666664,0.4517373077319113,147501639.0,+1
2018-01-09,1862.0,1869.8499760000002,1855.0,1860.5999760000002,1851.871826,1326382.0,1863.9150025000001,1862.5154541636366,-16.050047999999606,49.42240577010348,-2.3557452782760855,18.225682235340628,-0.06033565484478406,16276.222222222224,-298796.24110312934,48.0,8.0,40.0,16.449951000000056,1861.8166506666669,1868.6333013333337,1876.666626666667,1883.483277333334,1853.7833253333336,1846.9666746666667,1838.9333493333334,0.37710337040276176,146175257.0,-1
2018-01-10,1865.199951,1867.9000239999998,1857.300049,1863.699951,1852.3686519999999,1153972.0,1863.4500000000003,1862.476353890909,-4.6500250000001415,51.58144962554812,-2.183915831946119,17.485212095562247,-0.6460804921455636,502154.0301014988,-262389.41059382807,44.0,4.0,40.0,27.050048999999944,1862.966674666667,1868.6333003333339,1873.5666496666668,1879.2332753333337,1858.033325333334,1852.366699666667,1847.4333503333341,0.6037657635985176,147329229.0,+1
2018-01-11,1864.199951,1876.0,1856.25,1864.199951,1860.6657710000002,1014774.0,1864.1949951000001,1862.6127086181818,7.4499510000000555,51.96307584681534,-1.1646164053751369,14.619566065715844,2.3764540481795713,-10542027.114497714,-729645.6698621869,40.0,0.0,40.0,19.349976000000197,1865.4833170000002,1874.7166340000003,1885.2333170000002,1894.4666340000003,1854.9666340000003,1845.7333170000002,1835.2166340000003,0.40252916455696486,148344003.0,+1
2018-01-12,1873.0,1878.1500239999998,1860.0,1872.550049,1853.4617920000003,1084177.0,1863.6449951000004,1864.131809327273,-5.5,58.29687767797297,-0.5746159725551169,12.093496089695236,18.624732481580377,-743294.9218977558,-730266.0904092583,36.0,0.0,40.00000000000001,15.400025000000142,1870.2333576666667,1880.4667153333335,1888.3833816666665,1898.6167393333333,1862.3166913333337,1852.083333666667,1844.1666673333339,0.6914618404912346,149428180.0,+1
2018-01-15,1869.949951,1904.4000239999998,1859.8499760000002,1865.300049,1885.705811,3144111.0,1862.9349976,1864.4327282181819,-7.0999749999998585,51.49472516355834,-2.165723633556342,9.848154726560551,61.80378183247111,-2333072.2930174433,-803120.9178005395,32.0,24.0,40.0,12.949951000000056,1876.5166829999998,1893.1833899999995,1921.0667309999992,1937.733437999999,1848.6333419999999,1831.9666350000002,1804.0832940000003,0.12233596246629848,146284069.0,-1
2018-01-16,1903.449951,1910.0,1885.25,1897.75,1888.090576,1611346.0,1867.2599976000004,1870.7627286545458,43.25,69.73327873039518,-0.67642186637217,5.7594361742178535,229.76120840117594,900622.9054484244,-725678.0167437684,96.0,20.0,40.0,14.849976000000197,1897.6666666666667,1910.0833333333335,1922.416666666667,1934.8333333333335,1885.3333333333335,1872.9166666666667,1860.5833333333335,0.5050505050505051,147895415.0,+1
2018-01-17,1897.0,1902.550049,1887.0,1900.1500239999998,1878.5018309999998,726374.0,1870.0400023999998,1876.7427334545455,27.800047999999606,70.67429961599835,-0.5438970734400993,4.303166767997482,191.03494335200799,-1106507.681059361,-742988.4560308408,96.0,16.0,40.0,10.599974999999858,1896.566691,1906.133382,1912.11674,1921.683431,1890.583333,1881.016642,1875.033284,0.8456580426209493,148621789.0,+1
2018-01-18,1924.0,1954.0,1918.050049,1890.5,1922.023804,4162385.0,1873.825,1880.462733018182,37.8499760000002,61.765116851941286,-3.4231805929919137,5.51784429154759,329.60900328525264,-1123723.176813046,-760294.5797027592,92.0,12.0,40.0,19.75,1920.850016333333,1923.6499836666662,1956.799967333333,1959.5999346666663,1887.7000326666662,1884.900065333333,1851.7500816666661,-0.7663445493986877,144459404.0,-1
2018-01-19,1935.1500239999998,1959.9000239999998,1919.25,1934.300049,1939.8101809999998,2863997.0,1881.2650025000003,1891.4581964727274,74.40002500000014,76.96960598795427,-1.3756770739877138,3.8358698653833017,361.1895002027283,-2492823.0289466376,-839045.8728502083,96.0,8.0,36.0,18.150023999999803,1937.816691,1956.383382,1978.4667149999996,1997.0334059999998,1915.7333580000002,1897.1666670000002,1875.0833340000004,0.37023468916033153,147323401.0,+1
2018-01-22,1960.0,1988.0,1953.1500239999998,1952.199951,1950.889404,2212442.0,1890.1250000000002,1904.3554598363637,88.59997499999986,80.60622906818492,-1.895185230280569,5.605671494480248,381.2508020032983,1193910.8450704226,-746638.7493083613,96.0,4.0,8.0,44.550047999999606,1964.4499916666664,1975.749959333333,1999.2999676666666,2010.5999353333332,1940.8999833333328,1929.6000156666662,1906.0500073333326,-0.027261797827342612,149535843.0,+1
2018-01-23,1965.0,1966.699951,1943.300049,1963.3499760000002,1938.9160160000001,1261949.0,1900.4,1917.6690918363638,102.75,82.58294695352944,-1.3049245103229117,8.10818879956605,244.4082240645229,-622281.1886792452,-740986.1329161287,96.0,0.0,76.0,44.699951000000056,1957.7833253333336,1972.2666016666672,1981.1832273333334,1995.6665036666673,1948.866699666667,1934.3834233333334,1925.466797666667,0.8568380756466484,150797792.0,+1
2018-01-24,1952.550049,1969.0,1950.5999760000002,1951.300049,1945.225586,1197642.0,1909.1600098,1926.9236462,87.60009799999989,73.27041905084808,-1.9428242985706754,12.46992623505821,186.01343671844543,609317.5317971144,-679608.6936109812,92.0,32.0,80.0,15.550048999999944,1956.9666750000004,1963.3333740000005,1975.3666990000004,1981.7333980000003,1944.9333500000007,1938.5666510000005,1926.533326000001,0.038047396025122304,149600150.0,-1
2018-01-25,1953.9000239999998,1980.0,1950.5,1957.6500239999998,1962.4157710000002,2180917.0,1918.5050170999998,1935.740012418182,93.45007299999975,74.98557362175487,-1.6066689253573425,18.289129669353315,157.3854199069558,1931393.0913906987,-560926.794292723,88.0,28.000000000000004,80.0,53.8499760000002,1962.7166746666664,1974.933349333333,1992.2166746666662,2004.433349333333,1945.433349333333,1933.2166746666664,1915.933349333333,0.24237369491524755,151781067.0,+1
2018-01-29,1978.0,2006.949951,1978.0,1974.949951,1986.9591059999998,2058973.0,1928.7450073000002,1946.0027276727274,102.39990200000011,79.18433799959286,-1.6771928416271125,25.109268419794716,171.58465312847252,3700512.556068129,-367225.00563995674,84.0,24.0,88.0,69.4000239999998,1986.6333006666666,1995.2666013333333,2015.583251666667,2024.2165523333333,1966.3166503333332,1957.6833496666666,1937.3666993333331,-0.10535592961797893,153840040.0,+1
2018-01-30,1997.800049,2001.9000239999998,1984.1500239999998,1999.6500239999998,1982.835449,1599390.0,1942.1800048,1958.8945488909092,134.34997499999986,83.69348165954221,-0.3826057909000283,32.2127570895168,149.49354940279085,2818804.3175517255,-222405.4909494256,96.0,20.0,92.0,53.699951000000056,1995.2333573333333,2006.3166906666668,2012.9833573333333,2024.0666906666668,1988.5666906666668,1977.4833573333333,1970.8166906666668,0.8732394366197183,155439430.0,+1
2018-01-31,1989.4000239999998,2013.5,1987.0,1995.5,1992.9705809999998,1735837.0,1951.9550048,1968.5890934727274,97.75,80.32037666710323,-0.9401932619482893,38.88806707148842,123.9812947512839,1134714.4077382903,-160718.2228272567,92.0,16.0,96.0,23.39990200000011,1998.6666666666667,2010.3333333333335,2025.166666666667,2036.8333333333335,1983.8333333333335,1972.1666666666667,1957.3333333333335,0.32075471698113206,153703593.0,-1
2018-02-01,2006.0,2015.0,1985.300049,2005.699951,1978.513062,1630355.0,1962.5099975000003,1978.360901872727,105.54992700000025,82.33897334574058,-0.4853887787056339,48.22051067842176,105.11116235294027,-785378.5239888728,-189111.87288005743,96.0,12.0,60.0,18.400023999999803,2002.0,2018.699951,2031.699951,2048.399902,1989.0,1972.300049,1959.300049,0.6868665204195142,155333948.0,+1
2018-02-02,1986.0,1989.9000239999998,1941.5,1991.1500239999998,1935.636841,1836531.0,1972.5749999,1983.568179418182,100.6500239999998,70.44578208094823,-1.2447795407098223,53.074986789293916,55.78693230882876,4130043.7376283393,7213.3821430516655,96.0,8.0,60.0,29.5,1974.1833493333331,2006.8666986666663,2022.583373333333,2055.2667226666663,1958.4666746666664,1925.7833253333333,1910.0666506666666,1.025826433474496,153497417.0,-1
2018-02-05,1918.0,1935.25,1905.8499760000002,1948.0,1901.703613,1981696.0,1973.9449949999996,1979.0999976181818,13.699951000000056,47.144058124929366,-3.496868475991649,56.4030841873946,0.6389331205854075,-1496466.3776933728,-61135.69784951313,92.0,4.0,60.0,49.29992700000025,1929.699992,1953.550008,1959.1000159999996,1982.9500319999997,1924.1499840000001,1900.2999680000003,1894.7499600000003,1.4336731153688884,151515721.0,-1
2018-02-06,1860.0,1912.0,1836.300049,1913.8499760000002,1884.761841,2687451.0,1970.1099974999997,1968.173630527273,-38.34997499999986,36.20732960197972,-5.279228810020867,62.09128157952273,-47.14962651447314,-740439.4516129033,-92013.14120239453,88.0,0.0,76.0,26.950072999999747,1887.3833416666666,1938.4666343333333,1963.0832926666667,2014.1665853333334,1862.7666833333333,1811.6833906666666,1787.0667323333332,1.024438272093468,148828270.0,-1
2018-02-07,1907.0,1907.0,1862.4000239999998,1896.800049,1860.914185,2091243.0,1963.4550047999999,1954.8445489818182,-66.54992700000025,31.9389718081933,-6.16909973903967,61.33847408118231,-46.314607022257775,-214649.20087658148,-97587.50755122122,84.0,96.0,76.0,26.5,1888.7333576666667,1915.0666913333337,1933.3333336666672,1959.6666673333339,1870.4667153333335,1844.1333816666665,1825.8667393333333,0.7713014240187033,146737027.0,-1
2018-02-08,1884.0,1898.5999760000002,1866.5,1872.800049,1869.012329,1292861.0,1955.6050048000002,1938.3618297454545,-78.5,26.806356300981633,-7.421709342379962,56.29308113278353,-56.274964929255894,-312623.3335250124,-107361.86327730263,80.0,92.0,84.0,29.699951000000056,1879.3000083333336,1892.1000166666672,1911.399984333334,1924.1999926666674,1860.000040666667,1847.2000323333334,1827.9000646666668,0.19626335546169585,145444166.0,-1
2018-02-09,1847.9000239999998,1864.699951,1844.0999760000002,1880.949951,1837.761963,1602238.0,1947.9349975000002,1924.7881836000001,-76.70007299999975,31.142072051945206,-6.996349112734862,50.63700505903307,-72.7539621531694,337612.56918191584,-87135.75271097451,76.0,88.0,88.0,64.19995100000006,1863.2499593333334,1882.3999426666667,1883.8499343333335,1902.9999176666665,1861.7999676666668,1842.6499843333336,1841.199992666667,1.788835908781448,147046404.0,+1
2018-02-12,1860.0,1886.0,1855.1500239999998,1849.5,1864.7397460000002,1095277.0,1935.3900024000004,1906.8909113272728,-125.44995100000006,24.64246529444044,-8.637787056367433,44.19782470895257,-71.51718538506537,443506.7113086426,-63015.640710082815,72.0,84.0,88.0,85.3000479999996,1863.550008,1871.949992,1894.3999840000004,1902.7999680000003,1841.1000159999999,1832.7000319999997,1810.2500399999997,-0.18314516679039772,145951127.0,-1
2018-02-14,1889.800049,1897.9000239999998,1874.6500239999998,1876.6500239999998,1871.198486,894297.0,1923.0900024,1896.2109152545454,-123.0,37.61235591837832,-7.220771189979133,37.51169357547269,-52.37628560434849,237836.29613327718,-49340.55267174825,68.0,80.0,88.0,111.69995100000006,1883.0666906666665,1891.4833573333333,1906.3166906666663,1914.7333573333333,1868.2333573333333,1859.8166906666665,1844.9833573333333,0.08602150537634409,146845424.0,+1
2018-02-15,1889.699951,1894.75,1875.0,1883.1500239999998,1869.956421,1228806.0,1911.8550048,1888.949101,-112.3499760000002,40.44392240834017,-6.881522755741138,28.24127767444952,-51.75354626117767,2379547.427340037,61063.44641969663,64.0,76.0,-12.0,51.449952000000394,1884.300008,1893.6000159999999,1904.0500080000002,1913.3500159999999,1873.8500159999999,1864.550008,1854.1000159999999,0.4126594430379647,148074230.0,+1
2018-02-16,1883.9000239999998,1894.8499760000002,1875.6500239999998,1881.9000239999998,1866.6772460000002,895880.0,1899.4750121,1883.5027408545454,-123.79992700000025,40.04067265904378,-6.9467628392484455,14.457537053279111,-52.49373705555928,-853517.7300196397,19491.574763363125,60.0,72.0,-12.0,32.0999760000002,1884.1333413333332,1892.6166586666666,1903.3332933333338,1911.816610666667,1873.4167066666662,1864.9333893333328,1854.2167546666658,0.32552164713744447,147178350.0,-1
2018-02-19,1882.5999760000002,1887.5999760000002,1859.050049,1878.5999760000002,1866.2797850000002,913638.0,1888.2200073,1879.7072797454546,-112.5500479999996,38.86038969266136,-7.118999164926921,0.21158290067478447,-61.64809586839323,-1427087.432,-46262.01645315344,56.00000000000001,68.0,-12.0,28.700072999999747,1875.0833336666667,1891.1166183333335,1903.633260666667,1919.6665453333337,1862.5666913333332,1846.5334066666665,1834.016764333333,0.6847627666438545,146264712.0,-1
2018-02-20,1884.75,1885.8499760000002,1858.800049,1878.199951,1851.375,1021017.0,1881.2400023999999,1877.8854513272727,-69.80004899999994,38.7008312269444,-7.139877296450936,-16.6949999237861,-61.41559996105529,74291.51676026975,-40782.31039799783,52.0,64.0,-12.0,30.849976000000197,1874.283325333333,1889.7666016666662,1901.3332523333333,1916.8165286666665,1862.716674666666,1847.2333983333328,1835.6667476666657,0.7171887007310567,145243695.0,-1
2018-02-21,1867.949951,1868.550049,1852.199951,1863.199951,1845.611938,688268.0,1876.1749998999999,1874.6054419818183,-50.65002500000014,32.86276710048048,-7.92275829853862,-32.846808704848854,-74.36005143564947,1843859.308766926,44883.21774586241,48.0,60.0,-12.0,48.4000239999998,1861.3166503333334,1870.4333496666668,1877.6667483333335,1886.7834476666667,1854.083251666667,1844.9665523333335,1837.733153666667,0.6727788420595445,144555427.0,-1
2018-02-22,1850.0,1860.0,1841.550049,1857.4000239999998,1841.438477,3313399.0,1872.2349974000003,1871.1918099999998,-39.40002500000014,30.790505577773516,-8.22546847599166,-44.86162782323322,-81.14865873276901,274300.7459542935,55311.287209882015,44.0,56.00000000000001,-12.0,19.75,1852.9833576666667,1864.4166663333335,1871.433308666667,1882.8666173333336,1845.9667153333335,1834.5334066666667,1827.5167643333334,0.8590795173385453,141242028.0,-1
2018-02-23,1856.9000239999998,1884.8499760000002,1850.4000239999998,1853.199951,1868.6149899999998,1019187.0,1870.2749876000003,1867.7308924727274,-19.60009799999989,29.249375655841902,-7.2293654484611585,-51.066448528309365,-63.96190219875223,595937.2821484746,79885.19607072715,40.0,52.0,-12.0,19.199952000000394,1862.8166503333334,1875.233276666667,1897.2666023333338,1909.6832286666674,1840.7833246666667,1828.366698333333,1806.3333726666663,0.08127520758229853,140222841.0,-1
2018-02-26,1888.0999760000002,1914.800049,1883.550049,1880.550049,1899.418213,1197221.0,1870.2349974,1869.5990854545453,-0.399902000000111,48.58513030943543,-2.978894540503747,-54.55237665939103,-18.832227033537848,580596.2864464255,102644.79108780436,36.0,48.0,-11.999999999999993,28.549927000000253,1892.9667156666667,1902.3833823333334,1924.216715666667,1933.6333823333334,1871.1333823333334,1861.7167156666667,1839.8833823333334,-0.096,141420062.0,+1
2018-02-27,1914.75,1921.75,1900.0,1911.550049,1890.4753420000002,1196832.0,1876.4400023000003,1877.1109130181817,62.050048999999944,62.12315634957643,-0.5595913317789085,-54.70573237596136,10.41266031868155,598979.3757233485,125205.45402578365,32.0,44.0,-12.0,27.049927000000253,1911.100016333333,1922.2000326666662,1932.8500163333329,1943.9500326666662,1900.4500326666662,1889.350016333333,1878.7000326666662,0.5310367356321813,142616894.0,+1
2018-02-28,1889.550049,1895.449951,1878.0,1902.550049,1872.241699,1016591.0,1879.0300048000004,1881.8581942363637,25.90002500000014,57.087710243841244,-1.0533507612124566,-53.40392871256108,-8.378977376991667,-1317207.3782900928,59641.23437506195,28.000000000000004,40.0,-12.0,26.0,1892.0,1906.0,1909.449951,1923.449951,1888.550049,1874.550049,1871.100098,1.4068835494151168,141600303.0,-1
2018-03-01,1879.300049,1893.300049,1868.0,1884.199951,1862.4542239999998,977460.0,1879.1349975000003,1882.7981844545454,1.0499270000002525,47.94506027154167,-2.0600767521601946,-46.86673890712564,-15.211085084969127,-171576.2422256751,49131.34907502844,24.0,36.0,-12.000000000000007,21.64990200000011,1881.8333333333333,1895.6666666666665,1907.1333823333334,1920.9667156666665,1870.3666176666666,1856.5332843333333,1845.0665686666666,0.6403130286427544,140622843.0,-1
2018-03-05,1874.1500239999998,1878.0,1858.25,1874.3499760000002,1858.082153,945366.0,1878.3799927000002,1881.9281805454548,-7.550047999999606,43.61848110799818,-2.600467645041822,-43.28606404817924,-24.2422904263639,-2119314.163776721,-49434.3560545966,20.0,32.0,-12.0,34.449952000000394,1870.199992,1882.1499840000001,1889.9499919999998,1901.8999840000001,1862.3999840000001,1850.449992,1842.6499840000001,0.8151886582278581,139677477.0,-1
2018-03-06,1870.0,1879.9000239999998,1839.5,1869.949951,1834.532593,1144207.0,1877.5149902000003,1880.3954456909094,-8.650025000000142,41.67985137299774,-2.841862515429979,-41.363407001594624,-29.300201605751262,-226067.64705882355,-57463.142009334195,16.0,28.000000000000004,-12.0,61.60009799999989,1863.1166583333331,1886.7333166666663,1903.516682333333,1927.133340666666,1846.3332926666665,1822.7166343333333,1805.9332686666667,0.7537112106666126,138533270.0,-1
2018-03-07,1840.0,1853.4000239999998,1828.5,1846.25,1820.969238,1407041.0,1874.3199951000001,1874.7109020181817,-31.949951000000056,32.65867615165891,-4.14209299135921,-39.45484863703905,-63.08603336906248,212684.60367928314,-45183.69902348795,12.0,24.0,-12.0,41.199951000000056,1842.7166746666664,1856.933349333333,1867.6166986666663,1881.8333733333327,1832.033325333333,1817.8166506666666,1807.1333013333333,0.7128507185374657,137126229.0,-1
2018-03-08,1839.800049,1858.5,1832.0,1832.5999760000002,1841.090698,1379681.0,1871.2599976000001,1867.125444,-30.59997499999986,28.55186021164012,-4.890962776025226,-36.374454573730645,-64.00692541095044,-1559868.89451145,-114033.02609112265,8.0,96.0,-11.999999999999996,33.550048999999944,1841.0333253333336,1850.066650666667,1867.5333253333338,1876.566650666667,1823.566650666667,1814.5333253333336,1797.066650666667,0.02264060377359234,135746548.0,-1
2018-03-09,1854.949951,1865.25,1844.0,1852.8499760000002,1839.3022460000002,1027027.0,1870.8049928000003,1863.7781673454547,-4.550047999999606,41.207116453993635,-3.7800040597997424,-31.16859253711732,-36.00262536890723,1939810.0583000078,-20676.5222551621,4.0,92.0,-12.0,34.550048999999944,1854.0333253333336,1864.066650666667,1875.2833253333338,1885.316650666667,1842.816650666667,1832.7833253333336,1821.566650666667,0.4164694588235387,136773575.0,+1
2018-03-12,1860.199951,1869.449951,1853.4000239999998,1851.050049,1855.3992920000003,1639279.0,1870.5900026000002,1860.1863593818182,-2.149902000000111,40.47190637908923,-3.8787519407488715,-24.005980185298313,-27.552843484201254,331457.75504726655,-4670.418741415333,0.0,88.0,-12.0,25.949951000000056,1857.966674666667,1862.533325333334,1874.016601666667,1878.5832523333343,1846.4833983333338,1841.9167476666667,1830.4334713333335,-0.14641655379490645,135134296.0,-1
2018-03-13,1867.449951,1884.75,1855.0,1867.25,1848.4437260000002,1281050.0,1869.2599977000004,1859.5790861818182,-13.300048999999944,49.77750335101709,-2.9899876560142644,-14.651592014868129,-4.528076889847653,148330.43805509424,2284.165658426017,0.0,84.0,-12.000000000000004,40.4000239999998,1869.0,1883.0,1898.75,1912.75,1853.25,1839.25,1823.5,0.4117647058823529,136415346.0,+1
2018-03-14,1856.0,1867.9000239999998,1848.0,1860.25,1852.666748,920098.0,1864.1299928000003,1857.9409047818183,-51.300048999999944,46.178407120382104,-3.374022767795913,-5.318564309988233,-32.99716669620648,-2045630.0488313846,-90802.8440911109,0.0,80.0,-12.0,41.449951000000056,1858.7166746666664,1869.433349333333,1878.6166986666663,1889.3333733333327,1849.533325333333,1838.8166506666666,1829.6333013333333,0.6155771470426429,135495248.0,-1
2018-03-15,1865.199951,1887.5,1865.199951,1864.5,1868.863403,1467731.0,1860.3249879000002,1858.0081788181815,-38.050048999999944,48.773164033416435,-3.140858592785626,-2.02051067672096,7.405176024539819,-1159098.2274542875,-139361.72515307352,56.00000000000001,76.0,-88.0,26.5,1872.399983666667,1879.6000163333338,1894.700032666667,1901.9000653333337,1857.2999673333338,1850.099934666667,1834.9999183333339,-0.03138786825087502,136962979.0,+1
2018-03-16,1880.0,1881.0999760000002,1846.550049,1880.800049,1841.2397460000002,1974084.0,1859.9849977000001,1861.7309172,-3.399902000000111,57.7805810459566,-2.246602715676865,-4.838210598836895,0.5039659523140742,5120442.065080139,99720.26531207269,52.0,72.0,-88.0,32.6500239999998,1869.4833580000002,1892.4166670000004,1904.0332850000004,1926.9665940000007,1857.8667400000002,1834.933431,1823.316813,0.9913190265206566,138937063.0,+1
2018-03-19,1853.0,1860.0,1843.1500239999998,1853.0,1835.526245,1959685.0,1857.8500001000002,1860.460917618182,-21.349976000000197,42.926830683538896,-3.771773419284049,-8.554377634745151,-80.33171374523671,-1989804.804611794,4741.853042805952,48.0,68.0,-88.0,16.59997499999986,1852.050008,1860.949992,1868.8999840000004,1877.7999680000003,1844.1000159999999,1835.2000319999997,1827.2500399999997,0.5845691412260814,136977378.0,-1
2018-03-20,1845.0999760000002,1855.9000239999998,1835.25,1847.25,1827.825439,914343.0,1855.5800050000003,1858.533644872727,-22.699951000000056,40.44544633607715,-4.08723083253326,-11.764103602638215,-102.24330405160201,793779.8585877465,40607.21693121237,44.0,64.0,-84.0,33.699951000000056,1846.1333413333332,1857.0166826666664,1866.7833653333328,1877.6667066666662,1836.3666586666666,1825.4833173333334,1815.7166346666668,0.5811131260670745,136063035.0,-1
2018-03-21,1848.0,1863.199951,1843.300049,1839.5,1847.1024170000003,1480285.0,1854.9050049999998,1855.6100076,-6.75,37.10940820424655,-3.1144731290095407,-13.588600531214297,-77.73125565276499,882815.7765687474,78889.424187464,40.0,60.0,-80.0,19.900023999999803,1848.6666666666667,1854.0332843333335,1868.5665686666666,1873.9331863333337,1834.1333823333334,1828.7667646666666,1814.2334803333333,-0.19095817657795117,134582750.0,-1
2018-03-22,1858.9000239999998,1880.0,1855.0999760000002,1858.9000239999998,1855.896118,1668306.0,1857.5350098000001,1856.336374690909,26.300047999999606,49.209582539562916,-1.9171835289851316,-16.514211825076018,-2.3812407879424415,-1372563.0443406752,12914.311981639434,36.0,56.00000000000001,-19.999999999999993,27.25,1864.6666666666667,1874.2333573333333,1889.5666906666668,1899.133381333333,1849.3333333333335,1839.766642666667,1824.4333093333337,0.15261222238177907,136251056.0,+1
2018-03-23,1846.6500239999998,1853.0999760000002,1837.25,1867.75,1829.862549,1797538.0,1859.0250122,1858.1936456363635,14.900023999999803,53.880266360667385,-1.1042773273693038,-14.325054309660118,-59.15146463730657,1783217.149596006,93382.62278229253,32.0,52.0,-20.0,34.54992700000025,1852.699992,1868.1499840000001,1868.5499680000003,1883.9999600000003,1852.300008,1836.8500159999999,1836.4500319999997,1.9242931345763312,138048594.0,+1
2018-03-26,1839.9000239999998,1900.0,1833.5,1841.550049,1881.432983,2625442.0,1858.0750122,1855.0163796000002,-9.5,41.000812614748064,-3.2454164908384264,-10.26353280026774,-31.786362604514096,567103.2766654092,114915.37977697968,28.000000000000004,48.0,-20.0,37.65002500000014,1858.350016333333,1883.2000326666662,1924.8500163333329,1949.7000326666662,1816.7000326666662,1791.850016333333,1750.2000326666662,0.1210533684210518,135423152.0,-1
2018-03-27,1893.800049,1899.0,1876.0,1893.449951,1880.5883789999998,1534209.0,1860.6950073,1861.4481866545455,26.199951000000056,61.8464949917399,-0.3636895613547998,-7.5367393722392535,125.52821264830828,-1924155.6006280985,22230.33521311241,24.0,44.0,-20.0,20.650023999999803,1889.4833170000002,1902.9666340000003,1912.4833170000002,1925.9666340000003,1879.9666340000003,1866.4833170000002,1856.9666340000003,0.7586935217391328,136957361.0,+1
2018-03-28,1882.949951,1899.699951,1876.050049,1892.5999760000002,1874.129639,2209377.0,1863.9300049000003,1867.2490900545456,32.3499760000002,61.436307218628414,-0.41088417545806794,-4.539672231086797,137.04549597349848,-650777.1446036061,-8360.913869465729,20.0,40.0,-20.0,19.89990200000011,1889.449992,1902.8499350000002,1913.0998940000004,1926.4998370000003,1879.200033,1865.80009,1855.550131,0.6997883965861751,134747984.0,-1
2018-04-02,1890.5,1935.75,1890.5,1886.0999760000002,1918.9434809999998,1149092.0,1866.0900025,1871.2799938909093,21.599976000000197,58.03968108014207,-2.7031454471212633,-3.7794163953110456,220.17307593173368,-453525.049350988,-28595.64730044403,16.0,36.0,-20.000000000000007,40.5,1904.1166586666668,1917.7333173333336,1949.3666586666668,1962.9833173333336,1872.4833173333336,1858.8666586666668,1827.2333173333336,-0.09723809944750945,133598892.0,-1
2018-04-03,1923.949951,1925.699951,1911.0,1931.199951,1903.7406010000002,1019971.0,1871.1299927000002,1883.1181663454545,50.39990200000011,70.9138609214506,-0.24772282564311665,-1.7397420777836032,275.1218823143619,1110617.7304163333,23186.778959409527,96.0,32.0,-20.0,21.650023999999803,1922.6333006666666,1934.2666013333333,1937.333251666667,1948.9665523333333,1919.5666503333332,1907.9333496666666,1904.8666993333331,1.3741509070336342,134618863.0,+1
2018-04-04,1912.949951,1924.949951,1878.449951,1915.9000239999998,1871.297852,928527.0,1877.4199951,1891.258172036364,62.9000239999998,63.310314114984,-1.0807119096229862,-0.7848249527573898,152.2647435607929,801268.9353314189,58554.14970359179,92.0,28.000000000000004,-19.999999999999996,66.5,1906.4333086666666,1934.416666333333,1952.9333086666666,1980.916666333333,1887.916666333333,1859.9333086666666,1841.416666333333,0.8053779139784892,133690336.0,-1
2018-04-05,1901.300049,1914.0,1890.199951,1883.25,1896.785034,1214723.0,1881.0199951000002,1892.3181729272728,36.0,50.08671453011891,-2.8583095140873827,-3.086833134796507,89.62177210488039,-48002.03705122487,53710.68666928194,88.0,24.0,-20.0,57.449951000000056,1895.8166503333334,1901.4333496666668,1919.6166993333331,1925.2333986666667,1877.6333006666669,1872.0166013333335,1853.833251666667,-0.29201414669356657,132475613.0,-1
2018-04-06,1912.199951,1926.449951,1905.800049,1908.9000239999998,1911.192993,930002.0,1887.9599975000003,1897.3872690909093,69.4000239999998,58.03255635594825,-1.4618198448346371,0.8402145183968059,132.16083736118472,-59154.90509744226,48580.4324980672,84.0,20.0,-20.0,23.64990200000011,1913.7166746666664,1921.633300333333,1934.3665766666668,1942.283202333333,1900.9833983333328,1893.0667726666663,1880.3334963333327,0.15012056715813188,133405615.0,+1
2018-04-09,1918.800049,1942.0,1916.4000239999998,1923.4000239999998,1926.7436519999999,1000884.0,1894.4099975000001,1903.8309102727271,64.5,61.98039580447156,-1.0092227889311012,8.311916867460468,143.2701338581601,-468719.7765924244,25066.78663031757,80.0,16.0,-20.0,45.25,1927.2666826666664,1938.133341333333,1952.8666586666666,1963.7333173333332,1912.5333653333328,1901.6667066666662,1886.9333893333326,0.27343775634789447,134406499.0,+1
2018-04-10,1943.0,1943.0,1913.5,1939.050049,1908.65918,1516809.0,1901.5400024,1911.9472832727272,71.30004899999994,65.96732064464246,-0.2142055856833002,17.368940890715066,125.97993891826272,-35519.37009035464,22312.870415741556,96.0,12.0,64.0,39.59997499999986,1931.850016333333,1950.2000326666662,1961.3500163333329,1979.7000326666662,1920.7000326666662,1902.350016333333,1891.2000326666662,0.8661033559322016,135923308.0,+1
2018-04-11,1915.9000239999998,1920.0,1905.4000239999998,1920.8499760000002,1906.671875,717703.0,1909.4699951,1915.4581875636363,79.29992700000025,57.82986495969985,-1.2011943600867572,22.853758451569774,71.03690111446309,388976.8370594896,38979.41435409375,96.0,8.0,64.0,52.75,1915.4166666666667,1925.4333093333337,1930.0166426666672,1940.0332853333339,1910.8333333333335,1900.8166906666665,1896.2333573333333,1.0582176299468016,135205605.0,-1
2018-04-12,1916.0,1932.9000239999998,1905.9000239999998,1918.8499760000002,1916.558716,1178129.0,1912.0099976000001,1917.1636386363637,25.40002500000014,56.93927762002744,-1.3096542299349134,26.93311750684893,72.07550376140995,-845973.4064685401,-1245.7138651169116,92.0,4.0,64.0,25.700072999999747,1919.2166746666664,1932.533325333333,1946.2166746666664,1959.533325333333,1905.533325333333,1892.2166746666664,1878.533325333333,0.47962785185186646,134027476.0,-1
2018-04-13,1928.0,1940.0,1919.0999760000002,1928.800049,1912.7828370000002,824293.0,1915.6300049000001,1920.2163752545455,36.20007299999975,60.436795755210156,-0.7700624186551006,35.180815552398144,83.5241059960767,-1228988.2985788027,-57052.19498846632,88.0,0.0,64.0,43.199951000000056,1929.3000083333336,1939.500040666667,1950.2000323333334,1960.4000646666668,1918.6000166666672,1908.3999843333338,1897.6999926666674,0.46411779240061346,134851769.0,+1
2018-04-16,1920.0,1950.0,1919.8499760000002,1925.0,1929.7742920000003,711936.0,1919.5200073,1921.9200107272727,38.9000239999998,58.34837376941877,-1.3506212857914641,35.25686789150859,75.47625105164882,2336953.22817651,51766.233337214515,84.0,0.0,64.0,33.0999760000002,1931.6166586666668,1943.3833413333334,1961.7666826666666,1973.5333653333332,1913.2333173333336,1901.466634666667,1883.0832933333338,0.17081326369756245,134139833.0,-1
2018-04-17,1943.5,1951.0,1934.0999760000002,1942.0999760000002,1936.1336670000003,666958.0,1920.6100098000002,1926.0254595818183,10.900025000000142,64.68465555871134,-0.4805628509719116,35.19703365987425,84.95380303373172,-145642.05314672715,42793.12940612625,96.0,44.0,84.0,29.5,1942.3999840000004,1950.6999920000005,1959.3000080000004,1967.6000160000003,1933.7999680000007,1925.4999600000006,1916.899944000001,0.47337210882067937,134806791.0,+1
2018-04-18,1951.0,1953.5,1930.050049,1948.5,1920.334595,678180.0,1923.8700073999998,1931.096366890909,32.5999760000002,66.86169745860619,-0.26961445133459155,37.73542774527755,73.64047777938595,773190.7692307692,75993.02212542824,96.0,40.0,88.0,33.65002500000014,1944.0166829999998,1957.9833169999997,1967.4666339999999,1981.4332679999998,1934.5333659999997,1920.5667319999998,1911.0834149999996,0.7867799382608524,135484971.0,+1
2018-04-19,1940.0,1944.800049,1933.0,1932.5999760000002,1926.69397,792258.0,1928.8050050000002,1932.683633909091,49.3499760000002,56.82075604024018,-1.1269897007279484,33.70444961490102,51.516764675103786,-628217.2147053165,43983.46590584891,96.0,36.0,88.0,27.0,1936.8000083333334,1940.6000166666668,1948.600057333333,1952.4000656666667,1928.7999676666668,1924.9999593333334,1916.9999186666669,-0.03390019821102479,134692713.0,-1
2018-04-20,1941.0,1961.0,1932.1500239999998,1939.0,1943.4866940000002,2340345.0,1931.8150026000003,1934.5372693636364,30.099976000000197,59.636041974758584,-1.1815252416756177,32.840945651185166,55.20946214176593,784919.5652173912,77662.37951091904,92.0,32.0,88.0,21.150023999999803,1944.050008,1955.949992,1972.8999840000004,1984.7999680000003,1927.1000159999999,1915.2000319999997,1898.2500399999997,0.23743437429549855,137033058.0,+1
2018-04-23,1979.0,1979.0,1860.300049,1955.9000239999998,1923.4646,3826155.0,1935.0650026000005,1938.9163641636362,32.5,66.32564553448913,-1.228722127659585,36.698701337523744,29.414431347448907,-1631074.462284628,-7.476934333162558,96.0,28.000000000000004,84.0,30.150023999999803,1931.7333576666667,2003.1666663333335,2050.433308666667,2121.8666173333336,1884.4667153333335,1813.0334066666667,1765.7667643333334,0.8053918657472724,140859213.0,+1
2018-04-24,1935.0,1948.050049,1926.0,1935.75,1922.71936,1259354.0,1934.7349977000003,1939.0409091454544,-3.3000489999999445,54.010928622135644,-2.3005319148936167,37.1751429322901,32.86049338829604,-1963601.589025756,-89261.75475667065,96.0,24.0,52.0,26.0,1936.600016333333,1947.2000326666662,1958.6500653333333,1969.2500816666661,1925.1499836666662,1914.5499673333331,1903.0999346666663,0.4421758881352157,139599859.0,-1
2018-04-25,1927.9000239999998,1938.0,1912.0,1935.0,1908.559814,1005148.0,1936.1500001000004,1939.0890913818182,14.150023999999803,53.58365226579029,-2.3404255319148937,36.77635643319218,11.953686495205606,650216.3591064261,-55649.11321743896,92.0,20.0,56.0,23.449951000000056,1928.3333333333333,1944.6666666666665,1954.333333333333,1970.6666666666665,1918.6666666666665,1902.3333333333333,1892.6666666666665,0.8846153846153846,138594711.0,-1
2018-04-26,1916.800049,1939.199951,1911.25,1920.75,1917.999512,1961870.0,1936.3400025000003,1936.2890913636363,1.900023999999803,45.66405340874737,-3.098404255319149,32.07109904583376,0.016382812058945338,-1488077.3897110377,-120759.48942169349,88.0,16.0,60.0,15.5,1923.7333170000002,1936.2166340000003,1951.6832680000002,1964.1665850000004,1908.2666830000003,1895.7833660000001,1880.3167320000002,0.3398932613513341,136632841.0,-1
2018-04-27,1933.0,1935.5,1912.5,1930.25,1911.192993,1444252.0,1936.4849976000003,1935.1818181818182,1.4499510000000555,51.210947848449095,-2.5930851063829787,29.58784206328596,1.134037278931577,1572807.2233234323,-43779.18429691498,84.0,12.0,60.0,28.849976000000197,1926.0833333333333,1939.6666666666665,1949.083333333333,1962.6666666666665,1916.6666666666665,1903.0833333333333,1893.6666666666665,0.7717391304347826,138077093.0,+1
2018-04-30,1930.0,1954.800049,1928.800049,1923.4000239999998,1931.960327,1152388.0,1936.3250000000003,1932.802732072727,-1.599976000000197,47.20194887316783,-2.957445531914904,26.706475197232294,20.718839604999584,1424323.2861363688,22952.746177325243,80.0,8.0,68.0,118.69995100000006,1935.666707333333,1942.5333656666662,1961.6667073333333,1968.5333656666662,1916.5333656666662,1909.666707333333,1890.5333656666662,-0.20769326923077466,136924705.0,-1
2018-05-02,1950.0,1978.0,1946.0,1944.300049,1957.000366,1775012.0,1936.5450073000004,1934.2527409818183,2.2000729999997475,58.60923318470995,-1.8457420744680881,24.134215820127793,74.35256544607932,-113289.39685024267,16759.92149425397,76.0,4.0,72.0,29.900023999999803,1956.100016333333,1966.2000326666662,1988.1000163333329,1998.2000326666662,1934.2000326666662,1924.100016333333,1902.2000326666662,-0.053123468750001734,138699717.0,+1
2018-05-03,1968.050049,1974.9000239999998,1946.0,1969.5,1955.410522,1038193.0,1938.6450073000003,1940.2445578363634,21.0,68.17523360484469,-0.5053191489361702,23.284890468229833,87.60045614642412,-2552266.4435256883,-100014.00418847078,72.0,0.0,72.0,26.0,1963.4666746666664,1980.933349333333,1992.3666986666663,2009.8333733333327,1952.033325333333,1934.5666506666666,1923.1333013333333,0.8131481136486309,139737910.0,+1
2018-05-04,1970.0,1990.0,1966.300049,1967.9000239999998,1975.879761,1720359.0,1942.1750121000002,1945.5636517818182,35.300047999999606,67.0401609782158,-1.1686925436277207,18.431645976161917,107.91578664981702,-859717.6644569623,-134545.9887461295,68.0,68.0,72.0,27.949951000000056,1974.7333576666667,1983.1666663333335,1998.433308666667,2006.8666173333336,1959.4667153333335,1951.0334066666667,1935.7667643333334,0.06750963324775881,138017551.0,-1
2018-05-07,1981.6500239999998,1987.300049,1975.0,1988.5,1964.8503420000002,1316032.0,1947.1250121000003,1953.9863768545451,49.5,73.57594428741605,-0.07932310946589106,16.327013724672724,122.62951155219282,-1288495.9743327687,-186998.2608182495,96.0,64.0,72.0,23.0,1983.600016333333,1992.2000326666662,1995.9000653333333,2004.5000816666661,1979.8999836666662,1971.2999673333331,1967.5999346666663,1.097556603229797,139333583.0,+1
2018-05-08,1979.25,1979.9000239999998,1954.5999760000002,1977.4000239999998,1954.56604,1775141.0,1949.2750121,1959.4909244727273,21.5,65.50059956765254,-0.6663128503437439,16.139910933407236,79.44415372035563,-3091678.0765246884,-319029.16153217864,92.0,60.0,72.0,26.0,1970.6333413333332,1986.6667066666662,1995.9333893333326,2011.9667546666658,1961.3666586666666,1945.3332933333336,1936.066610666667,0.9011859582242674,137558442.0,-1
2018-05-09,1956.1500239999998,1980.5,1956.1500239999998,1967.050049,1965.843994,1081833.0,1952.405017,1962.7227493636362,31.300048999999944,58.58290622123763,-1.2136409836065603,14.516564137123396,70.43366453889384,507485.9717217384,-281460.29183881875,88.0,56.00000000000001,72.0,54.5999760000002,1967.9000243333332,1979.6500246666667,1992.2500003333332,2004.000000666667,1955.3000486666665,1943.550048333333,1930.9500726666663,0.44764007159596597,136476609.0,-1
2018-05-10,1988.5999760000002,1999.0,1982.0,1978.4000239999998,1980.0531010000002,1792918.0,1956.7450194,1967.4491142727272,43.4000239999998,63.465223480306804,-1.084209263157905,13.650027467012478,119.3816190075542,-530584.7134516861,-292784.1291848582,84.0,52.0,72.0,30.59997499999986,1986.4666746666664,1990.933349333333,2003.4666746666662,2007.933349333333,1973.933349333333,1969.4666746666664,1956.933349333333,-0.21176329411765865,138269527.0,+1
2018-05-11,1992.699951,2017.0,1986.0,1992.699951,1998.9823,1514267.0,1963.9400144999997,1973.9863745636362,71.94995100000006,68.81019985395537,-1.2669472888425415,15.052483441112145,139.6071611642987,1679684.4678501773,-203126.4656832656,96.0,48.0,0.0,23.699951000000056,1998.5666503333334,2011.1333006666669,2029.5666503333332,2042.1333006666669,1980.1333006666669,1967.5666503333334,1949.1333006666669,0.216127451612905,139783794.0,+1
2018-05-14,2017.199951,2027.4000239999998,2012.4000239999998,2011.75,2008.918823,1185729.0,1972.0900144999998,1982.6790991999999,81.5,74.53643011737286,-0.8115548540358142,15.25951071135637,172.96290204456918,598211.5550883764,-166702.01019364546,96.0,44.0,32.0,19.40002500000014,2017.1833493333331,2021.9666746666664,2032.1833493333331,2036.9666746666664,2006.9666746666664,2002.1833493333331,1991.9666746666664,-0.0433349333333202,140969523.0,+1
2018-05-15,2027.050049,2065.0,2026.699951,2021.75,2024.866943,2456671.0,1981.9250120999998,1991.7081874727273,98.3499760000002,77.08463743546625,-2.1998982706002037,19.678768450628468,190.19583007992134,-464591.16946560435,-180242.42652418904,96.0,40.0,32.0,33.9000239999998,2037.8166503333334,2048.933349666667,2076.116699333333,2087.2333986666667,2010.6333006666669,1999.5166013333335,1972.333251666667,-0.12924137512200212,143426194.0,+1
2018-05-16,2030.550049,2049.0,2017.1500239999998,2037.800049,2010.5086670000003,1710401.0,1991.2750121,2001.8672850909088,93.5,80.6674833497151,-1.383517344862668,24.695280336354017,147.98891364600212,1047950.8074696369,-124415.46134265146,96.0,36.0,31.999999999999993,24.349976000000197,2034.6500243333332,2052.1500246666665,2066.5000003333334,2084.000000666667,2020.3000486666665,2002.800048333333,1988.4500726666663,0.6483529218357971,145136595.0,+1
2018-05-17,2023.8499760000002,2044.449951,2012.5,2023.3499760000002,2014.8807370000002,1653869.0,1996.6600096999998,2007.699096709091,53.8499760000002,69.39608154233763,-2.118515971515758,31.97201163781415,107.04672732997803,-386729.23876208166,-136338.81486171647,92.0,32.0,32.0,31.949951000000056,2026.7666423333333,2041.0332846666665,2058.7165933333335,2072.9832356666666,2009.0833336666665,1994.8166913333332,1977.1333826666664,0.33959288388267567,143482726.0,-1
2018-05-18,2024.699951,2024.699951,2003.5,2027.75,1999.379761,1304365.0,2002.6450072999999,2013.351822218182,59.8499760000002,70.82818937625314,-1.89471007121058,36.033855017030646,75.721310685083,-1545500.91760726,-200391.63771378668,88.0,28.000000000000004,48.0,38.5999760000002,2018.649983666667,2033.7999673333338,2039.8499346666667,2054.999918333334,2012.6000163333338,1997.4500326666669,1991.4000653333337,1.1438705683800843,144787091.0,+1
2018-05-21,2016.0999760000002,2021.0,1986.050049,2012.1500239999998,1980.4010010000002,1212027.0,2005.0100097,2015.0800070727273,23.650023999999803,59.44792885005975,-2.6881981688708136,36.537439811593,46.43084756093237,-1126198.174924562,-242473.75304154924,84.0,24.0,52.0,34.70007299999975,2006.4000243333332,2026.7499996666666,2041.349975333333,2061.6999506666666,1991.8000486666665,1971.4500733333332,1956.8500976666664,0.7467814475619671,143575064.0,-1
2018-05-22,1998.699951,2013.949951,1985.5,1993.050049,1977.2709960000002,990093.0,2006.5750122000002,2012.9054687636362,15.650025000000142,48.45029480967276,-3.6597126653102774,37.644614333256186,26.705748588252355,101656.05677052909,-226831.48895918205,80.0,20.0,56.0,53.25,1997.5,2009.5,2025.949951,2037.949951,1981.050049,1969.050049,1952.600098,0.26538003527668397,142584971.0,-1
2018-05-23,1987.800049,1994.0,1963.4000239999998,1989.9000239999998,1955.013062,1431573.0,2008.8600097000003,2009.8736527272727,22.84997499999986,46.80265552237395,-3.819937741607334,35.72593635949943,0.9045273185187144,-135934.48461695344,-222699.80694362623,76.0,16.0,60.0,31.849976000000197,1982.4333493333331,2001.4666746666664,2013.0333253333336,2032.0666506666666,1970.8666986666663,1951.833373333333,1940.266722666666,0.8660137511218907,141153398.0,-1
2018-05-24,1967.0999760000002,1990.25,1956.3499760000002,1967.5,1973.39563,1130186.0,2007.7700073,2002.3536509636363,-10.900023999999803,36.59235609460045,-4.959308240081384,35.8733634502687,-20.062890282465677,-17750901.388494927,-1019436.2424686861,72.0,12.0,60.0,31.949951000000056,1971.3666586666668,1986.3833413333334,2005.2666826666666,2020.2833653333332,1952.4833173333336,1937.466634666667,1918.5832933333338,0.32890902968091906,140023212.0,-1
2018-05-25,1990.0,2016.0,1989.9000239999998,1986.0,1995.9515379999998,1189897.0,2007.1000122,1998.3954678181817,-6.6999510000000555,47.50556358223324,-4.018311291963377,38.47760257401342,16.044252483119138,5702277.24031834,-713903.811432912,68.0,8.0,60.0,21.199951000000056,1997.300008,2004.699992,2023.3999840000004,2030.7999680000003,1978.6000159999999,1971.2000319999997,1952.5000399999997,-0.14942634430007803,141213109.0,+1
2018-05-28,2007.800049,2052.0,2006.0,2008.699951,2029.239014,1275985.0,2006.7950073,1998.6863657818183,-3.0500489999999445,57.79089019382166,-2.863685096642927,39.36720426980128,52.84165314735113,4894843.134628522,-458960.76843011944,64.0,4.0,60.0,41.699951000000056,2022.2333170000002,2038.4666340000003,2068.233317,2084.4666340000003,1992.4666340000003,1976.2333170000002,1946.4666340000003,0.058694586956522944,142489094.0,+1
2018-05-29,2038.0,2052.699951,2028.800049,2042.199951,2019.699951,837811.0,2008.8400024000002,2005.123628272727,20.449951000000056,68.35034661217873,-1.159717650050862,39.72819718465166,77.14632265395304,238382.17039457505,-427263.362119906,60.0,0.0,60.0,28.449951000000056,2041.2333170000002,2053.6665850000004,2065.1332190000003,2077.5664870000005,2029.7666830000003,2017.333415,2005.8667810000002,0.5606676546205105,143326905.0,+1
2018-05-30,2019.699951,2053.0,2016.300049,2032.5999760000002,2035.3500980000001,1216749.0,2008.3199951000001,2009.4436234727273,-5.2000729999997475,63.128389719570634,-1.6480174974567547,38.40459191880291,55.38299215500398,2149088.595109018,-310156.45497313666,56.00000000000001,8.0,60.0,30.599976000000197,2033.966675,2051.633301,2070.6666259999997,2088.333252,2014.9333499999998,1997.2667239999998,1978.2333989999997,0.4441402932663378,142110156.0,-1
2018-05-31,2100.0,2160.0,2080.0,2048.350098,2139.449951,9909798.0,2010.8200073000003,2016.7218239999997,25.000121999999692,67.78727252981803,-5.417268413391563,34.787333280934945,152.6141267574001,-1816884.5306170222,-378644.0947751315,52.0,4.0,60.0,33.9000239999998,2096.116699333333,2112.2333986666663,2176.1166993333336,2192.2333986666663,2032.2333986666663,2016.1166993333331,1952.2333986666663,-0.3956237750000014,152019954.0,+1
2018-06-01,2116.0,2138.0,2101.0,2139.449951,2110.600098,5287839.0,2021.9900024000003,2040.109086490909,111.69995100000006,82.52422691457951,-0.9970911693352714,31.055389041414855,178.40160242637353,1657060.8711712065,-286112.0508684797,96.0,0.0,60.0,48.5,2126.1499836666667,2151.2999673333334,2163.1499836666662,2188.2999673333334,2114.2999673333334,2089.1499836666667,2077.2999673333334,1.0391878648648665,157307793.0,+1
2018-06-04,2150.0,2157.0,2037.949951,2110.600098,2046.199951,22199081.0,2031.8350098,2056.2200129636362,98.45007400000009,70.7046471610967,-2.3968899563318833,27.740729847524563,119.56950185612423,-223880.1375586687,-283283.32753621554,92.0,0.0,60.0,66.0,2101.8500163333333,2165.7500816666666,2220.9000653333337,2284.8001306666665,2046.7000326666666,1982.7999673333334,1927.6499836666667,0.6102487786460287,135108712.0,-1
2018-06-05,2050.0,2066.949951,2023.0,2046.199951,2063.600098,4276365.0,2037.1500000000003,2058.8318204545453,53.14990200000011,51.65060427085087,-5.521593837942743,22.790658117825615,29.567748509356555,-594793.5990601777,-297442.8853327593,88.0,0.0,60.0,44.0,2045.3833006666666,2067.7666013333333,2089.333251666667,2111.7165523333333,2023.8166503333332,2001.4333496666666,1979.8666993333331,0.5278720561030893,130832347.0,-1
2018-06-06,2060.199951,2064.800049,2045.0,2063.600098,2057.350098,2445500.0,2044.5200074,2063.640929181818,73.70007400000009,55.39782425175294,-4.6773363415817615,19.901005271788108,44.913030186462805,565971.5487396608,-258196.7746931038,84.0,0.0,48.00000000000001,36.699951000000056,2057.800049,2070.600098,2077.600098,2090.400147,2050.800049,2038.0,2031.0,0.939396564119611,133277847.0,+1
2018-06-07,2073.199951,2079.800049,2053.199951,2057.350098,2062.199951,2640974.0,2053.5050172,2065.9736729272727,89.85009799999989,53.67375339096205,-4.9805871906841395,20.96619860929104,50.432124715819604,-1502343.1062805767,-314748.88067435264,80.0,0.0,48.0,127.4000239999998,2063.4500326666666,2073.700114333333,2090.050130666667,2100.300212333333,2047.1000163333333,2036.8499346666667,2020.4999183333334,0.15601998909928266,130636873.0,-1
2018-06-08,2059.0,2061.25,2035.0,2062.199951,2049.350098,1545222.0,2061.1250123,2067.554569981818,76.19995100000006,54.92963849616414,-4.745271664240657,24.56934042764351,28.528640568027217,2228600.1271025967,-199142.10759358213,76.0,8.0,96.0,89.64990200000011,2052.8166503333337,2070.6333006666673,2079.066650333334,2096.8833006666673,2044.3833006666673,2026.5666503333337,2018.1333006666673,1.0361886095238115,132182095.0,+1
2018-06-11,2051.899902,2062.949951,2038.800049,2049.350098,2042.300049,1772797.0,2065.190027,2065.4136764727273,40.65014699999983,50.725592897858576,-5.3687482775351825,31.49225393985057,21.89173709632208,712179.3826862867,-157718.4034899517,72.0,4.0,92.0,119.05004899999994,2050.366699333333,2061.9333496666663,2074.5166013333333,2086.0832516666665,2037.7834476666662,2026.216797333333,2013.6335456666661,0.4368568038081437,130409298.0,-1
2018-06-12,2051.899902,2052.699951,2038.4000239999998,2042.300049,2043.8499760000002,1308564.0,2065.2000368,2061.2518622909092,0.100097999999889,48.38146360466728,-5.710817612809318,37.73871072336374,10.786720349090933,-2783779.936290212,-277084.8367990545,68.0,0.0,88.0,87.60009799999989,2044.466674666667,2050.533325333334,2058.766601666667,2064.8332523333343,2036.2333983333338,2030.1667476666667,2021.9334713333335,0.27273041323917757,129100734.0,-1
2018-06-13,2052.0,2054.800049,2024.0999760000002,2043.8499760000002,2031.449951,1974490.0,2066.3250368,2057.3700330545453,11.25,48.97955245876275,-5.635614944201834,40.79246142367174,3.7108387671762815,-2468648.727272727,-376701.3772751306,64.0,0.0,84.0,19.800048999999944,2040.9166670000002,2057.7333580000004,2071.6167399999995,2088.433431,2027.0332850000004,2010.2165940000004,1996.3332120000007,0.643320945849222,131075224.0,+1
2018-06-14,2030.0,2045.0,2025.0,2031.449951,2037.4000239999998,4231894.0,2064.6350221,2051.0291083636366,-16.900146999999833,44.24692478886414,-6.237265841824354,38.53408866795871,-9.927369890620318,-789351.3615470685,-395458.19474203687,60.0,40.0,80.0,26.60009799999989,2033.8166503333334,2042.6333006666669,2053.816650333333,2062.633300666667,2022.6333006666669,2013.8166503333334,2002.6333006666669,0.3224975500000028,126843330.0,-1
2018-06-15,2026.0,2038.9000239999998,2022.300049,2037.4000239999998,2029.5999760000002,2720204.0,2054.4300294,2046.0772905272727,-102.04992700000025,47.078123803743345,-5.948567491508986,38.505783350473166,-13.093364748369877,-1181376.302629881,-431181.74510057527,56.00000000000001,36.0,68.0,26.25,2032.866699,2043.433349,2049.466674,2060.033324,2026.833374,2016.266724,2010.2333990000002,0.909638418130147,129563534.0,+1
2018-06-18,2030.0999760000002,2038.800049,2009.0999760000002,2029.5999760000002,2019.1500239999998,1871851.0,2046.3300172,2041.5627353636364,-81.00012199999969,43.71994320278138,-6.327026880155255,37.09436300848006,-29.271601434995233,-293106.1530411391,-424905.5818251464,52.0,32.0,68.0,24.14990200000011,2025.8333336666667,2042.5666913333332,2055.5334066666665,2072.266764333333,2012.8666183333335,1996.133260666667,1983.1665453333337,0.6902339937009642,127691683.0,-1
2018-06-19,2024.949951,2040.699951,2019.300049,2019.1500239999998,2023.5,2745288.0,2043.6250244999997,2036.6209184181816,-27.049927000000253,39.377825794827864,-6.834059970887927,23.549988278960882,-32.96053006893944,697517.260130623,-373886.3617362477,48.0,28.000000000000004,68.0,14.299927000000253,2026.3833413333332,2033.4666336666664,2047.7832433333333,2054.8665356666666,2012.0667316666663,2004.983439333333,1990.6668296666662,-0.007010546123068262,124946395.0,-1
2018-06-20,2026.0,2058.0,2025.0,2023.5,2056.149902,2262928.0,2039.6150146999998,2032.9618230545454,-40.10009799999989,42.137996319436574,-6.622998544395925,13.645792085921357,-20.344774014233057,-3582239.345989745,-519720.588293225,44.0,24.0,64.0,30.700072999999747,2035.5,2046.0,2068.5,2079.0,2013.0,2002.5,1980.0,-0.045454545454545456,127209323.0,+1
2018-06-21,2060.0,2070.800049,2047.050049,2056.149902,2057.600098,3377676.0,2039.4949951,2035.9681662,-1.200195999999778,58.50159279937581,-4.900393488824096,13.908737989215524,22.683079509832897,-8471017.221903965,-881143.1625482589,40.0,20.0,20.0,20.0,2058.0,2068.949951,2081.7499999999995,2092.699951,2045.199951,2034.25,2021.449951,0.3831517052631649,130586999.0,+1
2018-06-22,2056.949951,2088.800049,2049.850098,2057.600098,2083.350098,1962245.0,2039.0350098000004,2039.2600030909089,-4.5998530000001665,59.09446366851196,-4.829927210884359,10.838243099856527,46.364089684220076,2313808.0652472666,-735918.1067393712,36.0,16.0,20.000000000000007,16.59997499999986,2065.4167483333335,2080.983398666667,2104.3666993333336,2119.9333496666673,2042.0334476666671,2026.4667973333335,2003.083496666667,0.19897329267500205,132549244.0,+1
2018-06-25,2083.050049,2097.800049,2073.050049,2083.350098,2094.949951,1748084.0,2042.4350098000004,2047.3172918545454,34.0,68.35658503655183,-0.7229312910628238,9.375530613609953,143.35952915136164,2471686.643971004,-590117.8907979904,32.0,12.0,20.0,29.700072999999747,2084.7333986666667,2096.4167483333335,2109.4833986666667,2121.1667483333335,2071.6667483333335,2059.9833986666667,2046.9167483333335,0.41616359595959374,134297328.0,+1
2018-06-26,2086.050049,2103.0,2079.850098,2094.949951,2093.699951,2290483.0,2047.7,2056.8654629818184,52.64990200000011,71.68864076081745,-0.40169905189620486,6.473653377028313,161.91531299021622,-362622.7413906405,-579777.2021885654,28.000000000000004,8.0,19.999999999999996,21.39990200000011,2092.6000163333333,2105.3499346666667,2115.749918333334,2128.499836666667,2082.2000326666666,2069.450114333333,2059.0501306666665,0.6522642298874567,136587811.0,+1
2018-06-27,2093.0,2119.5,2090.0,2093.699951,2112.600098,4781701.0,2052.6849975000005,2065.2290904363635,49.84997499999986,70.76216206494058,-1.2769140806730979,4.050212009676898,180.30144498282138,-1430806.803884057,-618460.3659019968,24.0,4.0,20.0,38.8499760000002,2101.0666503333337,2112.1333006666673,2130.566650333334,2141.6333006666673,2082.6333006666673,2071.5666503333337,2053.1333006666673,0.12542206779661205,131806110.0,-1
2018-06-28,2115.0,2140.0,2111.199951,2112.600098,2130.850098,9383385.0,2060.8000122000003,2076.122745072727,81.15014699999983,76.14152501410544,-1.3424743753062278,2.916987430129211,255.0869353891625,-964913.9208552593,-634208.2547635088,20.0,0.0,20.0,47.300048999999944,2121.2666830000003,2131.3334150000005,2150.066732,2160.1334640000005,2102.5333660000006,2092.4666340000003,2073.7333170000006,0.04861613256282433,141189495.0,+1
2018-06-29,2121.699951,2140.0,2105.100098,2130.850098,2108.449951,4864530.0,2070.1450196000005,2088.859124309091,93.45007400000009,80.20025983506207,-0.4483048505634547,0.7752014865177443,228.08335643483989,50326.67795932046,-603093.0305488347,16.0,0.0,20.0,38.949951000000056,2125.316732,2145.5333659999997,2160.2166339999994,2180.4332679999998,2110.6334639999995,2090.4168299999997,2075.7335619999994,0.7378244213980863,146054025.0,+1
2018-07-02,2108.350098,2108.399902,2063.25,2108.449951,2073.25,2466219.0,2078.0300171000004,2095.823657290909,78.84997499999986,64.62935862393624,-1.545813277804995,1.1695152749380213,94.18272588767553,-517520.41494398454,-599203.3662031597,12.0,0.0,20.0,40.199951000000056,2093.3666176666666,2123.483235333333,2138.5165196666667,2168.6331373333333,2078.333333333333,2048.2167156666665,2033.183431333333,1.0011085073894501,143587806.0,-1
2018-07-03,2073.25,2085.0,2065.600098,2073.25,2070.199951,1715775.0,2083.4400147,2094.9545632727272,54.0999760000002,47.80179399402772,-3.270455658990691,1.570685134820451,29.934716226482596,-2593032.030973835,-689831.9418745541,8.0,56.00000000000001,20.000000000000004,23.14990200000011,2074.616699333333,2083.6333006666664,2094.0166013333337,2103.0332026666665,2064.2333986666663,2055.216797333333,2044.8334966666662,0.39432683732114043,141872031.0,-1
2018-07-04,2076.25,2108.050049,2069.0,2070.199951,2103.550049,1524498.0,2088.1100098,2092.5472789636365,46.699951000000056,46.588998811608164,-3.419894610485054,5.353557595212806,47.28771380378874,161149.8925650612,-651150.9494000262,4.0,52.0,20.0,29.5,2082.4166666666665,2095.833333333333,2121.4667156666665,2134.883382333333,2056.783284333333,2043.3666176666666,2017.7332353333331,0.03072854018698049,140347533.0,-1
2018-07-05,2105.0,2129.0,2092.550049,2103.550049,2123.75,2433992.0,2092.8500245,2095.3545588181814,47.40014699999983,59.540090520995754,-1.7858868691817762,11.328455721703449,108.84444613742168,-2545156.2129643513,-737242.0977438593,0.0,48.0,20.0,46.300048999999944,2108.366699333333,2124.1833496666663,2144.8166503333337,2160.6333006666664,2087.7333986666663,2071.916748333333,2051.2834476666662,0.30178367043620946,142781525.0,+1
2018-07-06,2113.300049,2135.550049,2111.350098,2123.75,2115.149902,2030336.0,2099.4650147,2100.972736181818,66.14990200000011,65.40302332699626,-0.7961783439490446,18.92013707828073,127.56172347895733,-1421914.8843535653,-768363.5880443004,4.0,44.0,16.0,34.89990200000011,2123.550049,2135.75,2147.75,2159.949951,2111.550049,2099.350098,2087.350098,0.5123936821194424,144811861.0,+1
2018-07-09,2121.850098,2130.0,2107.75,2115.149902,2125.649902,1545574.0,2102.6449951,2103.8245338727274,31.799804000000222,61.056678530005236,-1.2175452229299308,28.21598098777804,95.68927745295258,685706.6953818476,-702269.4842522027,0.0,40.0,12.0,67.60009799999989,2117.633300666667,2127.5166013333337,2139.8833006666664,2149.7666013333337,2105.2666013333337,2095.383300666667,2083.0166013333337,0.3325798651685443,143266287.0,-1
2018-07-10,2129.899902,2149.600098,2125.0,2125.649902,2146.399902,2737684.0,2105.7149902,2108.007244218182,30.699951000000056,64.39038554425818,-1.167960346015734,36.45368485864765,113.44497575120575,-586892.3276464425,-697025.0680428499,68.0,36.0,-48.00000000000001,42.84985300000017,2133.4166666666665,2141.833333333333,2158.016764666667,2166.433431333333,2117.233235333333,2108.8165686666666,2092.6331373333333,0.026418675242680493,146003971.0,+1
2018-07-11,2145.050049,2155.699951,2134.800049,2146.399902,2148.25,1464480.0,2110.9849853,2115.404500909091,52.699951000000056,70.20604878132265,-0.45218307101520144,38.175110399217374,116.28375239382153,-3781158.1848939545,-837212.9369906276,96.0,32.0,-48.0,39.050048999999944,2145.633300666667,2156.4665523333338,2166.533202666667,2177.366454333334,2135.5666503333337,2124.7333986666667,2114.6667483333335,0.5550194924359025,147468451.0,+1
2018-07-12,2152.899902,2179.850098,2152.0,2148.25,2165.949951,2005167.0,2114.5499755,2122.179958127273,35.64990200000011,70.69836971475075,-1.5186148214315,39.705956599536876,118.84854601174338,-713203.43853386,-831576.1416062291,96.0,28.000000000000004,-48.0,58.800048999999944,2160.033366,2168.0667320000002,2187.8834640000005,2195.91683,2140.2166340000003,2132.183268,2112.3665360000005,-0.1346494364220914,149473618.0,+1
2018-07-13,2168.399902,2190.800049,2163.100098,2165.949951,2180.899902,1790297.0,2118.0599608,2131.525408218182,35.09985300000017,75.21869431311988,-1.1879767385931392,41.735268696955245,117.268765244229,-137891.23622047243,-800045.0095432401,96.0,24.0,-40.0,32.0,2173.283366,2183.4666340000003,2200.983317,2211.1665850000004,2155.7666830000003,2145.583415,2128.0667320000002,0.10288296177853025,151263915.0,+1
2018-07-16,2179.399902,2190.050049,2163.75,2180.899902,2168.850098,2254334.0,2125.3049559,2142.9508520727272,72.44995100000006,78.45753019803158,-0.47328362023572335,42.099852620705406,104.97308943897805,6554532.555787525,-465746.0293009322,96.0,20.0,-40.0,22.25,2178.2333169999997,2192.7166339999994,2204.5333659999997,2219.0166829999994,2166.4165849999995,2151.9332679999998,2140.1165359999995,0.6520863136034517,153518249.0,+1
2018-07-17,2163.25,2181.0,2163.25,2168.850098,2176.75,1590481.0,2134.8649657,2150.8681506363637,95.60009799999989,69.95459054541232,-1.0493331334652845,38.9278181876316,79.50724680153856,-183497.3370638116,-452916.54329015396,92.0,16.0,32.0,34.45019599999978,2171.033366,2178.8167320000002,2188.7833659999997,2196.5667320000002,2161.0667320000002,2153.283366,2143.3167320000002,0.3154984788732332,151927768.0,-1
2018-07-18,2187.0,2220.0,2173.649902,2176.75,2176.199951,4365068.0,2145.5199706000003,2158.4836114181817,106.55004899999994,72.23116448413847,-2.0391324846770393,38.62571421907569,92.28489708882908,-1812024.5020146072,-514694.1777776292,88.0,12.0,64.0,30.050048999999944,2190.133300666667,2206.6166993333336,2236.4833986666663,2252.9667973333335,2160.2666013333337,2143.783202666667,2113.916503333334,0.06688438932750253,156292836.0,+1
2018-07-19,2183.0,2193.5,2171.0,2176.199951,2186.100098,1326194.0,2152.7849608,2164.061789672727,72.64990200000011,71.79412555272948,-2.0650659594530856,43.667622893196494,70.03955391988364,-3839699.881103002,-665830.8006560553,96.0,8.0,68.0,33.45019599999978,2180.233317,2189.4666340000003,2202.733317,2211.9666340000003,2166.9666340000003,2157.733317,2144.4666340000003,0.2311089333333358,154966642.0,-1
2018-07-20,2186.100098,2202.850098,2171.100098,2186.100098,2189.050049,2501741.0,2159.0199706000003,2170.119087345455,62.35009799999989,74.9427256703695,-1.5982980669495574,49.3481572924361,71.3523205219309,-1108688.2674199955,-685960.6855089618,92.0,4.0,72.0,42.550048999999944,2186.6834313333334,2202.266764666667,2218.433431333334,2234.016764666667,2170.516764666667,2154.9334313333334,2138.766764666667,0.47244094488188976,157468383.0,+1
2018-07-23,2150.0,2178.0,2138.050049,2189.050049,2156.449951,4220033.0,2166.4099853000002,2175.5791016,73.90014699999983,75.86886587608018,-1.459215040075439,51.55512637371976,40.550173553512764,2077405.8780501105,-560353.1144380948,88.0,0.0,76.0,26.300048999999944,2168.366699333333,2198.6833496666663,2208.3166503333337,2238.6333006666664,2158.7333986666663,2128.416748333333,2118.7834476666662,1.2765973104697907,161688416.0,+1
2018-07-24,2147.0,2169.0,2147.0,2156.449951,2159.75,1302198.0,2169.4899902,2173.7681862727272,30.800048999999944,51.56596672480434,-2.9962305044790165,50.0523065235584,22.010242371460055,237890.31883361778,-524069.32201665326,84.0,0.0,76.0,17.75,2157.483317,2167.9666340000003,2179.483317,2189.9666340000003,2145.9666340000003,2135.483317,2123.9666340000003,0.4295432272727298,160386218.0,-1
2018-07-25,2164.649902,2176.800049,2160.0,2159.75,2170.350098,1759654.0,2170.8250000000003,2171.9972789636363,13.350097999999889,53.31276221581415,-2.840641206977841,49.37375031542797,27.906983043166996,2104198.209051407,-404602.61605901405,80.0,0.0,76.0,51.14990200000011,2165.516683,2171.0333659999997,2182.3167319999993,2187.8334149999996,2154.2333169999997,2148.716634,2137.4332679999998,-0.014880908978301244,162145872.0,+1
2018-07-26,2165.0,2203.449951,2165.0,2170.350098,2192.600098,5320273.0,2173.0350098,2171.9109331454547,22.10009799999989,58.81755473909565,-2.3408723243753,48.035915801247484,42.66446018572587,2914659.7301501767,-253727.05486768708,76.0,0.0,88.0,22.5,2179.6000163333333,2194.2000326666666,2218.0499673333334,2232.6499836666667,2155.7500816666666,2141.1500653333333,2117.3001306666665,0.13914446861063312,167466145.0,+1
2018-07-27,2201.949951,2211.949951,2184.699951,2192.600098,2202.149902,2638649.0,2175.7000245,2175.4682219090905,26.650146999999833,67.9655853534793,-1.2918388495992508,46.60706543787137,60.91145895411663,-66903.1155534274,-245235.05762612983,72.0,0.0,88.0,31.75,2196.4166666666665,2208.133382333333,2223.6666666666665,2235.383382333333,2180.883382333333,2169.1666666666665,2153.633382333333,0.28991365137614067,170104794.0,+1
2018-07-30,2199.0,2199.0,2159.399902,2202.149902,2169.899902,1792280.0,2177.8250245,2180.2772905454544,21.25,71.14039842822277,-0.8415887788778825,45.4198935241634,42.27305972263291,-9185.779149533304,-234505.5449681027,68.0,20.0,88.0,48.050048999999944,2186.8499346666667,2214.2999673333334,2226.4500326666666,2253.9000653333333,2174.6998693333335,2147.249836666667,2135.0997713333336,1.0795427829496815,171897074.0,+1
2018-07-31,2160.0,2185.899902,2150.050049,2169.899902,2179.5,2215236.0,2177.9300049,2178.8363591818184,1.049804000000222,51.32135632051011,-2.362097972654403,42.69923952492991,13.177410434728671,-974101.9850123852,-268123.5649701156,64.0,16.0,84.0,42.050048999999944,2168.616617666667,2187.183186333334,2204.4664706666676,2223.0330393333343,2151.333333333334,2132.766764666667,2115.483480333334,0.5536941253287726,169681838.0,-1
2018-08-01,2162.800049,2175.0,2151.699951,2179.5,2158.699951,1517890.0,2178.2050049,2179.121812836364,2.75,55.572556404081894,-1.9094766619519095,38.7667449746441,8.213444871928594,-3056585.7725562225,-394871.8471331206,60.0,12.0,80.0,20.35009799999989,2168.733317,2185.7666830000003,2192.033366,2209.0667320000002,2162.4666340000003,2145.433268,2139.1665850000004,1.193132641051528,171199728.0,+1
2018-08-02,2153.5,2153.699951,2121.350098,2158.699951,2130.199951,2226426.0,2176.4550049000004,2175.5754394,-17.5,45.61378457690913,-2.8901484677039107,35.760470516681835,-32.05684787175461,1702470.27818163,-299538.1141642682,56.00000000000001,8.0,76.0,43.699951000000056,2144.5833333333335,2167.816568666667,2176.9331863333337,2200.1664216666672,2135.466715666667,2112.2334803333333,2103.1168626666667,1.1545602077388102,168973302.0,-1
2018-08-03,2133.550049,2147.050049,2114.0,2130.199951,2121.649902,3401002.0,2170.8649902,2167.1654296,-55.90014699999983,35.543639797264504,-4.233854266855254,31.969440918746386,-60.81118155466758,801669.22644159,-249483.23504582004,52.0,4.0,72.0,41.59985300000017,2130.4166666666665,2146.833333333333,2163.4667156666665,2179.883382333333,2113.783284333333,2097.3666176666666,2080.733235333333,0.49016420520284504,165572300.0,-1
2018-08-06,2121.0,2137.399902,2106.100098,2121.649902,2114.300049,1436158.0,2164.1249755000003,2158.2172317454547,-67.40014699999983,33.020210746692015,-4.636968316831678,28.91194677008116,-82.34511273891067,4717526.715833902,-23710.055460377913,48.0,0.0,48.0,39.60009799999989,2121.716634,2137.33317,2153.0164379999997,2168.632974,2106.0333659999997,2090.4168299999997,2074.7335619999994,0.49680196080461436,164136142.0,-1
2018-08-07,2125.0,2134.5,2108.0,2114.300049,2130.899902,1857114.0,2159.9099853000002,2149.1581542,-42.14990200000011,30.847942946638895,-4.983496039603963,22.55576289308783,-88.95191680822747,-617003.9923304048,-50677.96168174279,44.0,0.0,48.0,52.09985300000017,2118.9333496666663,2129.8666993333327,2145.433349666666,2156.3666993333327,2103.3666993333327,2092.4333496666663,2076.8666993333327,0.23773769811320544,162279028.0,-1
2018-08-08,2135.850098,2151.800049,2133.050049,2130.899902,2136.350098,2486345.0,2157.0249755,2143.8835936,-28.85009799999989,40.96822987723875,-3.83587169027081,13.462165831781476,-52.69728364196937,3284415.230104575,100917.18339945358,40.0,0.0,48.0,23.300048999999944,2138.5833333333335,2144.116617666667,2157.3333333333335,2162.866617666667,2125.366617666667,2119.8333333333335,2106.616617666667,-0.11467450666665778,164765373.0,+1
2018-08-09,2142.0,2142.0,2094.649902,2136.350098,2118.5,2236102.0,2153.6249755000003,2140.1245249636363,-34.0,44.0691794128319,-3.5779291868328857,8.35093167562627,-83.4831204303313,-942390.2508832333,53494.118204785955,36.0,0.0,48.00000000000001,58.14990200000011,2124.3333333333335,2154.016764666667,2171.683431333334,2201.3668626666667,2106.666666666667,2076.9832353333336,2059.316568666667,0.8806781350272997,167001475.0,+1
2018-08-10,2123.5,2123.800049,2098.0,2118.5,2114.449951,1360735.0,2146.2149657000004,2133.738165781818,-74.10009799999989,36.769931642226986,-4.42272430332639,4.178456527781691,-104.80171721877474,-1671236.7621461875,-24902.73999298563,32.0,96.0,48.0,44.699951000000056,2113.4333496666663,2128.8666993333327,2139.2333986666663,2154.6667483333326,2103.0666503333327,2087.6333006666664,2077.266601333333,0.7945721343397466,165640740.0,-1
2018-08-13,2084.0,2103.949951,2080.0,2114.449951,2091.649902,2513563.0,2137.4449706000005,2127.9627085636366,-87.69995100000006,35.24177290140352,-4.6144017729268025,-0.6114085935473668,-123.39034063067298,-1230742.087197705,-79713.619411382,28.000000000000004,92.0,48.0,31.299804000000222,2099.4666340000003,2118.9332680000007,2123.416585000001,2142.8832190000007,2094.9833170000006,2075.5166830000003,2071.0333660000006,1.4384142581335542,163127177.0,-1
2018-08-14,2098.0,2105.0,2087.199951,2091.649902,2089.100098,1233991.0,2129.6199706,2119.6363324545455,-78.25,27.750306431771165,-5.693464198859291,-10.118108255880543,-115.2719851963455,860202.2487502581,-36990.17085858014,24.0,96.0,44.0,26.5,2094.616617666667,2102.033284333334,2112.4166666666665,2119.833333333334,2084.233235333334,2076.816568666667,2066.433186333334,0.24999655899824036,161893186.0,-1
2018-08-16,2083.0,2086.699951,2066.399902,2089.100098,2075.699951,2656290.0,2120.5799804000003,2112.269082890909,-90.39990200000011,27.00943389232077,-5.814139276789721,-21.237565919417648,-123.08702546463496,13192.917393720218,-34709.121392566485,20.0,92.0,40.0,37.5,2080.7333169999997,2095.0667319999993,2101.0333659999997,2115.3667809999993,2074.7666829999994,2060.4332679999998,2054.4666339999994,1.1182335569731798,159236896.0,-1
2018-08-17,2082.899902,2093.050049,2071.649902,2075.699951,2077.350098,1516332.0,2112.2799804,2104.1090775454545,-83.0,23.2460721367204,-6.448330682679762,-27.802785186804613,-107.9326057233943,-3281469.1334459563,-182289.12194044798,16.0,96.0,36.0,47.35009799999989,2080.133300666667,2088.6166993333336,2101.5334476666667,2110.0168463333334,2067.2165523333338,2058.733153666667,2045.816405333334,0.18925332615705753,157720564.0,-1
2018-08-20,2075.0,2107.600098,2075.0,2077.350098,2096.199951,1952784.0,2106.9949951000003,2097.7581898363633,-52.84985300000017,24.736146404051865,-5.792852476190482,-36.26841083896079,-85.33259912669845,-2070365.2146630327,-268110.76251874736,12.0,92.0,-64.0,38.35009799999989,2086.6500653333333,2098.3001306666665,2119.250163333333,2130.9002286666664,2065.7000326666666,2054.0499673333334,2033.0999346666667,0.07208867899721949,159673348.0,+1
2018-08-21,2098.0,2112.0,2092.649902,2096.199951,2096.050049,1944080.0,2104.4500000000003,2095.795454545455,-25.449951000000056,40.07094214721227,-4.298239264568236,-41.020772885327005,-54.3503943924904,2653855.3764914223,-135294.11983646682,8.0,88.0,-64.0,38.5,2100.283284333333,2107.916666666666,2119.6333823333325,2127.266764666666,2088.566568666666,2080.933186333333,2069.2164706666663,0.18346413542711593,161617428.0,+1
2018-08-23,2105.0,2107.0,2076.850098,2096.050049,2079.899902,3143638.0,2102.6250000000005,2094.2681907272727,-18.25,39.99616699873825,-3.802984152215802,-41.30789494378587,-58.28963373400902,1518716.657138751,-60111.811792138695,4.0,84.0,-72.0,27.25,2093.300049,2109.75,2123.4499509999996,2139.899902,2079.600098,2063.150147,2049.450196,0.6368163651079193,158473790.0,-1
2018-08-24,2071.0,2093.600098,2066.050049,2079.899902,2069.850098,2428657.0,2097.5250000000005,2090.1363547272726,-51.0,32.46503070191943,-3.591767691632166,-41.73716030880814,-69.34422746877088,-923172.0583658965,-99341.8230000368,0.0,80.0,-72.0,25.25,2079.8500163333333,2093.6499836666667,2107.400065333333,2121.2000326666666,2066.0999346666667,2052.2999673333334,2038.5498856666668,0.5027160931728359,156045133.0,-1
2018-08-27,2077.0,2088.5,2070.25,2069.850098,2080.449951,3143697.0,2090.875,2085.1045543636365,-66.5,28.598555328590393,-3.992105857553984,-41.062150142419796,-64.37032286025489,-2485697.4597976236,-207812.53376356355,24.0,96.0,-80.0,21.400146999999833,2076.2000326666666,2082.1500653333333,2094.4500326666666,2100.4000653333333,2063.9000653333333,2057.9500326666666,2045.6500653333333,-0.021912438356170467,152901436.0,-1
2018-08-28,2088.0,2098.25,2078.800049,2080.449951,2094.850098,2493383.0,2087.0699951,2083.209090909091,-38.050048999999944,37.637415957962475,-3.4757451430672632,-42.65529150686416,-41.58050928515169,1425502.9014452433,-133570.9230722541,20.0,92.0,-80.0,32.60009799999989,2085.8333333333335,2092.866617666667,2105.283284333334,2112.316568666667,2073.416666666667,2066.3833823333334,2053.966715666667,0.08482808002961582,155394819.0,+1
2018-08-29,2092.149902,2094.050049,2072.75,2094.850098,2078.5,2468423.0,2085.1100098,2084.623655072727,-19.599853000000167,47.96338301548544,-2.7742570947298364,-44.36993591532291,-33.15890711331196,449153.820852748,-107083.43471202672,16.0,88.0,-80.0,34.64990200000011,2087.2167156666665,2101.683431333333,2108.516764666667,2122.983480333333,2080.383382333333,2065.9166666666665,2059.083333333333,1.0375608995077874,157863242.0,+1
2018-08-30,2083.600098,2087.899902,2061.850098,2078.5,2066.100098,5456865.0,2083.7950195999997,2083.421835109091,-13.149902000000111,39.413616401850255,-3.570734959583974,-44.1355366335024,-44.393681186023684,9848.395801780873,-101768.35150685364,12.0,84.0,-80.0,30.14990200000011,2076.0833333333335,2090.316568666667,2102.1331373333333,2116.3663726666673,2064.266764666667,2050.0335293333333,2038.2169606666666,0.6391565172620864,152406377.0,-1
2018-08-31,2069.199951,2078.75,2058.25,2066.100098,2061.199951,3942875.0,2081.4950196000004,2080.2045766363635,-23.0,34.09518774601018,-3.715120019579056,-45.92471413853673,-49.23346950631339,280582.66115065786,-84388.76002242128,8.0,96.0,-80.0,30.0,2067.7000326666666,2077.1500653333333,2088.2000326666666,2097.6500653333333,2056.6500653333333,2047.2000326666666,2036.1500653333333,0.38293160975609214,148463502.0,-1
2018-09-03,2069.399902,2078.949951,2063.5,2061.199951,2075.050049,1915402.0,2080.0450196,2076.5145641636364,-14.5,32.118958726813474,-3.091668139326477,-44.69656463093952,-43.52507372712564,2430029.598840733,29902.983562267644,4.0,96.0,-72.0,18.25,2067.883300666667,2072.2666013333337,2083.333251666667,2087.7165523333338,2056.8166503333337,2052.433349666667,2041.3666993333336,-0.14887095758426264,146548100.0,-1
2018-09-04,2076.899902,2077.949951,2049.0,2075.050049,2051.800049,1782634.0,2079.8150147,2075.6063876909093,-2.3000489999999445,42.91067959502466,-1.8355663686040764,-42.1447424182943,-40.71090572418345,3389926.565969397,182631.32821713728,0.0,92.0,-72.0,28.39990200000011,2067.3333333333335,2085.666666666667,2096.2832843333335,2114.616617666667,2056.716715666667,2038.3833823333334,2027.7667646666669,0.8998305040309013,148330734.0,+1
2018-09-05,2053.800049,2060.199951,2035.550049,2051.800049,2045.8499760000002,1410377.0,2075.3750245,2070.512757563636,-44.39990200000011,32.80793948914615,-2.9905589170392477,-36.83834792514608,-67.20535493077591,-972363.8606294723,130131.54690592772,0.0,96.0,-72.0,21.300048999999944,2049.1833496666663,2062.8166503333327,2073.8332516666665,2087.466552333333,2038.1667483333326,2024.5334476666662,2013.5168463333325,0.6592318298060547,146920357.0,-1
2018-09-06,2049.0,2059.0,2032.5999760000002,2045.8499760000002,2052.199951,2600603.0,2070.3550172000005,2065.144566927273,-50.20007299999975,30.67533487643,-3.2861412816691407,-31.14010269314622,-68.80652167896335,-4572167.255076106,-83609.30772961944,0.0,96.0,-72.0,33.0,2045.8166506666669,2059.033325333334,2072.216674666666,2085.4333493333334,2032.6333013333337,2019.416626666667,2006.233277333334,0.5018934831271403,144319754.0,-1
2018-09-07,2051.0,2060.0,2040.75,2052.199951,2056.949951,1479825.0,2067.5850221,2061.8436458,-27.699951000000056,35.81311283904286,-2.9706929458519595,-29.85162164124131,-54.9496426615782,3222959.6283140886,66689.28027236741,0.0,96.0,-88.0,20.5,2050.983317,2061.2166340000003,2070.233317,2080.4666340000003,2041.9666340000003,2031.7333170000002,2022.7166340000003,0.5948026493506522,145799579.0,+1
2018-09-10,2055.0,2055.0,2025.0999760000002,2056.949951,2041.1500239999998,2149648.0,2066.2950074000005,2059.909996509091,-12.900146999999833,39.672116087951764,-2.7347267262791823,-27.966563537932416,-61.06553981694705,-516305.29336394195,40189.52692526242,0.0,92.0,-92.0,15.449951000000056,2045.683309,2066.2666419999996,2075.5833329999996,2096.1666659999996,2036.366618,2015.7832850000002,2006.4665940000002,1.0652157001613132,147949227.0,+1
2018-09-11,2046.300049,2048.0,1994.1500239999998,2041.1500239999998,2000.4000239999998,4546634.0,2062.3650147,2055.3381813454544,-39.29992700000025,32.234146717297605,-3.519621261798321,-25.623301838152656,-90.63829299744107,2406153.4445670475,147733.34136352548,12.0,96.0,-92.0,28.949951000000056,2027.7666826666664,2061.383341333333,2081.616658666667,2115.233317333333,2007.5333653333328,1973.9167066666662,1953.6833893333326,0.8727951893608983,143402593.0,-1
2018-09-12,2001.9000239999998,2021.3499760000002,1989.550049,2000.4000239999998,2011.8499760000002,3061502.0,2052.9200073,2044.0718193999999,-94.45007400000009,20.69020282980634,-5.30876374501993,-24.743541195186936,-125.58578501091597,797598.5992577882,177272.67126781016,8.0,96.0,-96.0,39.5,2003.7666829999998,2017.9833169999997,2035.5666100000003,2049.783244,1986.1833899999995,1971.9667559999996,1954.3834629999992,0.3411949656362347,140341091.0,-1
2018-09-14,2019.8499760000002,2037.4000239999998,2018.949951,2011.8499760000002,2029.5999760000002,2583668.0,2046.2550049,2036.6045409818184,-66.6500239999998,28.940747553621037,-4.321621808178057,-25.78119115897971,-77.17523417016706,3119451.4036769303,311008.0681954975,4.0,96.0,-96.0,26.400023999999803,2022.7333170000002,2026.5166830000003,2041.1833899999997,2044.966756,2008.0666100000005,2004.2832440000004,1989.6165370000008,-0.3848209706270515,142924759.0,+1
2018-09-17,2021.300049,2022.949951,1988.0,2029.5999760000002,1992.199951,2334555.0,2042.6049927000001,2033.5763539090908,-36.50012199999969,40.08896008759126,-3.43378887082655,-29.19136207944848,-88.53723919734014,-2271675.351543054,193613.3672982905,0.0,92.0,-96.0,19.25,2013.5166423333333,2039.0332846666665,2048.4665933333335,2073.9832356666666,2004.0833336666665,1978.5666913333332,1969.1333826666664,1.1902727989518536,145259314.0,+1
2018-09-18,1994.9000239999998,2009.8499760000002,1980.949951,1992.199951,1989.199951,2331434.0,2035.7049927000003,2024.4118008727276,-69.0,29.020062105389613,-5.304491634362883,-30.66738225392237,-115.19067652107834,-4622384.9638125645,-25295.64775220307,0.0,96.0,-92.0,29.900023999999803,1994.333292666667,2007.7166343333338,2023.233317666667,2036.616659333334,1978.8166093333336,1965.4332676666668,1949.9165843333335,0.3892730196600157,142927880.0,-1
2018-09-19,1994.8499760000002,1998.0,1956.5,1989.199951,1961.3499760000002,4178066.0,2027.1199829000002,2015.9563387454546,-85.85009799999989,28.2969323707768,-5.255512163845464,-30.515660841439512,-121.45237185275643,-706444.8524155237,-56256.97523689949,0.0,96.0,-84.0,62.79992700000025,1981.2333170000002,2005.9666340000003,2022.7333170000002,2047.4666340000003,1964.4666340000003,1939.7333170000002,1922.9666340000003,0.7879506265060254,138749814.0,-1
2018-09-21,1973.9000239999998,1999.8499760000002,1910.199951,1961.3499760000002,1970.25,5652537.0,2018.0749756,2003.9981556727273,-90.45007299999975,22.33534396094163,-6.362810208434507,-31.802216191482103,-138.32521999996075,-3803961.5530320187,-226607.18331849593,20.0,96.0,-88.0,51.59997499999986,1957.133301,2004.066651,2046.7833260000002,2093.716676,1914.416626,1867.483276,1824.7666009999998,0.5705522669960221,133097277.0,-1
2018-09-24,1967.25,1972.199951,1915.0,1970.25,1925.699951,3347698.0,2010.5149780000002,1995.3027055636367,-75.5999760000002,27.933803076504603,-5.490035288270781,-35.515861624648096,-122.40954368296856,-1950528.053584201,-304967.22287602804,16.0,96.0,-92.0,37.0,1952.4833170000002,1989.9666340000003,2009.6832680000002,2047.1665850000004,1932.7666830000003,1895.2833660000001,1875.5667320000002,0.9659099183494047,136444975.0,+1
2018-09-25,1925.699951,1962.0,1915.0,1925.699951,1952.4000239999998,4170638.0,1997.8649780000005,1979.8817915636364,-126.5,19.72250152894088,-7.740094638382098,-39.12219036768943,-127.77693740803883,992176.8517224091,-246006.12857609906,12.0,92.0,-92.0,34.949951000000056,1934.2333170000002,1953.4666340000003,1981.2333170000002,2000.4666340000003,1906.4666340000003,1887.2333170000002,1859.4666340000003,0.2276585319148948,132274337.0,-1
2018-09-26,1962.949951,1978.0,1955.300049,1952.4000239999998,1968.199951,3681681.0,1987.4099853000002,1971.6154362909092,-104.54992700000025,33.284426234152264,-6.344269946622831,-41.95900025108131,-76.05396787838357,6096300.344767859,42280.529303172,8.0,88.0,-96.0,48.65002500000014,1961.9000243333332,1968.4999996666666,1984.599975333333,1991.1999506666666,1945.8000486666665,1939.2000733333332,1923.1000976666664,-0.12775468105636592,135956018.0,+1
2018-09-27,1969.4000239999998,1986.0,1955.1500239999998,1968.199951,1976.1500239999998,4588052.0,1980.1149780000005,1968.1227027818181,-72.95007299999975,40.18418719139396,-4.691005624035935,-46.65200820361815,-56.733403716004425,-1155631.7725223978,-12170.029870717579,4.0,84.0,-96.0,41.5,1969.7833249999996,1984.4166259999995,2000.6333009999996,2015.2666019999997,1953.5666499999993,1938.9333489999995,1922.716673999999,0.42301254950733735,140544070.0,+1
2018-09-28,1980.6500239999998,2015.449951,1977.1500239999998,1976.1500239999998,2006.050049,3615179.0,1977.6899779999999,1967.4018020545454,-24.25,43.57233863121256,-4.27587842937278,-52.345924285885985,-27.88259415061578,4077226.952217678,173711.65113330056,0.0,80.0,-76.0,89.65002500000014,1989.5833329999998,2002.0166419999998,2027.8832600000003,2040.316569,1963.7167149999996,1951.2834059999996,1925.4167879999993,-0.02610971033965661,144159249.0,+1
2018-10-01,2009.800049,2042.0,1997.800049,2006.050049,2035.449951,3112397.0,1977.1099853,1972.5581786,-5.7999270000002525,54.70595502802149,-2.751144875063746,-54.54192367841483,5.092430559518999,-444977.2857142857,145589.4267311375,0.0,76.0,-80.0,57.199951000000056,2015.283366,2032.7666829999998,2059.4833169999997,2076.966634,1988.5667319999998,1971.0834149999998,1944.3667809999997,0.18665179063207535,147271646.0,+1
2018-10-03,2030.449951,2052.199951,2007.0,2035.449951,2031.1500239999998,3833037.0,1977.6949828000002,1983.165445090909,5.8499749999998585,62.990671432001875,-0.9994912576687088,-50.5797953228755,27.049161072344788,-3115536.2551696775,-2643.5588098087537,8.0,72.0,-80.0,55.25,2031.5499673333334,2056.0999346666667,2076.7499183333334,2101.299885666667,2010.8999836666667,1986.3500163333333,1965.7000326666666,0.6294243770308516,151104683.0,+1
2018-10-04,2008.0,2017.800049,1943.0,2031.1500239999998,1957.75,4492646.0,1981.5899900999998,1992.8845434909092,38.95007299999975,61.10453505950526,-1.0777149051853654,-49.20743722657221,-10.082252727891317,7998496.973262835,361044.64719349355,4.0,68.0,-80.0,52.300048999999944,1997.316691,2051.633382,2072.11674,2126.433431,1976.833333,1922.516642,1902.033284,1.1784754846885177,146612037.0,-1
2018-10-05,1953.949951,1990.0,1940.1500239999998,1957.75,1965.300049,3932295.0,1978.4449950000003,1988.5499998363634,-31.449951000000056,38.43617702337071,-4.835651923482977,-52.9316207720251,-48.354536839723394,-2787747.624250148,217917.72576423702,0.0,64.0,-80.0,33.5999760000002,1962.6333413333332,1985.1166586666666,2012.4833173333334,2034.9666346666668,1935.2666826666664,1912.783365333333,1885.4167066666662,0.35305886606645764,142679742.0,-1
2018-10-08,1965.0,1969.0,1930.0,1965.300049,1945.0,5032005.0,1978.8400023000002,1986.1600096545458,3.9500729999997475,41.032511988332296,-4.449104248415994,-51.000480808892235,-54.39614546791171,-1351837.5355019853,146565.2138884996,0.0,60.0,-80.0,47.25,1954.7666829999998,1979.5333659999997,1993.7666829999998,2018.5333659999997,1940.5333659999997,1915.7666829999998,1901.5333659999997,0.9051294615384601,147711747.0,+1
2018-10-09,1944.4000239999998,1965.0,1930.0,1945.0,1940.5999760000002,3114841.0,1976.3150023,1980.0072819636362,-25.25,36.28508292661876,-5.488426873301721,-48.321001933305524,-58.67740537927496,796612.218392354,176112.8050023112,0.0,56.00000000000001,-76.0,65.8499760000002,1946.6666666666667,1963.3333333333335,1981.666666666667,1998.3333333333335,1928.3333333333335,1911.6666666666667,1893.3333333333335,0.42857142857142855,144596906.0,-1
2018-10-10,1945.0,1982.25,1935.5,1940.5999760000002,1967.1500239999998,3984983.0,1977.8050048000002,1973.5136408181818,14.900025000000142,35.26466973191681,-5.713699457286125,-42.87531508595612,-44.21780999911035,360945.27272727276,184514.28080799128,4.0,52.0,-64.0,46.14990200000011,1952.7833253333336,1970.066650666667,1999.5333253333338,2016.816650666667,1923.316650666667,1906.0333253333336,1876.566650666667,0.10909039572192934,140611923.0,-1
2018-10-11,1925.0,1948.300049,1917.5999760000002,1967.1500239999998,1937.550049,3589976.0,1979.2800048000001,1971.5763715818182,14.75,45.86428281186272,-4.354389163099065,-38.58088751417836,-50.91214290400595,1117362.3878603752,226916.4674921906,0.0,48.0,-64.0,92.44995100000006,1944.350016333333,1971.100056666666,1975.050089333333,2001.8001296666657,1940.3999836666662,1913.6499433333333,1909.6999106666665,1.6140042403156505,144201899.0,+1
2018-10-12,1945.0,1997.0999760000002,1942.0,1937.550049,1981.8499760000002,2400080.0,1976.2150146000004,1963.989106890909,-30.64990200000011,37.884605126287276,-5.869849727433262,-28.801692853774966,-27.12108459706726,-11832851.68868162,-321254.8123338921,0.0,44.0,-64.0,91.0,1958.8833416666669,1975.7666833333337,2013.983317666667,2030.866659333334,1920.6667073333335,1903.7833656666667,1865.5667313333333,-0.08076139633890293,141801819.0,-1
2018-10-15,1990.0,2010.800049,1970.300049,1981.8499760000002,2008.050049,3146492.0,1976.7850098000001,1965.0136453272728,5.699952000000394,52.23541281582809,-3.6017805019901856,-20.1628858389779,18.590149209938616,4857141.0,-85873.18450053319,0.0,40.0,-60.0,39.0,1987.6500246666667,2005.0000003333334,2028.150024666667,2045.5000003333334,1964.5000003333334,1947.1500246666667,1924.0000003333334,0.28518338271605564,144948311.0,+1
2018-10-16,2003.0,2018.199951,1987.5,2008.050049,1992.75,2351501.0,1976.9850098000002,1970.6981979090906,2.0,58.740439589101506,-2.2603882402002022,-14.024746372472691,55.4666358935369,-1460270.884540239,-148345.8072296108,4.0,36.0,-56.00000000000001,35.300048999999944,2004.5833333333333,2021.6666666666665,2035.2832843333335,2052.3666176666666,1990.9667156666665,1973.8833823333332,1960.2667646666664,0.6693837719806103,147299812.0,+1
2018-10-17,2006.0999760000002,2013.0,1963.5,1992.75,1974.5999760000002,1985199.0,1972.7150147000002,1973.5645597636365,-42.699951000000056,53.80314595016932,-3.043720688686422,-9.379571559584747,34.09129531251167,3345565.1730167754,10468.328236134159,0.0,32.0,-48.0,46.75,1989.75,2016.0,2039.25,2065.5,1966.5,1940.25,1917.0,0.5909090909090909,145314613.0,-1
2018-10-19,1958.9000239999998,1980.8499760000002,1958.0,1974.5999760000002,1967.75,2466837.0,1967.0600099000003,1973.90728,-56.550047999999606,48.25180825511079,-3.9729662577694715,-8.817228216857302,-5.074932793916097,1531716.710160783,79615.98195998189,0.0,28.000000000000004,-48.0,30.700072999999747,1971.1499840000004,1984.2999680000007,1993.9999600000006,2007.149944000001,1961.4499920000005,1948.3000080000002,1938.6000160000003,0.72647673678082,142847776.0,-1
2018-10-22,2014.0,2020.0,1988.5999760000002,1967.75,1998.9000239999998,5082790.0,1968.0600099000003,1974.0327327454545,10.0,46.17701153604074,-4.323671570683961,-12.514557004898734,52.41644813796412,3802890.430107527,248855.72960305226,52.0,24.0,-44.0,55.0999760000002,1992.1166586666668,1995.6333413333334,2023.5166826666666,2027.0333653333332,1964.2333173333336,1960.716634666667,1932.8332933333338,-0.6640114669976153,137764986.0,-1
2018-10-23,1973.0,1998.9000239999998,1973.0,1998.9000239999998,1984.8499760000002,4857141.0,1971.4200074000003,1979.6400080363637,33.59997499999986,56.08512279029494,-2.7288515429621905,-16.39684722659058,43.2098750845428,2251930.536581651,339904.58446571586,48.0,20.0,-40.0,73.25,1990.2666826666664,2007.5333653333328,2016.166706666666,2033.4333893333326,1981.633341333333,1964.3666586666666,1955.7333173333332,1.0,142622127.0,+1
2018-10-24,2004.0,2008.800049,1972.5999760000002,1984.8499760000002,1992.25,4518084.0,1975.405005,1982.081820509091,39.8499760000002,51.181640637984366,-3.4481863961504806,-13.239888399408528,32.47753900161962,4027018.0928615113,507500.6530291612,44.0,16.0,-32.0,36.34997499999986,1988.7500003333334,2004.9000246666667,2024.9500733333332,2041.1000976666664,1968.699951666667,1952.5499273333337,1932.4998786666672,0.33839710765224384,138104043.0,-1
2018-10-25,1973.5999760000002,2003.5999760000002,1962.449951,1992.25,1968.800049,7461764.0,1980.5700074000001,1985.1445468727272,51.6500239999998,53.6446174350846,-1.4445601249349298,-10.009987163992491,18.335301300134358,-360828.1617647059,468031.16144762177,40.0,12.0,-32.0,49.5,1986.0999756666668,2009.7500003333334,2027.250000666667,2050.9000253333334,1968.5999753333333,1944.9499506666666,1927.4499503333332,0.7241805806922315,145565807.0,+1
2018-10-26,1968.800049,1977.199951,1949.0,1968.800049,1961.199951,3788928.0,1980.7350099000005,1983.0045544363636,1.6500250000001415,45.289843899866156,-2.665275950026031,-3.1409239157867432,-43.7259427248587,-7460538.884901357,107641.61388630424,36.0,8.0,-28.000000000000004,34.75,1965.0,1981.0,1993.199951,2009.199951,1952.800049,1936.800049,1924.600098,0.7021306171773102,141776879.0,-1
2018-10-29,1964.0999760000002,1964.949951,1895.199951,1961.199951,1926.300049,4261070.0,1983.1000001000004,1979.4527255454545,23.64990200000011,42.79726070988556,-3.060908328995312,2.2701650514336507,-119.7947159323793,82343.14144282037,106491.68332069134,32.0,4.0,28.0,45.4000239999998,1940.4499509999998,1985.6999509999996,2010.199951,2055.4499509999996,1915.9499509999996,1870.6999509999998,1846.1999509999996,0.946236559139785,137515809.0,-1
2018-10-30,1925.0,1932.0,1899.300049,1926.300049,1912.75,3457176.0,1977.5450074,1969.1254617090908,-55.54992700000025,33.13482803582488,-4.877665330557004,3.2269408920278693,-177.33583691761012,-446099.3447104161,81373.90931927734,28.000000000000004,96.0,28.0,31.150023999999803,1919.2000326666666,1939.1000163333333,1951.8999836666667,1971.7999673333334,1906.4000653333333,1886.5000816666666,1873.7001143333332,0.8256893106659381,134058633.0,-1
2018-10-31,1902.050049,1917.9000239999998,1885.0,1912.75,1911.75,5862351.0,1968.0150025000003,1957.3445512727274,-95.30004899999994,30.091308163295977,-5.58302967204581,6.30008039676909,-196.4317883268184,-350314.9452175476,61751.68865851256,24.0,92.0,28.0,36.20007299999975,1905.2166746666664,1925.433349333333,1938.1166986666663,1958.3333733333327,1892.533325333333,1872.3166506666666,1859.6333013333333,0.8434644302995088,128196282.0,-1
2018-11-01,1930.0,1930.0,1896.0,1911.75,1912.199951,4907263.0,1959.9150025000001,1947.114550818182,-81.0,29.85777108325614,-5.635085892764185,3.8190731543834318,-141.24983567799364,2108055.057505197,154765.47815154374,20.0,96.0,28.0,41.15002500000014,1912.5833333333333,1929.1666666666665,1946.583333333333,1963.1666666666665,1895.1666666666665,1878.5833333333333,1861.1666666666665,0.4632352941176471,123289019.0,-1
2018-11-02,1926.0,1960.0,1912.0,1912.199951,1949.449951,7523217.0,1953.6750000000002,1938.4390869090907,-62.40002500000014,30.139259862816317,-5.611663144195728,-5.520334040490525,-85.01748797751046,513521.12421606446,171072.5529726583,16.0,92.0,28.0,43.25,1928.0666503333334,1944.1333006666669,1976.0666503333332,1992.1333006666669,1896.1333006666669,1880.0666503333334,1848.1333006666669,0.00416564583333449,130812236.0,+1
2018-11-05,1949.9000239999998,1959.6500239999998,1938.0,1949.449951,1956.0,1426324.0,1951.8449951000002,1937.6708961818183,-18.300048999999944,49.49870813295954,-3.6725689224362283,-10.82499436393391,-26.447883774615672,-429906.60438714374,143755.31854721275,12.0,88.0,28.0,73.60009799999989,1949.0333249999996,1960.0666499999993,1970.6833489999995,1981.716673999999,1938.4166259999995,1927.3833009999998,1916.7666019999997,0.528865510726462,132238560.0,+1
2018-11-06,1955.0,1976.0,1942.949951,1956.0,1946.550049,2121397.0,1947.5549927000002,1938.4263516181818,-42.9000239999998,52.186973910013265,-3.331598125976054,-12.826486667601557,-3.1531029743358445,-11465228.76370501,-383925.77610061597,8.0,84.0,-68.0,61.89990200000011,1958.3166503333334,1973.6833496666668,1991.3666993333331,2006.7333986666667,1940.6333006666669,1925.2666013333335,1907.583251666667,0.39485717555214417,134359957.0,+1
2018-11-07,1961.0,1964.949951,1950.0,1946.550049,1957.949951,239690.0,1943.7250000000001,1938.243634581818,-38.29992700000025,47.938912308054874,-3.8235268610098934,-13.783203330799779,-16.8622889350394,394509.2914986871,-348542.3639370113,4.0,80.0,-68.0,41.300048999999944,1953.8333333333333,1957.6666666666665,1968.7832843333335,1972.6166176666666,1942.7167156666665,1938.8833823333332,1927.7667646666664,-0.23076670953637524,134120267.0,-1
2018-11-09,1958.199951,1959.9000239999998,1936.300049,1957.949951,1945.4000239999998,2525405.0,1940.2949950999998,1940.829989309091,-34.300048999999944,53.23734388451998,-3.230091046330034,-17.15630978816239,-24.14360732146279,-5115330.031557865,-565214.5306470502,0.0,76.0,-76.0,34.0,1951.3833413333334,1966.466633666667,1974.9833163333333,1990.0666086666668,1942.866658666667,1927.7833663333336,1919.2666836666672,0.9173697006035066,136645672.0,+1
2018-11-12,1951.5,1962.0,1917.1500239999998,1945.4000239999998,1921.050049,1976941.0,1937.9549926000002,1941.758176381818,-23.40002500000014,47.142846647417464,-3.883392816241551,-17.43890496103495,-50.92742249927505,-2299675.8111675787,-644053.6797616198,44.0,72.0,-76.0,48.25,1941.5166826666664,1965.883341333333,1986.3666586666666,2010.7333173333332,1921.0333653333328,1896.6667066666662,1876.1833893333326,0.6298777060661053,134668731.0,-1
2018-11-13,1919.0,1937.699951,1908.199951,1921.050049,1927.75,3337605.0,1933.9400024000001,1938.6845502727272,-40.14990200000011,37.525536147578606,-4.594721842527296,-19.964339071896575,-99.66484314673981,635068.1734643182,-585911.777342259,40.0,68.0,-76.0,47.45007299999975,1922.3166503333334,1936.4333496666668,1951.8166503333337,1965.9333496666668,1906.9333496666668,1892.8166503333334,1877.4333496666668,0.4355965423728776,131331126.0,-1
2018-11-14,1938.550049,1960.0,1936.5999760000002,1927.75,1957.75,6527659.0,1934.0849975000003,1937.559095290909,1.4499510000000555,41.325736509057265,-4.243902341631993,-24.10991493978304,-37.23241371540514,-250181.22769569184,-570651.2978128695,36.0,64.0,-76.0,33.050048999999944,1941.449992,1946.300008,1964.8500159999996,1969.7000319999997,1922.8999840000001,1918.0499680000003,1899.4999600000003,-0.37820371466286834,137858785.0,+1
2018-11-15,1961.9000239999998,1977.300049,1931.199951,1957.75,1975.1500239999998,2598131.0,1938.5849975000003,1941.8618230181817,45.0,55.355969627006395,-2.407328393245774,-26.34122661202423,6.08264152612806,218722.43047423035,-534770.6737998195,32.0,60.0,-76.0,14.949951000000056,1955.4166666666667,1979.6333823333334,2001.5167646666664,2025.7334803333333,1933.5332843333335,1909.3165686666669,1887.4331863333337,0.5759217474982377,140456916.0,+1
2018-11-16,1981.0,2013.0,1980.0,1975.1500239999998,2004.300049,3953304.0,1944.9249999000003,1948.5100096545452,63.4000239999998,61.51466851714097,-1.977532706374096,-24.6379968385354,96.23040069961048,-6036836.070445754,-784864.5554655441,28.000000000000004,56.00000000000001,-76.0,23.59997499999986,1989.3833413333332,1998.7666826666664,2022.3833413333332,2031.7666826666664,1965.7666826666664,1956.3833413333332,1932.7666826666664,-0.14696896969697568,144410220.0,+1
2018-11-19,2011.0,2021.0,2001.9000239999998,2004.300049,2013.9000239999998,3071607.0,1954.1350097000004,1959.3054731272728,92.10009799999989,69.61675276562875,-0.8688840270551538,-20.288441785969326,135.17815931738585,-1074600.6053149141,-798034.3759132427,24.0,52.0,-28.0,44.8499760000002,2009.066691,2016.2333580000002,2028.1666670000002,2035.3333340000004,1997.133382,1989.9667149999998,1978.0334059999998,0.12565591705456158,147481827.0,+1
2018-11-20,2013.0,2019.5999760000002,1999.050049,2013.9000239999998,2012.449951,1426292.0,1960.5800170000002,1970.171839363636,64.45007299999975,71.8673186325278,-0.3694056191467324,-13.33738043175299,131.63309838418363,-2595782.907384189,-879750.2182528313,96.0,48.0,-28.0,37.20007299999975,2010.850016333333,2022.6499836666662,2031.3999433333333,2043.1999106666665,2002.100056666666,1990.3000893333328,1981.5501296666657,0.7226290876848213,148908119.0,+1
2018-11-21,2012.75,2023.949951,2004.0,2012.449951,2018.75,1636401.0,1966.2250121000002,1979.6027364545453,56.449951000000056,70.95133902053718,-0.5974181299636293,-7.649225536096083,135.40896505288487,-9723315.258601686,-1281730.4473595978,92.0,44.0,-28.0,38.949951000000056,2013.466634,2022.9332680000002,2033.416585,2042.8832190000003,2002.9833170000002,1993.516683,1983.0333660000001,0.42355748141937954,147271718.0,-1
2018-11-22,2013.25,2035.0,2000.1500239999998,2018.75,2005.5,3243638.0,1973.4450072000002,1989.1527342545455,72.19995100000006,72.69589261791958,-0.8393595041322314,-3.6514112492018285,145.6457858602489,1721830.7234705433,-1145204.9395945913,96.0,40.0,-28.0,49.550048999999944,2017.9666746666664,2035.783325333333,2052.8166506666666,2070.6333013333333,2000.933349333333,1983.1166986666663,1966.0833733333327,0.5337156042804762,150515356.0,+1
2018-11-26,2013.9000239999998,2052.0,2012.050049,2005.5,2049.800049,4546109.0,1978.2000120999999,1994.980914763636,47.550048999999944,63.44886947307662,-2.380952380952381,1.108980780121101,150.52302208558706,615374.6921162462,-1065178.592698644,96.0,36.0,-28.000000000000004,55.25,2023.1833496666666,2034.3166503333332,2063.133300666667,2074.2666013333333,1994.3666993333331,1983.2333986666665,1954.416748333333,-0.1639563713106916,145969247.0,-1
2018-11-27,2041.050049,2067.899902,2040.75,2049.800049,2064.0,3223860.0,1988.6400146,2007.9991032909093,104.40002500000014,75.48078674372674,-0.9192876174971828,7.758745537065579,195.55117171022675,2328900.099759553,-910902.2884959986,96.0,32.0,-28.0,45.8499760000002,2052.8166503333337,2064.8833006666673,2079.9665523333333,2092.0332026666674,2037.7333986666672,2025.6667483333335,2010.583496666667,0.33333634132454354,149193107.0,+1
2018-11-28,2065.0,2098.600098,2060.100098,2064.0,2089.25,3255277.0,2002.9350097000001,2021.7009188181817,142.94995100000006,78.14197439310522,-1.730350885389879,12.634699414456009,192.63955199474185,-1020074.1945843739,-915864.647863652,96.0,28.000000000000004,48.0,20.549927000000253,2074.2333986666667,2088.3666993333336,2112.7333986666663,2126.8666993333336,2049.8666993333336,2035.7333986666667,2011.3666993333336,0.10129615584415873,152448384.0,+1
2018-11-29,2101.0,2137.399902,2094.0,2089.25,2131.050049,7977159.0,2019.0850097,2037.3945534181817,161.5,82.12293313201188,-2.36214208766186,20.07865500777507,196.2332186549347,2069538.6225095962,-780164.4992103224,96.0,24.0,48.0,19.949951000000056,2106.883300666667,2119.7666013333337,2150.2832026666674,2163.166503333334,2076.3666993333336,2063.4833986666667,2032.9667973333335,-0.10944725174725022,160425543.0,+1
2018-11-30,2130.0,2137.550049,2110.0,2131.050049,2128.449951,3260231.0,2036.4150146000002,2057.751833290909,173.30004899999994,86.73698381471124,-0.3188540797999314,34.909742694542274,174.23695044195094,-275835.76108574047,-757240.4656592051,96.0,20.0,56.0,34.8499760000002,2126.200032666666,2142.4000653333323,2153.750081666666,2169.9501143333323,2114.8500163333324,2098.6499836666662,2087.2999673333325,0.7640657553821406,163685774.0,+1
2018-12-03,2131.0,2142.0,2106.899902,2128.449951,2113.300049,2699964.0,2051.7450073,2074.485458090909,153.29992700000025,85.15944607741659,-0.6632427312775303,49.33107361791235,136.0640362791057,3121599.168948636,-580929.5731770303,96.0,16.0,60.0,39.949951000000056,2125.783284333333,2144.666666666666,2160.8833823333325,2179.766764666666,2109.566568666666,2090.683186333333,2074.4664706666663,0.6139597957817671,160985810.0,-1
2018-12-04,2105.399902,2111.0,2078.600098,2113.300049,2085.550049,2039355.0,2062.6450073,2085.6772838545457,109.0,75.88097617264994,-1.40479446891826,61.04322647005597,88.15957689486241,8923703.565972544,-148900.79412477653,96.0,12.0,64.0,62.39990200000011,2100.966715666667,2123.333333333334,2133.3666176666675,2155.733235333334,2090.933431333334,2068.566813666667,2058.5335293333337,1.070989381387633,158946455.0,-1
2018-12-05,2078.0,2105.300049,2075.949951,2085.550049,2099.199951,2949711.0,2069.8100098,2089.841836890909,71.65002500000014,61.67811881230967,-2.7630910915320634,69.28334416638882,65.72172801970518,-2947913.8497056,-276128.66028754134,92.0,8.0,68.0,48.800048999999944,2088.9333496666663,2101.9167483333326,2118.2834476666662,2131.2668463333325,2072.5666503333327,2059.5832516666665,2043.2165523333329,0.32708912931057077,155996744.0,-1
2018-12-06,2089.699951,2101.649902,2085.0,2099.199951,2097.050049,2932563.0,2078.4850098,2095.1854625636365,86.75,65.35820244311202,-2.094960792951539,74.15791903630634,61.77599864850593,-2394923.6532453406,-372437.52360380505,88.0,4.0,72.0,73.39990200000011,2095.283284333333,2105.566568666666,2111.9331863333337,2122.2164706666663,2088.916666666666,2078.633382333333,2072.266764666666,0.8528549297167011,158929307.0,+1
2018-12-07,2106.699951,2118.0,2080.300049,2097.050049,2107.600098,2475980.0,2086.3150147,2098.5609242363635,78.30004899999994,64.23712909400746,-2.2001933920704873,76.06600855891247,54.70055004026348,-177344.0133848992,-363569.63677567296,84.0,0.0,76.0,48.300048999999944,2098.450032666666,2116.6000163333324,2136.149983666666,2154.2999673333325,2078.9000653333323,2060.750081666666,2041.2001143333323,0.44429765969722285,156453327.0,-1
2018-12-10,2065.899902,2104.800049,2065.899902,2107.600098,2088.75,2728764.0,2096.5250245,2102.4309393818185,102.10009799999989,67.40301381781684,-1.6837935389133682,78.10996419763387,43.02086626998186,-2523668.8187301066,-461755.96322814736,80.0,0.0,80.0,35.10009799999989,2092.7666830000003,2119.6334640000005,2131.66683,2158.5336110000003,2080.7333170000006,2053.8665360000005,2041.8331700000008,1.0719804220791236,159182091.0,+1
2018-12-11,2056.0,2071.300049,2032.0,2088.75,2059.550049,4726445.0,2100.4200196,2101.0172985636364,38.949951000000056,57.00029483354769,-2.606461086637298,79.29760465056074,14.943580913604693,957290.6629135514,-397253.8438580701,76.0,24.0,84.0,49.84985300000017,2064.016683,2096.0333659999997,2103.3167319999993,2135.3334149999996,2056.7333169999997,2024.7166339999999,2017.4332679999998,1.4440185558038383,154455646.0,-1
2018-12-12,2066.949951,2089.800049,2060.100098,2059.550049,2085.300049,2842622.0,2099.9750245,2093.586394818182,-4.4499510000000555,44.67608516684755,-4.035729368575627,82.17029823011171,14.11809883490054,-100713.12706773254,-383774.7203676002,72.0,20.0,84.0,37.35009799999989,2069.816732,2079.5333659999997,2099.516683,2109.2333169999997,2049.8334149999996,2040.1167809999997,2020.1334639999995,-0.01852019890537676,151613024.0,-1
2018-12-13,2095.0,2125.0,2091.300049,2085.300049,2101.300049,1766059.0,2099.5800294,2090.9182174545454,-3.9499510000000555,54.65257237267486,-2.7753279980420977,82.36246955580918,34.25913113385325,200569.84478593932,-357213.60376971203,68.0,16.0,84.0,16.64990200000011,2100.5333659999997,2109.7666829999994,2134.2333169999997,2143.4666339999994,2076.0667319999993,2066.8334149999996,2042.3667809999993,-0.17804180190054253,153379083.0,+1
2018-12-14,2104.899902,2118.0,2088.050049,2101.300049,2095.699951,1539571.0,2096.6050294,2091.230948290909,-29.75,59.84420158278184,-1.9921659813999046,81.66181676362567,30.121115157028186,1068585.8026324953,-292404.53984233894,64.0,12.0,84.0,37.699951000000056,2102.450032666666,2116.8500163333324,2132.399983666666,2146.7999673333325,2086.9000653333323,2072.500081666666,2056.9501143333323,0.4424047304785232,154918654.0,+1
2018-12-17,2104.0,2132.600098,2099.0,2095.699951,2130.199951,2109331.0,2093.3300294,2091.066388581818,-32.75,57.19955750937452,-2.2662774840920186,76.84102959707752,31.55051863732355,2151783.5859446023,-181305.07957929609,60.0,8.0,80.0,38.90014699999983,2109.1000163333333,2119.2000326666666,2142.7001143333327,2152.8001306666665,2085.5999346666667,2075.4999183333334,2051.999836666667,-0.09821545758586643,152809323.0,-1
2018-12-18,2124.0,2139.0,2102.600098,2130.199951,2135.449951,1853492.0,2095.0200196,2097.770010690909,16.89990200000011,67.43071470249319,-0.5775843857072905,67.52615531286983,41.90422118695914,-1137017.134377303,-224746.53661556914,56.00000000000001,4.0,52.0,75.60009799999989,2123.9333496666663,2145.266601333333,2160.333251666666,2181.666503333333,2108.8666993333327,2087.5334476666662,2072.4667973333326,0.7582397611949637,154662815.0,+1
2018-12-19,2133.100098,2159.399902,2113.550049,2135.449951,2123.449951,2252474.0,2100.0100098000003,2105.1209073090913,49.89990200000011,68.7426626179226,-1.1623933284384351,57.40195819358178,50.57740044904434,589335.5944728813,-187742.80338427593,52.0,0.0,52.0,29.699951000000056,2136.133300666667,2158.7165523333338,2181.9831536666675,2204.566405333334,2112.8666993333336,2090.2834476666667,2067.0168463333334,0.47764388688443626,156915289.0,+1
2018-12-20,2112.550049,2140.449951,2102.649902,2123.449951,2137.449951,1995119.0,2102.4350098000004,2109.3827148,24.25,62.140957033184044,-1.7448045384346973,47.06369940510149,33.74466350662689,-4564974.551348596,-386707.8828371997,96.0,4.0,52.0,65.44995100000006,2122.183268,2141.7166340000003,2159.983317,2179.5166830000003,2103.9165850000004,2084.3832190000003,2066.1165360000005,0.5502651332541917,154920170.0,-1
2018-12-21,2134.0,2149.100098,2109.050049,2137.449951,2111.149902,2555077.0,2106.4750000000004,2115.7490677454543,40.39990200000011,66.47500064461354,-1.065324793439058,41.014504580131415,43.468454965741074,-570767.5087337862,-395074.22946886276,92.0,0.0,52.0,32.699951000000056,2131.8666993333336,2154.6833496666673,2171.9167483333335,2194.733398666667,2114.6333006666673,2091.8166503333337,2074.5832516666674,0.709110293473053,157475247.0,+1
2018-12-24,2104.0,2104.0,2077.350098,2111.149902,2080.649902,1400372.0,2106.8299804000003,2116.599049927273,3.549804000000222,53.25916990650491,-2.3417784068599707,34.174331452555634,-4.983716773771469,-463275.5440432359,-398174.2892222434,88.0,0.0,52.0,33.60009799999989,2097.5,2117.649902,2124.149902,2144.299804,2091.0,2070.850098,2064.350098,1.2682899922108561,156074875.0,-1
2018-12-26,2077.0,2127.0,2069.0,2080.649902,2122.350098,1900479.0,2106.0199706000003,2111.8390356727277,-8.100097999999889,42.067925057702475,-3.82207356560047,27.714996833177793,-17.663939841544156,2121351.664585539,-283650.38223098044,84.0,4.0,52.00000000000001,43.300048999999944,2092.216634,2115.4332679999998,2150.2166340000003,2173.4332679999998,2057.4332679999998,2034.2166339999999,1999.4332679999998,0.20086037931034675,154174396.0,-1
2018-12-27,2133.0,2138.199951,2098.449951,2122.350098,2105.050049,2909967.0,2112.2999755,2114.8081497454546,62.800048999999944,56.49078573727015,-1.7981850981470402,22.379390137960854,26.526574494800492,3256142.0594059406,-122750.72579293844,80.0,0.0,52.0,45.84985300000017,2119.6666666666665,2140.883382333333,2159.4166666666665,2180.633382333333,2101.133382333333,2079.9166666666665,2061.383382333333,0.6012615597484234,157084363.0,+1
2018-12-28,2117.350098,2137.75,2115.5,2105.050049,2122.899902,2353903.0,2114.2749755,2113.489981290909,19.75,50.47532876601282,-2.6378303040707562,19.69399642923827,28.024050699660926,-1530704.9591782826,-186748.6454922723,76.0,4.0,92.0,37.800048999999944,2119.4333496666663,2123.3666993333327,2141.683349666666,2145.6166993333327,2101.1166993333327,2097.1833496666663,2078.8666993333327,-0.4696607191011261,154730460.0,-1
2018-12-31,2137.0,2137.0,2116.699951,2122.899902,2121.699951,1466632.0,2116.4349607999998,2115.0581497454546,21.599853000000167,56.047333245759056,-1.7715007637386309,21.56284400835102,46.04727216137647,-1432145.0411166472,-243357.57256610758,72.0,0.0,92.0,40.050048999999944,2125.5332843333335,2134.366617666667,2145.8333333333335,2154.666666666667,2114.066568666667,2105.2332353333336,2093.766519666667,0.30541556820873056,156197092.0,+1
2019-01-01,2127.649902,2151.0,2105.600098,2121.699951,2148.100098,1593360.0,2119.0349608,2116.015420690909,26.0,55.562438001924626,-1.829739506559152,20.578808475329424,51.69873617769402,1643042.0602275052,-157612.13471185238,68.0,0.0,88.0,60.09985300000017,2126.1000163333333,2146.5999346666667,2171.499918333334,2191.999836666667,2101.2000326666666,2080.700114333333,2055.8001306666665,0.35462307826127304,154603732.0,-1
2019-01-02,2142.800049,2147.5,2119.699951,2148.100098,2128.5,2033558.0,2120.8249755,2121.299991090909,17.900146999999833,63.564598689061334,-0.548427710030061,17.335353774239593,78.03060737306018,-2050780.6940144815,-243665.25104379014,64.0,40.0,80.0,58.0,2138.433349666667,2157.1667483333335,2166.2333986666667,2184.9667973333335,2129.3666993333336,2110.633300666667,2101.5666503333337,1.0215862209451463,156637290.0,+1
2019-01-03,2124.199951,2128.25,2103.0,2128.5,2111.800049,3192916.0,2120.1299804,2122.6954500909096,-6.9499510000000555,55.069507570066364,-1.4997041093821655,17.246424609911628,26.079533258939065,1058671.1007846883,-184468.1441424956,60.0,36.0,80.0,57.550048999999944,2119.9166666666665,2136.833333333333,2145.166666666666,2162.083333333333,2111.583333333333,2094.6666666666665,2086.333333333333,1.00990099009901,153444374.0,-1
2019-01-04,2115.25,2128.5,2110.350098,2111.800049,2117.449951,1821780.0,2118.9649901999996,2121.180917109091,-11.649902000000111,48.674265347939055,-2.3102239984478588,12.879862330046308,17.329266354199707,-1501884.375,-244350.70009056406,56.00000000000001,32.0,72.0,22.25,2116.8833823333334,2123.416666666667,2135.0332843333335,2141.566568666667,2105.266764666667,2098.7334803333333,2087.1168626666667,0.07988753878671337,151622594.0,-1
2019-01-07,2127.699951,2135.350098,2118.0,2117.449951,2120.649902,1346753.0,2116.9649902,2120.905455436364,-20.0,50.90013499827635,-2.0360101434328284,9.234679023812078,34.524135815104515,1637823.2556881662,-158797.33846425806,52.0,28.000000000000004,72.0,31.949951000000056,2123.6000163333333,2129.2000326666666,2140.9501143333327,2146.5501306666665,2111.8499346666667,2106.2499183333334,2094.499836666667,-0.031702933320604185,152969347.0,+1
2019-01-08,2122.0,2123.5,2096.649902,2120.649902,2103.0,2085865.0,2117.9149902000004,2121.5754394,9.5,52.253322657018444,-1.8807028656129297,9.759296321562033,2.955176873966271,-1308238.8608262744,-211044.6803898043,48.0,24.0,68.0,45.39990200000011,2113.5999346666667,2130.5499673333334,2140.4500326666666,2157.4000653333333,2103.6998693333335,2086.749836666667,2076.8497713333336,0.8938514861286577,155055212.0,+1
2019-01-09,2118.0,2121.350098,2102.600098,2103.0,2116.800049,2142157.0,2120.1500000000005,2118.8636229999997,22.35009799999989,44.455855115495595,-2.7373279306242226,7.646980326041103,-21.363196143518522,827049.8376031219,-163858.56593558032,44.0,20.0,24.0,27.800048999999944,2108.9833986666667,2115.3666993333336,2127.7333986666663,2134.1166993333336,2096.6166993333336,2090.2333986666667,2077.8666993333336,0.021328106666672588,152913055.0,-1
2019-01-10,2117.0,2123.800049,2092.649902,2116.800049,2108.5,1922885.0,2119.5949951000002,2118.2545410000002,-5.5500489999999445,51.04625574086405,-1.6666642787524393,8.427289171967004,-25.60050497974712,-808508.4169949146,-193160.8318928228,40.0,16.0,24.0,45.10009799999989,2111.0833333333335,2129.516764666667,2142.2334803333333,2160.6669116666667,2098.366617666667,2079.9331863333337,2067.216470666667,0.7752819593435615,154835940.0,+1
2019-01-11,2113.800049,2124.0,2108.0,2108.5,2111.899902,1602010.0,2119.9399902000005,2116.2372691636365,3.4499510000000555,47.16277780809785,-2.0711500974658867,11.676894327306854,-20.229617737094028,588430.5247771619,-157633.9520441871,36.0,12.0,24.000000000000007,18.14990200000011,2113.5,2119.0,2129.5,2135.0,2103.0,2097.5,2087.0,0.03125,153233930.0,-1
2019-01-14,2109.899902,2109.899902,2098.449951,2111.899902,2101.649902,1213790.0,2118.8399902,2114.7754349454544,-11.0,48.99673248723129,-1.9054628654970707,10.284064586259774,-65.00830793625107,-3567182.125,-312613.41445126967,32.0,8.0,23.999999999999996,23.550048999999944,2106.7499183333334,2115.049885666667,2118.199869333334,2126.499836666667,2103.5999346666667,2095.2999673333334,2092.1499836666667,1.1746732365928894,154447720.0,+1
2019-01-15,2105.050049,2126.5,2102.0,2101.649902,2121.899902,1271889.0,2116.8349853,2111.6499643636366,-20.050048999999944,43.71816672093343,-2.4049755360623726,10.872689969503426,-43.82005684087632,2533740.4632261824,-183233.69273865808,28.000000000000004,4.0,24.0,26.85009799999989,2110.0499673333334,2118.0999346666667,2134.5499673333334,2142.5999346666667,2093.5999346666667,2085.5499673333334,2069.0999346666667,-0.014289714285709755,153175831.0,-1
2019-01-16,2120.050049,2125.0,2108.25,2121.899902,2120.199951,1313113.0,2114.2149657,2112.570858309091,-26.200195999999778,54.814858716025874,-1.418133430799215,10.179856721552824,4.521123937094977,1906072.0,-88265.2521596281,24.0,0.0,24.0,18.75,2118.383300666667,2128.5166013333337,2135.1333006666664,2145.2666013333337,2111.7666013333337,2101.633300666667,2095.0166013333337,0.8149195223880663,154488944.0,+1
2019-01-17,2125.25,2135.899902,2113.350098,2120.199951,2132.300049,2060057.0,2113.3849608,2113.659037454546,-8.300048999999944,53.78763038044981,-1.500977046783623,8.380547104211018,38.6405324354516,-931329.0,-126586.33160691778,20.0,0.0,24.0,31.150146999999833,2123.1499836666667,2132.9498693333335,2145.6997876666674,2155.4996733333337,2110.4000653333333,2100.6001796666665,2087.850261333333,0.30376552275133295,152428887.0,-1
2019-01-18,2135.0,2139.0,2114.550049,2132.300049,2130.25,1301994.0,2115.4349608,2117.0981444,20.5,59.95152328867604,-0.9113036549707629,1.1807558975679058,74.31216214714401,633500.775,-92036.91767023968,16.0,32.0,24.0,16.0,2128.616699333333,2142.6833496666663,2153.0666503333337,2167.1333006666664,2118.2333986666663,2104.166748333333,2093.7834476666662,0.7259728250580118,153730881.0,+1
2019-01-21,2139.949951,2166.5,2126.5,2130.25,2148.149902,4390378.0,2116.7149657,2119.7917878909093,12.800048999999944,58.42802724716703,-1.7533252720677146,-2.119902174379604,162.40672940134894,2003523.8127269766,3215.8428023611327,12.0,28.000000000000004,24.0,11.449951000000056,2141.0833333333335,2155.666666666667,2181.083333333334,2195.666666666667,2115.666666666667,2101.0833333333335,2075.666666666667,0.09375,149340503.0,-1
2019-01-22,2146.0,2146.800049,2129.050049,2148.149902,2135.850098,2199244.0,2119.4649657,2125.5072308545455,27.5,66.90184643225865,-0.8875500846432837,-1.7486756096932368,145.5425637427185,3973626.3241129606,183689.0464982976,96.0,24.0,24.000000000000004,24.5,2141.3333333333335,2153.616617666667,2159.0833333333335,2171.366617666667,2135.866617666667,2123.5833333333335,2118.116617666667,1.0760480563380375,151539747.0,+1
2019-01-23,2134.0,2135.850098,2101.449951,2135.850098,2105.399902,1906072.0,2122.7499755000003,2128.4863458181817,32.85009799999989,57.59396243720897,-1.4824620072551444,-2.7307376818662306,20.840713416309068,4739339.493806461,390764.06683048705,92.0,20.0,24.0,23.35009799999989,2124.383382333333,2147.316813666666,2158.7835293333324,2181.7169606666657,2112.916666666666,2089.983235333333,2078.516519666666,1.0,149633675.0,-1
2019-01-24,2110.0,2121.649902,2097.899902,2105.399902,2102.25,2527893.0,2121.6099608000004,2125.331787,-11.400146999999833,41.21441748717751,-2.9552647158403818,-2.7733437553715703,-98.10192431137712,-2590920.236832436,255232.96211853588,88.0,16.0,20.0,22.549804000000222,2108.3165686666666,2118.733235333333,2132.066568666666,2142.483235333333,2094.983235333333,2084.5665686666666,2071.233235333333,0.3157894736842105,147105782.0,-1
2019-01-25,2093.0,2110.0,2090.0,2102.25,2096.0,2815559.0,2120.9849608000004,2121.8117941272726,-6.25,39.86131301335043,-3.1076178960096734,-0.09151990108466634,-142.35232662124326,-3264545.0713026673,95243.05150848106,84.0,12.0,-16.0,24.449951000000056,2100.75,2111.5,2120.75,2131.5,2091.5,2080.75,2071.5,0.6125,144290223.0,-1
2019-01-28,2090.0,2102.050049,2076.75,2096.0,2084.149902,3840109.0,2119.3949706000003,2117.269073981818,-15.899902000000111,37.07461626724609,-3.409915356711004,-0.1258458452857667,-186.6558722444911,-964492.3387067846,47073.261044150764,80.0,8.0,-16.000000000000004,40.0,2091.6000163333333,2106.4500326666666,2116.9000653333333,2131.7500816666666,2081.1499836666667,2066.2999673333334,2055.8499346666667,0.76086809159935,140450114.0,-1
2019-01-29,2078.25,2083.0,2053.0,2084.149902,2057.600098,3690697.0,2117.6449706,2110.8608796909093,-17.5,32.15652039897938,-3.983076082224904,1.5593634072374698,-247.70475950400257,-612289.6465505235,17102.219789847364,76.0,4.0,72.0,17.75,2073.383300666667,2093.7666013333337,2103.3833006666664,2123.7666013333337,2063.7666013333337,2043.3833006666669,2033.7666013333337,1.0383300666666704,136759417.0,-1
2019-01-30,2057.25,2057.25,2028.0,2057.600098,2034.699951,4628540.0,2111.2149901999996,2099.9436301272726,-64.29980400000022,23.945015840682245,-5.267226215235797,0.46338021660722006,-302.8377054945411,-2536325.452230898,-98962.67439291389,72.0,96.0,72.0,46.699951000000056,2047.6166993333334,2067.2333986666667,2076.8666993333336,2096.4833986666667,2037.9833986666667,2018.3666993333334,2008.7333986666667,1.0119691623931586,132130877.0,-1
2019-01-31,2031.0,2089.75,2022.0,2034.699951,2079.949951,4144851.0,2102.6649902,2086.0318048181816,-85.5,19.092728200615667,-6.374851221281738,-1.839564874462667,-216.43817645798512,706021.8992964246,-62372.46649794393,68.0,96.0,72.0,37.95019599999978,2048.8166503333337,2075.6333006666673,2116.566650333334,2143.3833006666673,2007.8833006666673,1981.0666503333337,1940.1333006666673,0.18745315129151374,127986026.0,-1
2019-02-01,2079.949951,2117.0,2076.600098,2079.949951,2090.449951,3913547.0,2097.4299803999997,2081.901797690909,-52.35009799999989,44.66057967133612,-4.186217605804108,-3.443029244225727,-45.815794436811196,-1365714.4000020362,-121615.2816572209,64.0,96.0,72.0,20.0,2091.1833496666663,2105.766601333333,2131.583251666666,2146.166503333333,2065.3666993333327,2050.7834476666662,2024.9667973333326,0.08291735460150763,131899573.0,+1
2019-02-04,2095.0,2113.0,2082.649902,2090.449951,2104.899902,1984572.0,2093.4499755,2080.6327014363637,-39.800048999999944,48.977619149755256,-3.6783578718258743,-5.843937250956515,-28.493866696688954,-647785.3280682374,-145532.10194863076,60.0,92.0,72.0,25.5,2095.3666176666666,2108.083333333333,2125.7167156666665,2138.433431333333,2077.733235333333,2065.0165196666667,2047.3831373333333,0.25700243208440293,133884145.0,+1
2019-02-05,2108.0,2119.0,2097.0,2104.899902,2114.050049,2172572.0,2089.1249755000003,2082.7145062545455,-43.25,54.60129017774248,-2.979448512696488,-8.705781718254457,7.138396763777847,684464.0293091843,-107805.0050732755,56.00000000000001,88.0,72.0,43.0,2106.966634,2116.9332679999998,2128.9666340000003,2138.9332679999998,2094.9332679999998,2084.966634,2072.9332679999998,0.35908645454545957,136056717.0,+1
2019-02-06,2116.25,2127.0,2113.600098,2114.050049,2122.649902,2718921.0,2086.9449706000005,2087.2463378,-21.800048999999944,57.98485612829408,-2.536877920193473,-11.427583247933853,39.01599990214658,746293.5206032951,-68982.34481524954,52.0,84.0,-24.0,56.14990200000011,2118.216715666667,2122.833333333334,2131.6166176666675,2136.233235333334,2109.433431333334,2104.816813666667,2096.0335293333337,0.033578678411234034,138775638.0,+1
2019-02-07,2125.050049,2130.0,2105.850098,2122.649902,2117.25,1804327.0,2088.6699706000004,2093.738143509091,17.25,61.12675895959524,-2.1209237243047108,-15.113564923231934,40.66747974864035,2399672.4093946344,43229.23492156346,48.0,80.0,-28.0,67.75,2119.5,2133.149902,2143.649902,2157.299804,2109.0,2095.350098,2084.850098,0.6956468808858994,140579965.0,+1
2019-02-08,2112.0,2144.949951,2106.649902,2117.25,2122.649902,3058911.0,2090.1699706000004,2098.934512490909,15.0,57.985189046150076,-2.382103990326481,-18.874121015945093,48.87569192746809,-150593.8124517376,34419.09640459522,44.0,76.0,-32.0,82.30004899999994,2122.949951,2139.25,2161.25,2177.550049,2100.949951,2084.649902,2062.649902,0.2767646067502395,137521054.0,-1
2019-02-11,2113.300049,2142.899902,2113.300049,2122.649902,2139.649902,1759091.0,2092.8349608,2104.8399545636366,26.64990200000011,60.33723730352715,-1.1793215363869656,-19.597023935049947,56.74417534586685,-288062.4409299004,19760.84470757268,40.0,72.0,-32.0,33.050048999999944,2126.2832843333335,2139.266519666667,2155.8831373333337,2168.8663726666673,2109.666666666667,2096.6834313333334,2080.066813666667,0.31587498086561827,139280145.0,+1
2019-02-12,2138.0,2148.0,2124.800049,2139.649902,2129.699951,2443097.0,2098.3849608,2113.351762054546,55.5,67.03984767677619,-0.40752064421668566,-19.133513779197983,86.06115571702028,-1042376.5675119166,-28518.128575131417,36.0,68.0,-31.999999999999993,28.550048999999944,2137.4833169999997,2150.1665849999995,2160.683268,2173.3665359999995,2126.9666339999994,2114.2833659999997,2103.7666829999994,0.6400812225853465,141723242.0,+1
2019-02-14,2140.0,2140.0,2105.600098,2129.699951,2110.199951,1860347.0,2105.5949461000005,2119.0453966363634,72.09985300000017,60.1726424873571,-0.8931209858467518,-17.775564644710357,44.8605434701007,157255.49822770376,-20073.872811366175,32.0,64.0,-32.0,22.10009799999989,2125.1000163333333,2144.5999346666667,2159.499918333334,2178.999836666667,2110.2000326666666,2090.700114333333,2075.8001306666665,0.700579117928885,139862895.0,-1
2019-02-15,2107.350098,2108.100098,2078.199951,2110.199951,2100.649902,2104131.0,2113.1449461,2119.8826702545452,75.5,48.85581186302383,-1.8448047340165907,-16.220896729175365,-23.010305544556832,832056.7412978715,18659.33692087193,28.000000000000004,60.0,-32.0,24.14990200000011,2098.8333333333335,2119.466715666667,2128.733480333333,2149.3668626666667,2089.566568666667,2068.9331863333337,2059.6664216666672,1.070228852052138,137758764.0,-1
2019-02-18,2106.800049,2118.0,2086.0,2100.649902,2089.899902,1784686.0,2115.2149412000003,2117.6108440545454,20.699951000000056,44.16231571821998,-2.3108881405563637,-10.065666642908127,-12.44882567487746,-2467904.2284595417,-94366.27968732879,24.0,56.00000000000001,-32.0,38.300048999999944,2101.5499673333334,2117.0999346666667,2133.5499673333334,2149.0999346666667,2085.0999346666667,2069.5499673333334,2053.0999346666667,0.45780943750000347,135974078.0,-1
2019-02-19,2089.699951,2108.149902,2078.199951,2089.899902,2084.050049,1317159.0,2115.1599363,2113.0081096545455,-0.5500489999999445,39.263210063931595,-2.8355343094192236,-0.8790251024565805,-34.18142139731096,2482234.5193734486,22751.938451797552,20.0,52.0,-32.0,29.599853000000167,2092.0832516666665,2105.966552333333,2122.033202666666,2135.916503333333,2076.016601333333,2062.1333006666664,2046.0666503333327,0.3906500882088266,134656919.0,-1
2019-02-20,2088.5,2111.0,2081.899902,2084.050049,2108.350098,1223125.0,2113.074951,2107.351766509091,-20.849853000000167,36.70644024082977,-3.121032259638851,2.740155236445389,-29.054437689259487,421221.5796560804,40864.19487017406,16.0,48.0,-32.0,25.35009799999989,2092.3166503333337,2102.733398666667,2121.416748333334,2131.833496666667,2073.6333006666673,2063.2165523333338,2044.5332026666674,0.07388796422609442,133433794.0,-1
2019-02-21,2101.699951,2119.949951,2093.600098,2108.350098,2115.899902,1315386.0,2112.5049559,2106.4927023272726,-5.6999510000000555,51.762219755944855,-1.9350855051244564,5.1395060175536855,28.662964688368035,485960.5117289133,61095.84563648041,12.0,44.0,-32.0,34.39990200000011,2107.300049,2121.0,2133.649902,2147.349853,2094.650147,2080.950196,2068.3002939999997,0.5597754188609669,134749180.0,+1
2019-02-22,2119.399902,2128.100098,2089.100098,2115.899902,2091.449951,2222677.0,2111.8299559,2107.1099652545454,-6.75,55.552469243850844,-1.5666226451927716,7.192446025300342,56.044598492278,-2230604.598568156,-43072.35637282133,8.0,40.0,-31.999999999999996,51.5,2111.033366,2132.9666340000003,2150.0333660000006,2171.9666340000003,2093.9666340000003,2072.033366,2054.9666340000003,0.6871744615384673,136971857.0,+1
2019-02-25,2095.149902,2129.949951,2095.149902,2091.449951,2125.399902,2035149.0,2109.2499510000002,2103.4045098181823,-25.800048999999944,42.943756795101,-2.7598852611029745,7.354111256388478,26.33564276922795,-1036832.1648950434,-88243.2567601951,4.0,36.0,-32.00000000000001,32.0,2105.5166013333333,2115.8833006666664,2140.316650333333,2150.6833496666663,2081.0832516666665,2070.7165523333333,2046.2832026666665,-0.10632028133064012,134936708.0,-1
2019-02-26,2111.25,2125.0,2101.100098,2125.399902,2110.649902,2401857.0,2109.5249510000003,2106.3408645454547,2.75,58.15898960153697,-1.1029818448023372,7.877507807380425,84.81854180136067,1429312.8644090006,-19263.433070686155,0.0,32.0,-32.0,29.949951000000056,2117.1666666666665,2133.233235333333,2141.066568666666,2157.1331373333333,2109.333333333333,2093.2667646666664,2085.433431333333,1.0167323698649522,137338565.0,+1
2019-02-27,2116.100098,2124.449951,2088.149902,2110.649902,2092.25,1757523.0,2106.6249510000002,2106.545401090909,-29.0,51.30092738854848,-1.822845192776959,8.649460253101552,21.196279289115374,-1202714.7,-73056.6724765641,60.0,28.000000000000004,-32.0,29.10009799999989,2107.7499183333334,2127.3499346666667,2144.0499673333334,2163.6499836666667,2091.049885666667,2071.4498693333335,2054.749836666667,0.6198338740534491,135581042.0,-1
2019-02-28,2093.100098,2105.850098,2073.199951,2092.25,2077.550049,2911344.0,2102.8799559,2103.9317736363637,-37.449951000000056,43.857106138157505,-2.7208394338701805,9.29742208241123,-83.65174081793107,1162706.821520716,-16885.604567596776,56.00000000000001,24.0,-32.0,35.89990200000011,2090.4333496666663,2107.6667483333326,2123.0834966666666,2140.3168953333325,2075.016601333333,2057.7832026666665,2042.366454333333,0.5834598233202455,132669698.0,-1
2019-03-01,2086.25,2100.899902,2077.0,2077.550049,2083.350098,2338232.0,2099.6149657,2099.326336018182,-32.64990200000011,38.68295987842554,-3.4382601756954636,6.249596872480652,-121.3950522224063,-1018942.1627906977,-62433.62994137412,52.0,20.0,-32.0,39.0,2085.1499836666667,2093.2999673333334,2109.0498856666673,2117.1998693333335,2069.4000653333333,2061.2500816666666,2045.5001633333331,0.02301469688034461,130331466.0,-1
2019-03-05,2088.899902,2111.100098,2070.0,2083.350098,2107.100098,2959319.0,2097.8849853,2096.369087345455,-17.299804000000222,41.8084787265644,-3.155192874572968,2.4178482384968447,-101.17771643342768,-5472778.083780357,-308358.37784314627,48.0,16.0,-32.0,34.800048999999944,2088.1500653333333,2106.3001306666665,2129.250163333333,2147.4002286666664,2065.2000326666666,2047.0499673333334,2024.0999346666667,0.32481912816850034,133290785.0,+1
2019-03-06,2110.0,2110.300049,2090.550049,2107.100098,2104.25,2114511.0,2099.6050049,2098.044562381818,17.200195999999778,53.10295874931793,-1.996090873596882,1.3885119761598617,-27.1129119549152,-14799573.144324569,-967049.9581377568,44.0,12.0,-32.0,33.550048999999944,2102.6500653333333,2114.7500816666666,2122.400065333333,2134.5000816666666,2095.0000816666666,2082.9000653333333,2075.2500816666666,0.8379771645569593,135405296.0,+1
2019-03-07,2109.600098,2130.0,2095.0,2104.25,2126.5,2551213.0,2101.6250000000005,2098.8891069454544,20.199951000000056,51.7131606947641,-1.7515923566878981,1.1575603513906572,10.844589369773848,-520999.4866653017,-946774.9367071906,40.0,8.0,31.999999999999996,37.25,2109.75,2124.5,2144.75,2159.5,2089.5,2074.75,2054.5,0.2642857142857143,132854083.0,-1
2019-03-08,2115.050049,2130.0,2109.449951,2126.5,2128.199951,1763365.0,2103.4399902,2103.411834218182,18.14990200000011,60.925064229653074,-0.17232890201870998,2.2855652951802767,92.70566714999457,-3851980.9511262593,-1078829.755544421,36.0,4.0,32.00000000000001,37.449951000000056,2121.983317,2134.5166830000003,2142.533366,2155.0667320000002,2113.9666340000003,2101.433268,2093.4165850000004,0.829684104402865,134617448.0,+1
2019-03-11,2132.0,2143.699951,2122.199951,2128.199951,2128.449951,2306027.0,2104.6699951000005,2107.913645272727,12.300048999999944,61.5713579489471,-0.7580574349023398,2.8091917430801914,146.07328925659402,-2624926.258771186,-1149106.8693274558,32.0,0.0,32.0,23.89990200000011,2131.3666176666666,2140.533284333333,2152.866617666667,2162.033284333333,2119.033284333333,2109.8666176666666,2097.533284333333,0.27906976744186046,136923475.0,+1
2019-03-12,2147.0,2175.0,2137.0,2128.449951,2171.0,3774323.0,2108.3699951,2112.2372736181815,37.0,61.678910575755225,-2.24229523121387,-1.360386305807424,211.57465205109278,-480242.53268145176,-1118703.9449344557,28.000000000000004,80.0,32.0,41.10009799999989,2146.8166503333337,2156.6333006666673,2184.816650333334,2194.6333006666673,2118.6333006666673,2108.8166503333337,2080.6333006666673,-0.22500128947368275,140697798.0,+1
2019-03-13,2175.0,2234.0,2172.100098,2171.0,2226.550049,14291587.0,2112.9300049000003,2123.6245472363635,45.60009799999989,75.2708844322207,-2.9508196721311477,-2.7889483323688182,392.67492368066337,-1920682.5798548944,-1155157.519249021,96.0,76.0,32.0,26.949951000000056,2192.366699333333,2212.6333006666664,2254.2666013333337,2274.5332026666665,2150.7333986666663,2130.466797333333,2088.833496666666,-0.017772209073931764,154989385.0,+1
2019-03-14,2244.850098,2247.5,2210.600098,2226.550049,2224.75,3844966.0,2124.5200196000005,2144.2827370727273,115.90014699999983,83.88237097854727,-0.9750966255527137,1.4196373690415385,398.9348776055293,4241420.701162557,-909858.5092303127,96.0,72.0,32.0,35.0,2228.216715666667,2245.833333333334,2265.1166176666675,2282.733235333334,2208.933431333334,2191.316813666667,2172.0335293333337,0.4322491425586986,158834351.0,+1
2019-03-15,2231.0,2259.899902,2228.050049,2224.75,2253.0,3190772.0,2137.7700196000005,2162.506369872727,132.5,82.80424396640177,-1.6266325880003725,2.2390857585028243,294.51317979570325,755584.8366449601,-834156.5389632549,96.0,68.0,32.0,25.75,2237.5666503333337,2247.0832516666674,2269.4165033333334,2278.9331046666675,2215.233398666667,2205.7167973333335,2183.383545666667,-0.10361269171320593,155643579.0,-1
2019-03-18,2261.899902,2291.649902,2247.0,2253.0,2261.449951,3589680.0,2155.3150147000006,2183.4572754,175.44995100000006,86.05084644797645,-1.7627028357215646,6.724379043809222,265.2086062698689,-1737452.1290167088,-875215.4294202301,96.0,64.0,32.0,21.5,2263.883300666667,2280.7666013333337,2308.5332026666674,2325.416503333334,2236.1166993333336,2219.2333986666667,2191.4667973333335,0.1343787943812281,159233259.0,+1
2019-03-19,2269.5,2275.899902,2251.0,2261.449951,2267.75,2989498.0,2173.1250000000005,2202.754536545455,178.09985300000017,86.90418989075334,-1.3773266298670628,15.21099167084958,193.7917362001216,1105163.473262237,-785198.206571027,96.0,60.0,-52.0,46.800048999999944,2262.783284333333,2274.566568666666,2287.6831863333337,2299.4664706666663,2249.666666666666,2237.883382333333,2224.766764666666,0.41967839873426044,162222757.0,+1
2019-03-20,2269.0,2300.0,2261.050049,2267.75,2299.0,2927998.0,2189.1899902,2219.9590820000003,160.6499020000001,87.55893348211443,-1.465243071331213,26.59822644021915,169.65608558695482,-1835716.2035601253,-832949.0246159862,92.0,56.00000000000001,20.0,105.55004899999994,2276.266683,2291.4833169999997,2315.216634,2330.4332679999998,2252.5333659999997,2237.316732,2213.5834149999996,0.17201436273950757,165150755.0,+1
2019-03-22,2300.0,2307.0,2270.800049,2299.0,2276.149902,7600970.0,2208.6649902,2239.924538327273,194.75,90.32688876743315,-0.36231884057971014,39.58330745603416,151.07523566625272,-2728653.5185417705,-919117.4107035219,96.0,52.0,24.0,76.5,2292.266683,2313.7333169999997,2328.466634,2349.9332679999998,2277.5333659999997,2256.066732,2241.3334149999996,0.7790052257253058,172751725.0,+1
2019-03-25,2260.0,2287.850098,2253.0,2276.149902,2281.300049,2299815.0,2223.6299804,2252.1945222909094,149.6499020000001,76.05129935392722,-1.3971964673912993,51.10824875227945,104.2166685203009,1432900.3284692194,-812207.5134683972,96.0,48.0,28.0,33.34985300000017,2272.3333333333335,2291.666666666667,2307.183431333333,2326.516764666667,2256.816568666667,2237.4832353333336,2221.966470666667,0.6642707862686694,170451910.0,-1
2019-03-26,2275.899902,2315.0,2272.600098,2281.300049,2311.350098,2946712.0,2238.9399902,2262.679989309091,153.1000979999999,76.99676421565333,-1.520755911552349,63.791317201316815,103.42910900921059,-1003995.7238505378,-820925.159394858,92.0,44.0,32.0,66.89990200000011,2289.6333823333334,2306.666666666667,2332.0332843333335,2349.066568666667,2264.266764666667,2247.2334803333333,2221.8668626666667,0.20518799784018446,173398622.0,+1
2019-03-27,2318.550049,2328.050049,2279.050049,2311.350098,2299.449951,3471325.0,2257.2300049,2275.8454634545456,182.90014699999983,81.8269578159659,-0.7491958741568865,74.23241247616306,100.12820058011877,-523383.63636363635,-807400.5447116208,96.0,40.0,36.0,24.89990200000011,2306.1500653333333,2333.2500816666666,2355.150065333333,2382.2500816666666,2284.2500816666666,2257.1500653333333,2235.2500816666666,0.6591846734693866,176869947.0,+1
2019-03-28,2298.800049,2325.0,2287.850098,2299.449951,2302.800049,4888582.0,2270.0750000000003,2283.521817290909,128.44995100000006,74.66325478903111,-1.2830621731813743,84.81899262531351,82.18329607739346,-1831347.8851625125,-853943.605641207,96.0,36.0,35.99999999999999,38.949951000000056,2304.1000163333333,2320.3499346666667,2341.249918333334,2357.499836666667,2283.2000326666666,2266.950114333333,2246.0501306666665,0.3122445114390916,171981365.0,-1
2019-04-01,2325.25,2332.0,2304.600098,2302.800049,2311.800049,2411769.0,2277.7,2289.4718262,76.25,75.36384989982989,-1.307655665024633,96.12164647763348,74.7727114910979,304235.0946069916,-801299.1192662888,92.0,32.0,44.0,39.25,2313.1333823333334,2321.666666666667,2340.5332843333335,2349.066568666667,2294.266764666667,2285.7334803333333,2266.8668626666667,-0.06569545394724176,174393134.0,+1
2019-04-02,2320.0,2320.0,2285.449951,2311.800049,2294.850098,2727624.0,2286.4050049,2295.671835109091,87.05004899999994,77.30879250460312,-0.9046104343931956,102.65648430588817,58.08147307789674,658616.4416000167,-734939.321045093,96.0,28.000000000000004,48.0,46.0,2305.75,2326.050049,2340.300049,2360.600098,2291.5,2271.199951,2256.949951,0.7626645623570586,177120758.0,+1
2019-04-03,2292.100098,2316.0,2288.25,2294.850098,2292.75,1914863.0,2290.5900147,2297.207306581818,41.85009799999989,65.98809060000815,-1.6636767577250386,103.38655329677749,45.06770455352598,30347441.745283023,677896.1819698225,92.0,24.0,48.0,42.39990200000011,2299.7000326666666,2311.1500653333333,2327.4500326666666,2338.9000653333333,2283.4000653333333,2271.9500326666666,2255.6500653333333,0.23784136936936537,175205895.0,-1
2019-04-04,2292.75,2313.0,2280.0,2292.75,2283.949951,2302888.0,2293.7200196000003,2297.600031181818,31.300048999999944,64.63498668858581,-1.7577250335871024,105.21835088278476,35.028570795843024,-2130789.376264733,550228.6565955244,88.0,20.0,56.0,49.0,2295.25,2310.5,2328.25,2343.5,2277.5,2262.25,2244.5,0.38636363636363635,172903007.0,-1
2019-04-05,2287.800049,2313.75,2282.0,2283.949951,2305.600098,2087795.0,2295.3400147,2295.8236550727274,16.199951000000056,58.80493020844365,-2.1518158978952058,101.74330628472217,28.41061137946833,-1060773.6602819283,477001.27855564014,84.0,16.0,60.0,37.14990200000011,2293.233317,2304.4666340000003,2324.983317,2336.2166340000003,2272.7166340000003,2261.483317,2240.9666340000003,0.061415779527560804,170815212.0,-1
2019-04-08,2319.0,2322.949951,2280.100098,2305.600098,2289.399902,1599533.0,2296.0000245,2297.6891247636363,6.600097999999889,67.20274451425057,-1.1822616211374881,99.85364422527437,29.66662302161585,-2393879.0875762044,346506.71645873797,80.0,12.0,60.0,32.550048999999944,2302.883382333333,2325.666666666666,2345.733235333333,2368.516519666666,2282.816813666666,2260.033529333333,2239.9669606666657,0.5951012247346543,172414745.0,+1
2019-04-09,2296.600098,2303.0,2267.0,2289.399902,2287.25,2694400.0,2297.3250245000004,2296.489102490909,13.25,57.144882079292735,-1.907751813703533,95.88383791162505,14.489264561974629,-880480.3976131976,290734.5749100136,76.0,8.0,68.0,34.550048999999944,2286.466634,2305.9332679999998,2322.4666340000003,2341.9332679999998,2269.9332679999998,2250.466634,2233.9332679999998,0.622219500000003,169720345.0,-1
2019-04-10,2250.0,2284.0,2231.0,2287.25,2237.350098,27032175.0,2297.9200195999997,2294.6572798545453,5.9499510000000555,55.86461149842263,-2.0040304523063144,86.23822444613688,-3.2255722003333016,691636.9627273463,308957.41071989236,72.0,4.0,68.0,27.75,2267.4166666666665,2303.833333333333,2320.416666666666,2356.833333333333,2250.833333333333,2214.4166666666665,2197.833333333333,1.0613207547169812,142688170.0,-1
2019-04-11,2244.899902,2263.0,2236.949951,2237.350098,2257.5,2198325.0,2290.5200196,2283.6445668363635,-74.0,34.915318558261106,-4.23868795342589,77.20661717041412,-25.091575439332534,106525.1321784557,299755.9435134634,68.0,0.0,68.0,33.0,2245.7666830000003,2254.5834150000005,2271.816732,2280.6334640000005,2228.5333660000006,2219.7166340000003,2202.4833170000006,0.015360700473148222,140489845.0,-1
2019-04-12,2252.100098,2272.199951,2252.100098,2257.5,2265.25,2292611.0,2286.3250245000004,2277.640926909091,-41.949951000000056,44.59578995713207,-3.3363188535602326,67.94730693587508,-17.289383569959536,457825.95101950405,306940.9438546471,64.0,0.0,68.0,31.75,2260.6000163333333,2269.0999346666667,2280.6998693333335,2289.199787666667,2249.0000816666666,2240.500163333333,2228.9002286666664,0.2686538055775864,142782456.0,+1
2019-04-15,2270.0,2292.899902,2264.350098,2265.25,2288.800049,2554945.0,2282.5700196000003,2273.8091042727274,-37.550048999999944,48.026443265567295,-2.989252127183162,55.70727924496714,-8.218610984792766,-3381880.849994054,139267.22595243328,60.0,0.0,68.0,42.84985300000017,2274.1666666666665,2283.983235333333,2302.716470666667,2312.5330393333334,2255.433431333333,2245.6168626666663,2226.8836273333327,0.03152042655004231,145337401.0,+1
2019-04-16,2290.949951,2309.899902,2280.300049,2288.800049,2305.050049,2068444.0,2280.2700196,2274.941836890909,-23.0,57.29743241457532,-1.934614912673536,44.892350336931486,8.563885278853947,304394.9184650679,146773.03015755303,56.00000000000001,0.0,68.0,38.60009799999989,2293.0,2305.699951,2322.599853,2335.299804,2276.100098,2263.400147,2246.5002449999997,0.28716358827862937,147405845.0,+1
2019-04-18,2313.0,2315.050049,2288.0,2305.050049,2293.649902,2653714.0,2281.2900147,2279.4472967818183,10.199951000000056,62.60790198949454,-1.2068943573667736,34.90542183349953,19.573695212856208,-1562392.4158556378,69083.69170240793,52.0,0.0,68.0,58.39990200000011,2302.700032666666,2317.4000653333323,2329.750081666666,2344.4501143333323,2290.3500163333324,2275.6499836666662,2263.2999673333325,0.6303149025718948,150059559.0,+1
2019-04-22,2325.0,2325.0,2261.0,2293.649902,2268.699951,5245105.0,2281.3800049000006,2281.6945490181815,0.899902000000111,56.881821789581586,-1.7174248992386874,22.968621725350204,6.630452221656558,-2749960.552977551,-59054.68305577211,48.0,0.0,68.0,50.300048999999944,2293.216634,2325.4332679999998,2357.2166340000003,2389.4332679999998,2261.4332679999998,2229.216634,2197.4332679999998,0.5101547187500017,144814454.0,-1
2019-04-23,2277.550049,2290.0,2241.600098,2268.699951,2245.300049,3820600.0,2279.8550049000005,2279.389084672727,-15.25,46.20934456475893,-2.834753649798475,12.173561260516635,-37.688673881891454,-4302518.455440288,-251939.3999823412,44.0,0.0,64.0,34.84985300000017,2266.766683,2291.9332679999998,2315.166585,2340.33317,2243.5333659999997,2218.3667809999997,2195.1334639999995,0.5599154518949254,140993854.0,-1
2019-04-24,2250.0,2283.899902,2247.050049,2245.300049,2279.75,3088532.0,2273.8250000000007,2273.1063654181817,-60.300048999999944,38.4104450180361,-3.58041109613657,3.199225031738024,-58.24105975658463,-3288937.1808260623,-389984.7536570559,40.0,0.0,60.0,35.39990200000011,2258.75,2270.449951,2295.599853,2307.299804,2233.600098,2221.900147,2196.7502449999997,-0.047490013053783205,137905322.0,-1
2019-04-25,2286.899902,2298.800049,2257.949951,2279.75,2263.449951,4521659.0,2272.8600098,2274.183638145454,-9.649902000000111,52.133668574018294,-2.0327942497753817,-0.6615819694752645,-19.54345037006754,6602854.865295188,-72128.40734104459,36.0,0.0,56.00000000000001,44.64990200000011,2278.8333333333335,2299.716715666667,2319.6834313333334,2340.566813666667,2258.866617666667,2237.9832353333336,2218.016519666667,0.5336596499719537,142426981.0,+1
2019-04-26,2265.899902,2285.0,2256.899902,2263.449951,2280.949951,2926892.0,2270.4800049000005,2272.472718363636,-23.800048999999944,46.47961635706208,-2.765051617250671,-8.352929570031392,-50.705107935059644,-1184667.3433666932,-122698.35897857412,32.0,60.0,52.0,27.050048999999944,2268.449951,2280.0,2296.5500490000004,2308.100098,2251.899902,2240.349853,2223.799804,0.23309701624528037,139500089.0,-1
2019-04-30,2285.0,2320.0,2278.399902,2280.949951,2317.449951,3134209.0,2274.8399902,2274.3763449272724,43.59985300000017,52.818468318831584,-1.9788880952380925,-12.051790103087114,26.563647206629952,2771743.529167897,8867.181391720138,28.000000000000004,56.00000000000001,48.0,64.0,2293.1166176666666,2307.833333333333,2334.7167156666665,2349.433431333333,2266.233235333333,2251.5165196666667,2224.6331373333333,0.06129911040113298,142634298.0,+1
2019-05-02,2323.5,2359.649902,2317.5,2317.449951,2355.800049,4292325.0,2280.8349853,2282.123610527273,59.949951000000056,63.283778317290825,-1.8667176621495307,-14.219655526764654,174.09341017106047,3409241.2967045405,163429.64117866664,24.0,52.0,44.0,52.04980400000022,2331.533284333333,2345.566568666666,2373.6831863333337,2387.7164706666663,2303.416666666666,2289.383382333333,2261.266764666666,-0.0011874048959815936,146926623.0,+1
2019-05-03,2364.199951,2378.0,2356.5,2355.800049,2367.949951,3087880.0,2289.8899902,2295.753622109091,90.55004899999994,71.06467921078793,-0.9741093023255838,-7.936467076805911,289.1066178031634,-2719630.392350394,32381.457836436515,96.0,48.0,40.0,36.84985300000017,2363.4333496666663,2370.3666993333327,2384.933349666666,2391.8666993333327,2348.8666993333327,2341.9333496666663,2327.3666993333327,-0.03255586046511886,150014503.0,+1
2019-05-06,2348.0,2351.899902,2317.050049,2367.949951,2328.449951,3437023.0,2297.8049804,2309.9463422545455,79.14990200000011,73.14509314683832,-0.4409850372970577,-1.5087779495270297,173.85386986610638,-29056.557944258395,29588.820755495835,96.0,44.0,36.0,53.5,2345.633300666667,2374.2165523333338,2380.4831536666675,2409.066405333334,2339.3666993333336,2310.7834476666667,2304.5168463333334,1.4605485423424847,153451526.0,+1
2019-05-07,2351.899902,2358.0,2318.0,2328.449951,2322.350098,2480966.0,2300.1449706000003,2315.518155090909,23.39990200000011,57.607810972024545,-2.174201360245719,2.0188184207590893,114.24464482642544,-899244.4187536822,-12630.871949466835,92.0,40.0,-28.0,28.10009799999989,2334.8166503333337,2351.6333006666673,2374.816650333334,2391.6333006666673,2311.6333006666673,2294.8166503333337,2271.6333006666673,0.2612487750000014,150970560.0,-1
2019-05-08,2322.550049,2323.800049,2288.0,2322.350098,2307.25,3016052.0,2303.0149902000003,2319.5554509818185,28.700195999999778,55.50690298324556,-2.4418561649846473,2.7691282454907196,46.828949376930694,-1218072.10522103,-67423.65527999248,88.0,36.0,-28.000000000000004,56.550048999999944,2311.383382333333,2334.766764666666,2347.183431333333,2370.566813666666,2298.966715666666,2275.583333333333,2263.166666666666,0.9594986308538277,147954508.0,-1
2019-05-09,2300.0,2300.0,2271.600098,2307.25,2290.899902,2256931.0,2306.8699951,2320.3254527636363,38.550048999999944,50.270345959137224,-3.1044317683194387,2.842031586765188,-1.7056292007477203,-1321053.0161110712,-124406.80804504156,84.0,32.0,-28.0,78.69995100000006,2292.9500326666666,2314.2999673333334,2321.3499346666667,2342.6998693333335,2285.9000653333333,2264.5501306666665,2257.500163333333,1.2552825710454907,145697577.0,-1
2019-05-10,2291.350098,2324.899902,2291.350098,2290.899902,2296.5,2648550.0,2311.4299804,2317.4217994727273,45.59985300000017,44.969934363875886,-3.8218559894690607,3.3368838806864005,23.857639901108445,-3811217.925737638,-291989.13157652336,80.0,28.000000000000004,48.0,60.550048999999944,2302.383300666667,2313.416503333334,2335.9331046666675,2346.966307333334,2279.8666993333336,2268.8334966666666,2246.3168953333334,-0.013418737110946311,143049027.0,-1
2019-05-13,2296.050049,2313.350098,2280.0,2296.5,2287.199951,2767908.0,2313.1049804000004,2314.707257581818,16.75,47.17129336320275,-3.5761298815269855,7.7843469676649875,6.854292751907449,-7123561.685725101,-602515.1567650953,76.0,24.0,52.0,38.75,2296.616699333333,2313.2333986666663,2329.9667973333326,2346.583496666666,2279.8833006666664,2263.2666013333333,2246.5332026666665,0.49475116984663897,145816935.0,+1
2019-05-14,2296.699951,2311.0,2275.550049,2287.199951,2287.899902,2623686.0,2315.4799804000004,2309.9972522363637,23.75,43.81290864513129,-3.9842057481351443,16.304468155636187,-11.266284425677558,819107.8162186976,-537895.9307203774,72.0,20.0,52.0,49.949951000000056,2291.25,2306.949951,2326.699951,2342.399902,2271.5,2255.800049,2236.050049,0.3286295656656928,143193249.0,-1
2019-05-15,2296.0,2307.199951,2282.199951,2287.899902,2286.699951,2239087.0,2316.1749755,2304.982692527273,6.9499510000000555,44.15816576582491,-3.9534926722246553,19.571306067218302,-14.512387228790079,-1152123.5975801474,-565815.3701230942,68.0,16.0,52.0,40.449951000000056,2292.433268,2302.6665850000004,2317.433268,2327.6665850000004,2277.6665850000004,2267.433268,2252.6665850000004,0.22799804000000223,145432336.0,+1
2019-05-16,2280.550049,2319.0,2280.0,2286.699951,2310.649902,2012534.0,2313.0999755000003,2299.623597163636,-30.75,43.62787515706617,-4.006145195261078,25.302005555282904,-12.105800224537983,3594386.605958394,-376715.2803012082,64.0,12.0,52.0,50.75,2295.233317,2310.4666340000003,2334.233317,2349.4666340000003,2271.4666340000003,2256.233317,2232.4666340000003,0.17179361538461682,143419802.0,-1
2019-05-17,2313.0,2369.300049,2311.600098,2310.649902,2362.100098,3689695.0,2308.5849608000003,2299.1781292545456,-45.15014699999983,55.84065564572899,-2.9552478279947296,29.118852589704147,90.54256201406157,-4621290.828382642,-569650.532486728,60.0,8.0,52.0,33.54980400000022,2330.5166830000003,2349.4332680000007,2388.2166340000003,2407.1332190000007,2291.7333170000006,2272.8167320000002,2234.0333660000006,-0.0164678822690816,147109497.0,+1
2019-05-20,2408.0,2438.699951,2380.0,2362.100098,2432.350098,4424908.0,2307.9999755000003,2308.9081542,-5.8498530000001665,71.26927449071223,-3.2739177930597894,30.807840511372888,257.9195668394954,-2878770.26618777,-674610.52038223,56.00000000000001,4.0,52.0,33.35009799999989,2393.6000163333333,2407.2000326666666,2452.2999673333334,2465.8999836666667,2348.5000816666666,2334.9000653333333,2289.8001306666665,-0.30493895982979774,151534405.0,+1
2019-05-21,2438.0,2449.399902,2399.449951,2432.350098,2403.699951,2581294.0,2318.3899902000003,2331.517267381818,103.90014699999983,81.46933336481534,-0.7254001323558692,27.98764726991749,277.88346507347694,539240.4728574456,-619435.4752349721,96.0,0.0,52.0,35.449951000000056,2427.066650333333,2454.6833496666663,2477.0166013333333,2504.6333006666664,2404.7333986666663,2377.116699333333,2354.7834476666662,0.6586622477367354,154115699.0,+1
2019-05-22,2411.850098,2426.0,2394.25,2403.699951,2405.75,2846665.0,2326.5249755,2347.0281693454544,81.34985300000017,69.80704507093077,-1.9443478942078367,22.458465667898054,170.10029427906574,-780185.4895443643,-626742.2940672172,96.0,0.0,52.0,25.0,2407.983317,2421.7166340000003,2439.733317,2453.4666340000003,2389.9666340000003,2376.233317,2358.2166340000003,0.2976362519685057,151269034.0,-1
2019-05-23,2409.0,2439.899902,2319.100098,2405.75,2332.100098,8270499.0,2336.3749755,2361.4327192545456,98.5,70.15972257663668,-1.857126609087142,19.123057340450032,110.73041356199224,-1822837.396157232,-681110.2532531269,92.0,20.0,52.0,39.0,2388.25,2457.399902,2509.049804,2578.1997060000003,2336.600098,2267.450196,2215.8002939999997,0.7173016770788796,159539533.0,+1
2019-05-24,2359.699951,2386.149902,2340.149902,2332.100098,2373.350098,3423200.0,2340.4949951000003,2360.6554688,41.20019599999978,47.27095686498693,-4.990631760160795,16.050191294167234,41.07715564959773,,-681110.2532531269,88.0,16.0,52.0,82.60009799999989,2352.7999673333334,2365.4500326666666,2398.7999673333334,2411.4500326666666,2319.4500326666666,2306.7999673333334,2273.4500326666666,-0.17499573913043961,156116333.0,-1
2019-05-27,2378.899902,2421.899902,2372.25,2373.350098,2408.350098,3012256.0,2348.1800049000003,2366.629123872727,76.85009799999989,56.45218128837483,-3.2356112649293425,16.594895618495684,102.71083534097639,,-681110.2532531269,84.0,12.0,52.00000000000001,128.05004899999994,2389.1666666666665,2406.083333333333,2438.816568666667,2455.733235333333,2356.433431333333,2339.5167646666664,2306.783529333333,0.022157103149969694,159128589.0,+1
2019-05-28,2416.5,2420.0,2387.050049,2408.350098,2416.199951,1841210.0,2360.2950196,2377.5691408000002,121.15014699999983,62.79452238709165,-1.7465029659450786,22.1477280987051,117.34999335117612,,-681110.2532531269,80.0,8.0,96.0,87.29980400000022,2405.133382333333,2423.216715666666,2438.0833333333335,2456.166666666666,2390.266764666666,2372.183431333333,2357.316813666666,0.6464364393136702,160969799.0,+1
2019-05-29,2410.199951,2430.800049,2410.199951,2416.199951,2416.899902,1868804.0,2373.1250245,2387.733673781818,128.30004899999994,64.14586006072236,-1.4125235017134565,28.84836466724437,120.71629867836376,,-681110.2532531269,76.0,4.0,96.0,38.10009799999989,2419.0666503333337,2427.9333496666673,2439.6667483333335,2448.533447666667,2407.3332516666674,2398.4665523333338,2386.7331536666675,0.29126075031293697,162838603.0,+1
2019-05-30,2416.0,2447.899902,2413.050049,2416.899902,2439.550049,2339789.0,2386.1450196,2395.6927424181818,130.19995100000006,64.27934443874946,-1.3827434204853877,36.973029194874016,110.28502307428734,,-681110.2532531269,72.0,0.0,72.0,120.79980400000022,2425.949951,2438.849853,2460.7998039999998,2473.6997060000003,2404.0,2391.100098,2369.150147,0.1104697055680593,165178392.0,+1
,,,,,,,,,,,,,,1733430.537113034,-544246.1035832928,68.0,0.0,72.0,65.60009799999989,,,,,,,,,165178392.0,-1
,,,,,,,,,,,,,,-19265.16174309909,-514818.8804401224,64.0,4.0,72.0,89.79980400000022,,,,,,,,,165178392.0,-1
,,,,,,,,,,,,,,-3486808.2015782497,-679663.1968228549,60.0,0.0,72.0,46.64990200000011,,,,,,,,,165178392.0,-1
,,,,,,,,,,,,,,1807047.1579978818,-543102.525479192,56.00000000000001,24.0,72.0,22.449951000000056,,,,,,,,,165178392.0,-1
,,,,,,,,,,,,,,799992.5652173912,-470036.1814148298,52.0,20.0,72.0,34.84985300000017,,,,,,,,,165178392.0,-1
