date,open,high,low,close,Adj Close,volume,SMA,WMA,MOM,RSI,WilliamK,MACD,CCI,acc_dist,AD21,Arronup,AroonDown,AroonOscillator,ATR,Pivot_Point,Resistance_1,Resistance_2,Resistance_3,Support_1,Support_2,Support_3,SO%k,On_Balance_Volume,y
2013-10-09,378.375,391.424988,376.25,379.26901200000003,239.75524900000002,17371792.0,377.2651000000001,377.6866548727273,1.8440240000000472,55.18519256452854,-4.156955287282068,-3.9012732379651993,63.477153328325066,-7949440.34105657,-3861279.6553390864,20.0,36.0,-16.0,4.450012000000015,382.31466666666665,388.3793333333333,397.48965466666664,403.5543213333333,373.2043453333333,367.13967866666667,358.02935733333334,0.19894658236303284,289892312.0,+1
2013-10-10,390.63800000000003,395.118988,386.343994,388.73098799999997,241.12381000000002,17434688.0,378.44939880000004,379.7713617818182,11.842987999999934,74.40275677998201,-2.1572409264076082,-2.688190640164919,220.36333777326658,-54598368.84589018,-6203094.4106534,16.0,32.0,-16.0,15.174987999999985,390.0646566666667,393.78531933333335,398.8396506666666,402.56031333333334,385.01032533333336,381.2896626666667,376.23533133333336,0.2720222942602537,307327000.0,+1
2013-10-11,416.875,417.25,394.600006,390.950012,252.448792,41290600.0,379.9238006,382.04420054545454,14.74401800000004,77.06420855483289,-8.263939670070695,-1.91032100546812,371.91540981565157,-6543887.196189778,-6218812.97602541,12.0,28.000000000000004,-16.0,15.84997599999997,400.9333393333333,407.26667266666664,423.58333333333337,429.91666666666663,384.61667866666664,378.28334533333333,361.96668466666665,-0.16114768065722196,348617600.0,+1
2013-10-14,407.0,416.944,407.0,409.31201200000004,256.292511,12231712.0,383.20120239999994,387.3875117090909,32.77401800000007,88.49026837957132,-2.4942617439120065,-0.924673351633146,403.70950416006355,-5294001.227534625,-6176185.912764095,96.0,24.0,-16.000000000000004,28.519012000000032,411.08533733333337,415.17067466666674,421.0293373333334,425.11467466666676,405.2266746666667,401.14133733333335,395.2826746666667,0.2325032180209206,360849312.0,+1
2013-10-15,415.5,420.881012,414.100006,415.544006,258.639923,9221320.0,387.17310180000004,393.2680214545455,39.71899400000001,90.36916054751046,-1.658067981965949,1.075628876665462,335.74197776746564,10784812.360880682,-5394906.410987833,92.0,20.0,72.0,25.993988,416.8416746666667,419.58334333333335,423.6226806666667,426.36434933333334,412.80233733333336,410.0606686666667,406.02133133333336,0.2129477543597541,370070632.0,+1
2013-10-17,416.274994,419.73699999999997,407.5,419.350006,264.60611,11513008.0,391.44560240000004,399.1183676727273,42.72500600000001,91.36273941446032,-0.4756434654182058,2.4797951233162507,231.98251057867606,-8335926.737900671,-5530297.084653334,96.0,16.0,72.0,11.56899999999996,415.529002,423.558004,427.76600199999996,435.79500399999995,411.321004,403.292002,399.08400400000005,0.9683750919343009,381583640.0,+1
2013-10-21,416.625,422.212006,408.13800000000003,414.319,270.026245,9383368.0,398.0818024,405.81311421818185,34.674987999999985,72.57370856478316,-2.4420522299533505,6.973553350029931,146.50564794736837,-3475037.169504587,-5243149.282744272,88.0,8.0,80.0,11.725006000000008,414.8896686666667,421.64133733333335,428.96367466666663,435.7153433333333,407.5673313333334,400.81566266666675,393.4933253333335,0.4391784400262448,380022232.0,+1
2013-10-22,417.25,420.52499400000005,415.674988,416.931,270.585205,7208760.0,402.06990360000003,409.24024105454555,39.881012,74.3772881324605,-1.6339139332590236,9.83829331919111,132.77918698344232,7341073.219406676,-4664793.659313748,96.0,4.0,80.0,14.07400599999994,417.7103273333334,419.7456666666668,422.56033333333346,424.59567266666687,414.89566066666674,412.86032133333333,410.0456546666667,0.25897122601497435,387230992.0,+1
2013-10-23,415.0,417.350006,409.875,417.794006,269.164246,6561584.0,406.07620540000005,412.0991687636363,40.063018000000056,75.00394280054171,-1.3669046687578648,12.19894974025965,97.76722953888812,-1178451.4079872665,-4504646.345518152,92.0,0.0,92.0,6.205994000000032,415.0063373333333,420.1376746666666,422.48134333333337,427.6126806666666,412.6626686666666,407.5313313333333,405.1876626666666,1.059397945633758,393792576.0,+1
2013-10-24,412.78799399999997,421.875,411.256012,415.600006,267.865021,6480560.0,409.7093048000001,413.83076887272733,36.330993999999976,69.98320297948226,-2.045716086425319,14.843735124016916,86.63205167167064,-5337792.464538402,-4542899.031428806,88.0,12.0,92.0,7.475006000000008,416.24367266666667,421.23133333333334,426.8626606666667,431.85032133333334,410.61234533333334,405.62468466666667,399.99335733333334,0.4090779648682161,387312016.0,-1
2013-10-25,416.0,418.75,413.28799399999997,413.593994,269.710876,6011344.0,412.1956054000001,414.53707600000007,24.86300600000004,65.36697925722318,-2.66636506070878,17.375365505971217,68.8527495177497,2865722.6092939093,-4202899.058370162,84.0,8.0,76.0,10.618988000000002,415.2106626666667,417.1333313333334,420.67266866666665,422.5953373333334,411.67132533333336,409.74865666666665,406.2093193333333,0.056023373097729715,381300672.0,-1
2013-10-28,414.649994,416.86199999999997,411.64401200000003,416.444,269.054779,3412448.0,414.74500420000004,415.30951138181825,25.493988,68.74647704482844,-1.7845890291587614,20.30424188503605,57.076547889334805,-2216678.3896927265,-4111786.3795757163,80.0,4.0,76.0,5.462006000000031,414.98333733333334,418.32266266666664,420.2013253333333,423.5406506666666,413.1046746666667,409.7653493333334,407.8866866666668,0.9198924949616683,384713120.0,+1
2013-10-29,414.93798799999996,420.618988,413.343994,415.431,270.03857400000004,5200392.0,415.356903,415.43423789090906,6.118987999999945,66.10113234507111,-2.0980056044081454,22.15334766752676,52.52000955749713,4434474.251429179,-3719912.7635935065,76.0,0.0,76.0,5.217987999999934,416.4646606666667,419.5853273333334,423.7396546666667,426.8603213333334,412.3103333333334,409.1896666666667,405.0353393333334,0.28687391357298386,379512728.0,-1
2013-10-30,413.875,417.35598799999997,413.431,416.950012,269.091064,5591088.0,415.49750359999996,415.72389407272726,1.4060059999999908,68.21717302635489,-1.6280317260244221,23.984686817679915,42.133814690367274,7187064.71921385,-3219991.973888176,72.0,16.0,76.0,7.274993999999992,415.9123333333334,418.3936666666668,419.83732133333336,422.31865466666676,414.4686786666668,411.9873453333334,410.5436906666668,0.8965663079734373,385103816.0,+1
2013-10-31,413.03799399999997,416.0,412.024994,415.48699999999997,267.957672,9687544.0,415.111203,415.7219843272727,-3.8630060000000412,63.791910684336024,-2.080679515351917,23.207306648145845,31.00644279838169,4786230.712575273,-2853166.683873,68.0,12.0,56.0,3.924987999999985,414.50399799999997,416.98300199999994,418.4790039999999,420.95800799999995,413.00799599999993,410.52899199999996,409.0329899999999,0.8709435910285336,375416272.0,-1
2013-11-01,412.5,414.375,408.674988,413.73699999999997,265.269897,6166704.0,415.6287018,415.4721292363636,5.174987999999928,58.54977119061628,-2.622119798359226,21.69482647509267,19.34977034650807,2758483.347620822,-2596148.072852725,64.0,8.0,56.0,4.925018000000023,412.2623293333333,415.8496706666666,417.96234133333337,421.5496826666666,410.1496586666666,406.5623173333333,404.4496466666666,0.8880704110798308,369249568.0,-1
2013-11-05,406.5,411.319,404.125,409.58700600000003,264.39163199999996,5320232.0,415.1555024,414.3736390909091,-4.731993999999986,47.80143535714519,-3.906104898838425,19.428731748095572,3.351615398832097,-5603595.082386809,-2733844.155349795,60.0,4.0,56.0,6.8120119999999815,408.34366866666664,412.5623373333333,415.5376686666666,419.7563373333333,405.3683373333333,401.1496686666666,398.17433733333326,0.7592446483180453,363929336.0,-1
2013-11-06,409.41299399999997,414.024994,409.41299399999997,408.23098799999997,267.65457200000003,3704664.0,414.2855012,413.1146364727273,-8.700012000000015,44.707159723105846,-4.325649338657304,18.491696640092016,5.672802089210286,-8433480.901468724,-2994716.036591632,56.00000000000001,0.0,56.0,9.611999999999966,410.5563253333333,411.6996566666666,415.16832533333337,416.31165666666664,407.0876566666666,405.94432533333327,402.47565666666657,-0.2562892454466599,360224672.0,-1
2013-11-07,415.205994,424.993988,414.200012,413.26901200000003,271.819641,7192712.0,413.8330018,412.92982025454546,-4.524993999999992,56.717884684674765,-3.5966847339528143,16.872156368163076,26.174474577247228,-5275124.319874657,-3099057.2207359844,52.0,0.0,56.00000000000001,4.612000000000023,417.48767066666665,420.7753293333333,428.2816466666666,431.56930533333326,409.9813533333333,406.69369466666666,399.1873773333333,-0.08625181304831364,367417384.0,+1
2013-11-08,418.75,423.64999400000005,418.75,419.700012,272.017792,8616112.0,414.2430024,413.9965493818182,4.100006000000008,67.2089909861029,-1.6239489668134575,14.934138450231274,34.774841252374536,-2427085.245709599,-3068320.06793992,96.0,0.0,52.0,16.763000000000034,420.70000200000004,422.6500040000001,425.59999600000015,427.54999800000013,417.75001000000003,415.800008,412.850016,0.1938802374043735,376033496.0,+1
2013-11-11,418.75,424.75,417.51300000000003,420.006012,272.224396,7803200.0,414.88420420000006,415.0443693090909,6.412017999999989,67.63963365950588,-1.530082205074286,12.849153926523059,30.587818330556825,3040103.5585834323,-2788990.4909505513,92.0,4.0,96.0,10.380982000000017,420.7563373333333,423.9996746666666,427.9933373333332,431.23667466666654,416.7626746666666,413.51933733333334,409.52567466666665,0.34448141495094325,383836696.0,+1
2013-11-12,420.31201200000004,421.875,416.01300000000003,420.325012,270.13961800000004,6452184.0,415.27230540000005,416.0336070909091,3.8810119999999984,68.14288608204598,-1.432227639731806,11.008749574857234,22.02918194769282,-104914.2561715288,-2666285.105488959,88.0,0.0,88.0,7.236999999999966,419.4043373333334,422.79567466666674,425.26633733333335,428.6576746666667,416.9336746666668,413.5423373333334,411.0716746666668,0.7355871716137847,390288880.0,+1
2013-11-13,414.506012,419.825012,414.506012,417.10598799999997,269.75100699999996,4687512.0,415.4398042,416.3670039272727,1.6749879999999848,57.69574074315486,-2.4196765248321186,9.48068047681403,9.801070447419962,-10610264.518383523,-3029357.5828682655,84.0,0.0,88.0,5.861999999999966,417.1456706666667,419.78532933333344,422.4646706666668,425.10432933333345,414.4663293333334,411.8266706666667,409.1473293333334,0.4888091746568831,385601368.0,-1
2013-11-14,419.03799399999997,421.875,418.756012,416.506012,271.548248,4343528.0,415.39540420000003,416.5608598909091,-0.4440000000000168,55.854162285654304,-2.603721636731535,7.3189052926263685,23.848575100193656,-21984310.52899495,-3895460.6169224405,80.0,4.0,84.0,5.819000000000017,419.0456746666667,419.33533733333337,422.16466266666663,422.4543253333334,416.21634933333337,415.9266866666667,413.09736133333337,-0.7213878347720475,381257840.0,-1
2013-11-18,423.875,426.875,423.48098799999997,419.281006,275.584412,6326536.0,415.7748048,417.26733294545454,3.7940060000000244,62.27955096097473,-2.3161247426610783,5.322837571532659,58.30503781915439,-7456912.416657385,-4058154.229313462,76.0,0.0,76.0,4.769012000000032,423.21233133333334,422.9436746666667,426.6063433333334,426.33768666666674,419.5496626666667,419.8183193333333,416.15565066666665,-1.23746822344763,387584376.0,+1
2013-11-19,425.75,431.0,425.006012,425.51300000000003,278.72943100000003,8975208.0,416.95240480000007,419.03791389090907,11.776000000000067,72.60991983152222,-1.6527108433734838,3.294358040669067,93.0345057996085,4243833.313026775,-3678990.475587187,96.0,0.0,76.0,10.368988000000002,427.17300400000005,429.3399960000001,433.166992,435.3339840000001,423.3460080000001,421.17901600000005,417.3520200000001,0.08458275191742712,396559584.0,+1
2013-11-20,426.125,430.412994,424.375,430.368988,275.430267,4306608.0,419.03060300000004,421.4772926545455,20.78198199999997,78.02161411477098,-0.19006385542168625,2.1294244975463243,104.24674192606376,8925658.111402031,-3103442.8167846506,96.0,0.0,96.0,11.71899400000001,428.38566066666664,432.3963213333333,434.4236546666666,438.4343153333333,426.35832733333325,422.3476666666666,420.3203333333332,0.9927118178653334,400866192.0,+1
2013-11-21,424.5,425.0,414.13800000000003,425.27499400000005,270.747131,8495496.0,420.73500360000014,422.6126364727273,17.04400600000008,62.963864878870396,-1.7243993975903464,1.2156667639145553,38.150198331191156,-1555531.4832344342,-3032777.4296624097,92.0,56.00000000000001,96.0,6.037994000000026,421.470998,428.803996,432.332998,439.66599599999995,417.941996,410.60899800000004,407.07999600000005,1.0253170686798057,392370696.0,-1
2013-11-22,418.25,421.875,417.0,418.044006,271.010071,2720936.0,421.2125030000001,422.1233641818182,4.774993999999992,47.84104166648867,-3.902407831325294,1.8751003299963713,12.079855954341284,747205.687809957,-2860247.3834612416,88.0,52.0,35.99999999999999,16.230987999999968,418.973002,420.946004,423.84800199999995,425.821004,416.071004,414.098002,411.196004,0.21415507692308194,389649760.0,-1
2013-11-25,419.0,422.35000599999995,413.375,418.450012,269.261414,5707296.0,421.087503,421.62109309090914,-1.25,48.64022664659116,-3.780116867469875,3.2206628058618207,0.7173055198866328,1344908.3022609784,-2668347.3330839975,84.0,48.0,36.0,8.27499400000005,418.0583393333333,422.74167866666664,427.0333453333333,431.7166846666666,413.7666726666667,409.08333333333337,404.79166666666674,0.5654605690514349,395357056.0,+1
2013-11-26,415.0,418.625,411.580994,415.75,268.46801800000003,7321096.0,420.6619018,420.6506380000001,-4.256011999999998,43.523171603132774,-4.593373493975903,4.148115679627608,-37.913348416283014,1456489.8010026435,-2480146.4391632685,80.0,44.0,36.0,8.97500599999995,415.3186646666666,419.05633533333327,422.3626706666666,426.1003413333333,412.01232933333324,408.2746586666666,404.9683233333332,0.5918515685534638,388035960.0,-1
2013-11-27,415.0,416.98098799999997,410.725006,414.524994,266.614441,6779624.0,420.0819,419.5348365818181,-5.800018000000023,41.25130603253997,-4.962351204819279,3.5188314881314113,-53.47188640249183,-1684112.2664785164,-2443832.6122048097,76.0,40.0,36.0,7.044006000000024,414.07699599999995,417.4289859999999,420.3329779999999,423.68496799999986,411.17300399999993,407.821014,404.917022,0.6074167093191778,381256336.0,-1
2013-11-28,412.674988,417.25,408.125,411.66299399999997,269.407104,7499968.0,419.5376006000001,418.0041264,-5.442993999999999,36.16266471855217,-5.824399397590371,3.099568782969186,-72.06794558125901,-1971344.7230399882,-2422281.989581942,72.0,36.0,36.0,6.25598199999996,412.345998,416.566996,421.470998,425.691996,407.441996,403.220998,398.316996,0.3877253698630103,373756368.0,-1
2013-11-29,417.0,420.75,413.75,415.975006,271.572815,5411560.0,419.4845000000001,417.35638192727276,-0.5310059999999908,47.43510997324015,-4.525600602409637,2.872996251342613,-13.250172027607585,646231.3697868709,-2282346.059756667,68.0,32.0,36.0,9.125,416.82500200000004,419.9000040000001,423.82500200000004,426.9000040000001,412.9000040000001,409.82500200000004,405.9000040000001,0.3178580000000011,379167928.0,+1
2013-12-02,419.0,422.11199999999997,415.63800000000003,419.319,270.289246,4711376.0,419.4882994000001,417.3262910181818,0.03799400000002606,54.607457561735345,-3.518373493975899,3.2254304983199518,15.00329972602123,-374273.75891543576,-2195343.661888226,64.0,28.000000000000004,36.0,9.08700600000003,419.02299999999997,422.4079999999999,425.49699999999996,428.88199999999983,415.93399999999997,412.54900000000004,409.46000000000004,0.5685820203892527,383879304.0,+1
2013-12-03,415.0,419.93798799999996,415.0,417.33700600000003,271.103271,7001240.0,418.6707,416.93514676363645,-8.175994000000003,49.94669403741088,-4.1153596385542075,3.5071502790922864,-14.249751133757728,-4341028.205256776,-2293166.5317105153,60.0,24.0,36.0,6.473999999999933,417.42499799999996,419.8499959999999,422.36298599999986,424.7879839999999,414.91200799999996,412.48701,409.97402,0.47327089494750674,376878064.0,-1
2013-12-04,418.75,423.25,417.100006,418.593994,272.447144,8443120.0,417.4932006,416.9212002181818,-11.774993999999992,52.889103976330965,-3.73674879518072,3.328389701369929,13.998552104970505,-1141052.05040511,-2240648.176753827,56.00000000000001,20.0,36.0,4.937987999999962,419.64799999999997,422.1959939999999,425.7979939999999,428.3459879999999,416.04599999999994,413.498006,409.89600599999994,0.2429251150488933,385321184.0,+1
2013-12-05,422.5,424.875,417.75,420.66900599999997,271.309906,6317072.0,417.0326018,417.4986193818181,-4.605988000000082,57.633003441240916,-3.1117451807229015,2.486147650429359,30.6971965064851,7524003.333738075,-1795590.936619304,52.0,16.0,36.00000000000001,6.149993999999992,421.098002,424.446004,428.22300199999995,431.571004,417.321004,413.973002,410.196004,0.4096850526315744,391638256.0,+1
2013-12-06,417.381012,418.625,414.774994,418.91299399999997,269.24517799999995,6544848.0,417.1195006,417.84050887272724,0.8689879999999448,52.47348905208902,-3.6406644578313343,0.7649609639747723,-35.76770888354573,-7520559.296963028,-2056493.5472679958,48.0,12.0,36.0,7.125,417.43766266666665,420.1003313333333,421.2876686666667,423.9503373333333,416.2503253333333,413.58765666666665,412.4003193333333,1.0748035197867143,385093408.0,-1
2013-12-09,420.625,423.006012,415.131012,415.725006,270.297638,8856632.0,416.84700000000004,417.5869644,-2.7250060000000076,44.187021905549415,-4.600901807228913,-0.36845830282902625,-26.454999613897172,-9275915.412306989,-2385463.6400839305,44.0,8.0,36.0,5.894011999999975,417.95401,420.77700799999997,425.82901,428.65200799999997,412.90200799999997,410.07901,405.02700799999997,0.0754278095238107,376236776.0,-1
2013-12-10,416.875,423.73098799999997,416.444,417.350006,272.89209,12345896.0,417.0070006000001,417.6784200363636,1.6000060000000076,48.93028784511943,-3.9416040518918267,-0.6245927241758977,0.39039305911681005,3001188.46586129,-2140035.7426385023,40.0,4.0,36.0,7.875,419.17499799999996,421.9059959999999,426.46198599999997,429.19298399999985,414.61900799999995,411.88801,407.33202,0.12433202854183331,388582672.0,+1
2013-12-11,420.625,422.712006,417.5,421.35598799999997,273.175812,6256960.0,417.69010000000003,418.46914501818185,6.830993999999976,58.87240963056555,-1.1177950920245496,-0.9640534893728727,47.93342268603559,2197787.599037829,-1942416.1066940886,36.0,0.0,36.0,8.00598199999996,420.5226646666667,423.54532933333337,425.7346706666667,428.75733533333334,418.3333233333334,415.3106586666667,413.1213173333334,0.7398280048027549,394839632.0,+1
2013-12-12,420.549988,423.212006,418.5,421.79400599999997,272.32547,5520232.0,418.7032012000001,419.21530974545453,10.131011999999998,59.85833030282212,-0.9454527042577775,-1.1821807612022326,71.09558203570742,640495.0201196497,-1824757.673277999,32.0,60.0,36.0,5.361999999999966,421.1686706666666,423.83734133333326,425.88067666666666,428.54934733333323,419.1253353333333,416.45666466666665,414.4133293333333,0.6990665971138377,400359864.0,+1
2013-12-13,418.125,422.5,418.125,420.48098799999997,273.134979,8315624.0,419.1537994000001,419.53854370909085,4.50598199999996,55.27516634073955,-1.348373456079795,-1.3321962452298521,34.89508175951479,-6436421.938106163,-2034810.5719408027,28.000000000000004,56.00000000000001,-28.0,4.712005999999974,420.3686626666667,422.6123253333334,424.74366266666675,426.9873253333334,418.2373253333334,415.9936626666667,413.8623253333334,0.5385115428571355,392044240.0,-1
2013-12-16,422.5,433.0,419.225006,421.73098799999997,279.482025,10117696.0,419.39499820000003,420.0071234545454,2.411987999999951,58.74497031290115,-3.373955688622764,-0.6988245065468277,194.03133391134594,-6866897.951061094,-2254882.7359313327,24.0,52.0,-28.000000000000004,4.375,424.651998,430.07899,438.42699200000004,443.85398399999997,416.303996,410.877004,402.529002,0.18192254747987271,402161936.0,+1
2013-12-17,430.63800000000003,435.61199999999997,430.63800000000003,431.53100599999993,279.81424,10713952.0,420.8143982,422.2136703272727,14.193999999999903,75.75817862924178,-1.212373296258016,0.0589013965412164,442.57376616653784,-2991984.5424484247,-2288450.236166655,96.0,48.0,-28.0,13.774993999999992,432.59366866666664,434.54933733333326,437.5676686666666,439.5233373333332,429.5753373333333,427.6196686666667,424.6013373333334,0.17953478086045685,412875888.0,+1
2013-12-18,431.25,434.21899400000007,430.93798799999996,432.04400599999997,279.902954,9183344.0,422.15939940000004,424.25541719999995,13.450011999999958,76.34733131611289,-1.0599723123358642,0.4558120688448071,322.5216347636166,-6932411.544242865,-2499917.4655438815,96.0,44.0,48.0,13.881011999999998,432.40032933333333,433.8626706666667,435.6813353333334,437.1436766666668,430.5816646666666,429.1193233333332,427.3006586666665,0.3370972195722808,422059232.0,+1
2013-12-19,432.81201200000004,443.118988,431.875,432.181,284.33935499999995,7331456.0,423.3105988,426.07752639999995,11.511994000000016,76.52313774645688,-3.178548229370016,1.2120684770991375,327.0144141354656,-7650693.284054179,-2734443.885923965,92.0,40.0,52.0,3.2810060000001045,435.724996,439.57499199999995,446.968984,450.81897999999995,428.33100399999995,424.481008,417.08701599999995,0.02721454345201926,429390688.0,+1
2013-12-20,440.625,446.625,438.549988,439.03100599999993,287.505096,8685456.0,425.3224,428.9357822545454,20.118011999999965,83.5692471562565,-2.184536209996423,1.8473948580102615,321.2192686084715,11400327.79581046,-2090905.912581581,96.0,36.0,52.0,11.243988000000002,441.401998,444.254008,449.47701000000006,452.32902,436.178996,433.326986,428.10398399999997,0.059568704046501504,438076144.0,+1
2013-12-23,437.5,442.48699999999997,432.569,443.91900599999997,280.79348799999997,8845904.0,428.1418,432.31698334545456,28.19399999999996,86.82498003134523,-0.7784233009708831,2.3675986500926456,207.1418615332224,-6203974.093498729,-2278154.7283668406,96.0,32.0,60.0,14.444000000000017,439.65833533333335,446.7476706666667,449.57633533333336,456.66567066666664,436.82967066666674,429.7403353333334,426.9116706666668,1.1443845533373673,446922048.0,+1
2013-12-24,435.75,437.86199999999997,433.26300000000003,433.556,282.246826,7109912.0,429.76239939999994,433.3013833454545,16.205993999999976,58.47890233063249,-3.7595109672779623,3.1392157807683816,112.33054086579004,-6151587.420801387,-2454481.5752564277,92.0,28.000000000000004,64.0,9.91799999999995,434.89366666666666,436.5243333333333,439.49266666666665,441.1233333333332,431.92533333333336,430.2946666666667,427.3263333333334,0.06370950206565641,439812136.0,-1
2013-12-26,435.875,441.799988,435.46899400000007,435.799988,285.01947,6869928.0,431.20679939999997,434.3991267272727,14.444000000000017,61.610349750926694,-3.1139912261776383,4.914869938270726,115.92583352561518,-10648911.997917728,-2827484.17250959,88.0,24.0,64.0,10.656005999999934,437.6896566666667,439.9103193333333,444.0206506666666,446.2413133333332,433.5793253333334,431.35866266666676,427.24833133333345,0.05228152166941289,446682064.0,+1
2013-12-27,441.25,446.5,441.243988,440.08099400000003,288.31076,7382064.0,433.03549819999995,436.01261665454547,18.286988000000065,67.07621874628745,-1.8824900395541078,7.048384054134942,133.01955647728767,8613789.31766533,-2306721.9850849626,84.0,20.0,64.0,8.243988000000002,442.60832733333336,443.9726666666667,447.86433933333336,449.2286786666667,438.7166546666667,437.35231533333337,433.46064266666673,-0.22126928172918356,454064128.0,+1
2013-12-31,437.5,440.212006,435.03100599999993,437.79400599999997,282.185883,3590808.0,437.11000060000003,438.6340353818182,16.063018,56.91036492429596,-2.610418684872449,9.635741353807418,59.429041185447154,410082.0005352033,-2072482.5933264133,96.0,12.0,64.0,12.5,437.679006,440.3270060000001,442.8600060000001,445.50800600000014,435.14600600000006,432.498006,429.965006,0.5332947307469624,462336752.0,-1
2014-01-01,436.5,437.375,432.756012,435.70599400000003,280.757202,1478688.0,437.5274994,438.3787614545455,4.1749880000000985,53.18116302604567,-3.2106377290693406,10.947945901770083,35.12788974785887,-3469315.2142214454,-2136049.757677415,92.0,8.0,84.0,10.131988000000092,435.27900200000005,437.8019920000001,439.89799,442.4209800000001,433.1830040000001,430.66001400000005,428.5640160000001,0.6386641402835498,460858064.0,-1
2014-06-30,402.5,407.875,401.424988,402.924988,295.602814,7290576.0,405.1686036,403.8142756727273,4.549987999999985,54.99047615857649,-4.553662729509155,15.184022691707526,40.74306849164346,2318944.0193566806,1799373.8082863444,76.0,16.0,60.0,4.875,404.074992,406.72499600000003,410.5250040000001,413.17500800000005,400.274984,397.62498,393.824972,0.232557706869382,595928912.0,+1
2014-07-01,405.625,406.850006,400.75,406.944,292.469849,4662512.0,405.3111024,404.13707501818186,1.4249879999999848,60.24758001742332,-3.291509270622935,15.603482771605911,37.1864487400783,-3653381.741368987,1551520.2835529298,72.0,12.0,60.0,8.28100599999999,404.848002,408.946004,410.9480080000001,415.04601,402.845998,398.747996,396.745992,1.0154088373027845,600591424.0,+1
2014-07-04,400.006012,407.299988,400.006012,401.33700600000003,294.73111,5752968.0,403.40870359999997,402.48391170909093,-12.649993999999936,50.284975997822166,-5.052361656994066,15.60023905547365,12.005612834608845,906632.0914083854,694147.4205639494,60.0,0.0,60.0,6.100006000000008,402.881002,405.75599200000005,410.17497800000007,413.04996800000004,398.46201600000006,395.58702600000004,391.1680400000001,0.18247852748624824,581213912.0,-1
2014-07-07,408.125,421.0,407.5,405.743988,303.765289,11638312.0,402.5256012,402.9085088727273,-8.831024000000014,58.20426736049604,-4.7378919254658385,13.77317403840226,48.453879167573696,-1003226.4402913288,616993.8048843875,56.00000000000001,16.0,60.0,7.169006000000024,411.41466266666663,415.32932533333326,424.9146626666666,428.82932533333326,401.82932533333326,397.91466266666663,388.32932533333326,-0.13007496296296284,592852224.0,+1
2014-07-08,418.625,425.79400599999997,412.881012,418.181,303.466064,11460480.0,403.9368012,405.7549450181818,14.111999999999966,72.47938046628465,-2.3296039279251604,11.03426316260618,82.6915445406563,-17667127.141747855,-214105.25841502144,96.0,12.0,60.0,4.7379759999999465,418.952006,425.02299999999997,431.86499999999995,437.93599399999994,412.110006,406.039012,399.19701200000003,0.4104383538008302,604312704.0,+1
2014-07-09,416.25,423.0,411.25,417.76901200000003,300.57861299999996,8270752.0,405.6662018,408.26989243636365,17.294006000000024,71.54538310559022,-2.4556735596918924,8.478999692304455,68.71213131344403,9715830.918030038,237256.8540896221,96.0,8.0,60.0,7.2939759999999865,417.3396706666667,423.42934133333335,429.08967066666673,435.17934133333335,411.67934133333335,405.5896706666667,399.92934133333335,0.5548095319148963,596041952.0,-1
2014-07-10,414.375,422.712006,406.325012,413.794006,298.975433,11345616.0,406.9050018,409.7476750181818,12.388000000000034,62.56917823149461,-3.672037974894786,7.3694713218481525,50.030329900034054,-2479995.5490501164,113745.02148622168,92.0,4.0,40.00000000000001,19.66299399999997,414.277008,422.22900400000003,430.664002,438.615998,405.8420100000001,397.89001400000006,389.4550160000001,0.4557879254730934,584696336.0,-1
2014-07-11,425.174988,429.0,412.544006,411.58700600000003,302.058289,15826360.0,408.28250119999996,410.5989485090909,13.774993999999992,57.91428927444032,-5.276664848484839,6.439396049990194,73.70052861824041,335028.6122604884,123803.39448523977,88.0,0.0,84.0,20.050017999999966,417.71033733333337,422.8766686666667,434.1663313333334,439.3326626666667,406.42067466666674,401.2543433333334,389.96468066666677,-0.058155101417756656,568869976.0,-1
2014-07-14,414.375,414.375,398.225006,415.830994,292.851257,8231600.0,409.57310179999996,411.97140174545456,12.90600599999999,63.87710212009064,-3.9906078787878863,5.943885622352468,13.542359361362726,-5124006.704838553,-114734.06123798751,96.0,0.0,88.0,11.75,409.47700000000003,420.72899400000006,425.6269940000001,436.87898800000005,404.57900000000006,393.32700600000004,388.4290060000001,1.0901544607384979,577101576.0,+1
2014-07-15,404.875,407.243988,402.131012,403.156006,292.887543,4139800.0,409.19430239999997,410.80465705454543,-3.787994000000026,42.92109225160756,-7.831513333333335,5.373028887340695,-29.35378922182594,-5230809.874942014,-347283.55094519234,92.0,0.0,88.0,16.38699399999996,404.17700199999996,406.2229919999999,409.28997799999996,411.3359679999999,401.1100159999999,399.06402599999996,395.9970399999999,0.2004691592528484,572961776.0,-1
2014-07-16,405.0,405.625,400.406006,403.205994,293.246368,4589488.0,409.2518005999999,409.71587370909094,0.5749819999999772,43.006178089673895,-7.816365454545463,3.9746392142050126,-40.62487427858391,3632843.74954292,-166368.23619465902,88.0,0.0,88.0,16.455993999999976,403.07899999999995,405.7519939999999,408.29799399999996,410.9709879999999,400.5329999999999,397.86000599999994,395.3140059999999,0.5364995629425863,577551264.0,+1
2014-07-17,407.51300000000003,418.23699999999997,403.955994,403.700012,294.127502,4946672.0,409.43050239999997,408.7064576,1.787018000000046,43.9587857774542,-7.666663030303026,2.6798916620403475,10.575309055395213,-7782630.642319243,-512562.7809804382,84.0,0.0,96.0,16.149993999999992,408.631002,413.3060100000001,422.91200799999996,427.58701600000006,399.0250040000001,394.34999600000003,384.7439980000001,-0.017924647605355015,582497936.0,+1
2014-07-18,406.625,409.33700600000003,405.450012,404.91299399999997,295.239594,4098368.0,409.78810119999997,407.8850924363636,3.5759879999999384,46.49251571823008,-7.299092727272736,2.910627416468458,-5.770425325638702,-15242524.347771116,-1182107.9636968914,80.0,0.0,92.0,13.699981999999977,406.56667066666665,407.6833293333333,410.45366466666667,411.5703233333333,403.7963353333333,402.67967666666664,399.90934133333326,-0.1381576611643969,586596304.0,+1
2014-07-21,406.875,409.169006,398.51300000000003,406.444,290.621887,7435968.0,409.85810240000006,407.2770740363636,0.7000120000000152,49.798065364135994,-6.83515151515151,3.181509362848999,-23.98406479459697,-1329563.0454644412,-1188810.481509293,76.0,32.0,88.0,5.218994000000009,404.70866866666665,410.9043373333333,415.3646746666667,421.56034333333326,400.2483313333333,394.05266266666666,389.5923253333333,0.7442751064517034,594032272.0,+1
2014-07-22,400.625,405.83700600000003,399.756012,400.08700600000003,293.618286,8733360.0,408.04870300000005,405.5005110545454,-18.093993999999952,38.42523625056318,-8.761513333333323,3.521524389131514,-59.58863810042689,3441326.7622999502,-978349.2752090578,72.0,28.000000000000004,84.0,15.03100599999999,401.89334133333335,404.0306706666667,407.9743353333334,410.11166466666674,397.9496766666667,395.8123473333333,391.86868266666664,0.05443090389499326,585298912.0,-1
2014-07-23,406.125,419.375,406.125,404.21200600000003,304.128479,11827336.0,406.69300240000007,404.80292978181825,-13.557006000000001,47.41658580223497,-7.5115133333333235,3.838937074252101,32.50933111854222,-239838.09528876183,-944780.5208881003,68.0,24.0,80.0,5.636994000000016,409.904002,413.683004,423.154002,426.933004,400.433004,396.654002,387.183004,-0.14437690566037503,597126248.0,+1
2014-07-24,418.0,424.375,415.181,418.681,307.106781,5571560.0,407.18170180000004,406.98256570909086,4.886993999999959,66.94937023681274,-3.1269696969697023,2.7995959711787464,135.36638078071525,535306.7648002816,-877503.7030278001,64.0,20.0,44.0,10.65600599999999,419.4123333333334,423.6436666666668,428.60633333333345,432.8376666666668,414.44966666666676,410.21833333333336,405.25566666666674,0.3806830541657596,602697808.0,+1
2014-07-25,424.875,424.875,413.08700600000003,422.78100599999993,304.37838700000003,5337672.0,408.3011018000001,409.8188028363636,11.193999999999903,70.52875159259295,-1.8845436363636565,1.7929539126831742,119.44532069739302,1031289.2994827316,-790740.2332460837,60.0,16.0,44.0,6.6879880000000185,420.24767066666664,427.40833533333324,432.0356646666666,439.1963293333332,415.6203413333333,408.45967666666667,403.8323473333333,0.8223621423628081,608035480.0,+1
2014-07-28,418.125,423.375,415.10598799999997,419.024994,306.094879,4601448.0,408.62050180000006,411.7686014181818,3.194000000000017,63.28416403535777,-3.022729090909093,1.751680617893328,97.5003266872677,1631323.3563747734,-680646.2502351459,56.00000000000001,12.0,44.0,19.28799399999997,419.1686606666667,423.23133333333345,427.43767266666674,431.5003453333335,414.9623213333334,410.8996486666667,406.6933093333334,0.4739388454146649,603434032.0,-1
2014-07-30,424.25,424.25,418.200012,421.38800000000003,306.194366,9934720.0,410.4437012,414.08996472727273,18.231994000000043,65.83189803866989,-2.3066666666666564,2.111931864933183,118.36749497441262,-14654353.891588518,-1315815.7898446147,52.0,8.0,44.0,20.16299399999997,421.2793373333334,424.35866266666676,427.3293253333334,430.40865066666674,418.3086746666668,415.2293493333334,412.2586866666668,0.5269412104619094,613368752.0,+1
2014-07-31,422.5,424.36199999999997,417.899994,421.52499400000005,305.78109700000005,8457168.0,412.27560120000004,416.10474523636367,18.319000000000074,65.9897663295664,-2.2651533333333185,1.2301592917450535,109.37279905604866,-12963223.097079558,-1845244.1986744993,48.0,4.0,44.0,11.78799399999997,421.26232933333335,424.6246646666667,427.72433533333333,431.0866706666667,418.16265866666674,414.8003233333334,411.70065266666677,0.5609713144803752,621825920.0,+1
2014-08-01,418.75,424.0,416.25,420.95599400000003,303.38909900000004,7607008.0,414.0011994000001,417.68299847272726,17.255982000000017,64.56022178304012,-2.437577575757566,1.8667175611102493,87.07291326352437,-23188224.780857615,-2815381.085906604,44.0,0.0,44.00000000000001,8.269012000000032,420.401998,424.553996,428.15199800000005,432.303996,416.803996,412.651998,409.053996,0.6072250322580687,614218912.0,-1
2014-08-04,419.375,435.36199999999997,418.66299399999997,417.66299399999997,314.670715,13086960.0,415.27619940000005,418.3487793090909,12.75,56.4012209223526,-5.261892247043363,2.570537078828977,118.24248569661444,15614441.969562024,-1977660.6970226802,40.0,0.0,44.0,6.049987999999985,423.89599599999997,429.12899799999997,440.59500199999997,445.82800399999996,412.42999199999997,407.19698999999997,395.730986,-0.05988380386233769,601131952.0,-1
2014-08-05,434.5,440.0,433.756012,433.194,318.97900400000003,10985624.0,417.95119940000006,421.60656123636363,26.75,74.16744393734933,-1.9958944281524875,3.4794042278085726,217.570389093402,1668872.126617556,-1811908.9861254708,96.0,40.0,44.0,6.462005999999974,435.650004,437.54399600000005,441.8939920000001,443.78798400000005,431.30000800000005,429.406016,425.05602000000005,-0.09000850097725706,612117576.0,+1
2014-08-06,440.625,451.04400599999997,440.625,439.125,324.68554700000004,18004184.0,421.8549988000001,425.45634316363635,39.03799399999997,78.09974067129514,-3.3856579850417816,4.844021580194351,241.19316690624603,-9806798.5318394,-2175313.5145287663,96.0,36.0,44.0,7.75,443.598002,446.571004,454.01700800000003,456.99001,436.15199800000005,433.17899600000004,425.7329920000001,-0.1439676683169205,630121760.0,+1
2014-08-07,437.375,443.049988,435.29400599999997,446.98098799999997,318.466125,7754224.0,426.1318970000001,430.02470483636364,42.76898199999994,82.23316325385186,-1.154122192326149,6.635244071245836,176.27988741905003,714909.5075221442,-2043939.5827045657,96.0,32.0,40.0,16.699005999999997,441.77499399999994,448.2559819999999,449.5309759999999,456.0119639999999,440.4999999999999,434.0190119999999,432.74401799999987,1.5068345955418636,637875984.0,+1
2014-08-08,437.5,440.0,434.375,438.41900599999997,316.223022,3811352.0,428.1056976000001,432.25872465454546,19.738005999999984,66.45931035305154,-3.5861993912204264,9.072279891320193,116.67063712100469,-2667648.840602156,-2072290.0360840983,92.0,28.000000000000004,56.0,22.33700600000003,437.598002,440.821004,443.22300199999995,446.446004,435.196004,431.973002,429.571004,0.7189343999999942,634064632.0,-1
2014-08-11,440.5,447.962006,438.75,435.33099400000003,324.472687,5628672.0,429.3606964000001,433.57241490909087,12.549988000000099,61.54632476944778,-4.463365866822893,11.089507363942914,114.604284659104,411986.50725305214,-1959368.2512067289,88.0,24.0,60.0,17.85000599999995,440.68100000000004,442.6120000000001,449.893006,451.82400600000005,433.3999940000001,431.46899400000007,424.18798800000013,-0.37114674046021867,628435960.0,-1
2014-08-12,449.875,449.875,442.625,446.68798799999996,324.772003,5916936.0,432.1269958000001,436.7228315636363,27.66299399999997,70.72884417640674,-1.2373504237421973,11.547999286008746,122.23448986644179,6898578.1347097065,-1556733.903160572,84.0,20.0,64.0,7.755982000000017,446.39599599999997,450.16699199999994,453.64599599999997,457.41699199999994,442.91699199999994,439.14599599999997,435.66699199999994,0.5604121379310292,634352896.0,+1
2014-08-13,445.006012,453.125,443.84399400000007,447.10000599999995,327.64126600000003,8941360.0,434.69819640000003,439.44519705454536,25.712005999999917,71.01854180092381,-1.7013749382280408,11.835651240175764,108.10730010364193,65347.64717116842,-1483002.8499378243,80.0,16.0,64.0,12.605987999999968,448.02299999999997,452.20200599999987,457.30400599999984,461.4830119999998,442.92099999999994,438.74199400000003,433.639994,0.3508253307884843,643294256.0,+1
2014-08-14,451.0,453.462006,448.325012,451.049988,328.018311,6762480.0,437.6506958,442.41825007272723,29.524993999999936,73.87832385700014,-0.6804729305741133,13.649099971497037,100.14643800575715,-3760696.4074021876,-1586534.474010486,96.0,12.0,64.0,9.543000000000006,450.9456686666667,453.56632533333334,456.0826626666667,458.7033193333333,448.4293313333334,445.8086746666667,443.2923373333334,0.5304611996821471,650056736.0,+1
2014-08-18,451.5,451.5,443.75,451.569,323.228394,6777888.0,440.71199640000003,444.94885083636365,30.613005999999984,74.26335409734557,-0.5340504674568584,15.322086942264548,79.28547799291577,2021264.0195756827,-1422543.4841108979,96.0,8.0,64.0,14.544005999999968,448.93966666666665,454.1293333333333,456.68966666666665,461.8793333333333,446.3793333333333,441.18966666666665,438.6293333333333,1.0089032258064539,656834624.0,+1
2014-08-19,445.125,448.625,441.25,444.97500599999995,322.138794,6424824.0,443.4431976000001,445.72394349090905,27.31201199999998,61.067862514830765,-2.3943327793501297,16.755232908593598,54.61252421425142,-4700988.933461332,-1571563.8612967366,92.0,4.0,64.0,9.281005999999934,444.950002,448.65000399999997,452.32500200000004,456.02500399999997,441.27500399999997,437.575002,433.90000399999997,0.5050855593220273,650409800.0,-1
2014-08-20,445.375,447.81201200000004,443.375,443.47500599999995,322.751892,3938224.0,444.4712982,445.7297268363636,10.281005999999934,58.34667934489822,-2.8175093045092185,18.277402757285245,46.00100838063768,242607.98928004105,-1489101.4360553634,88.0,0.0,84.0,6.362000000000023,444.88733933333333,446.39967866666666,449.3243513333334,450.8366906666667,441.9626666666666,440.4503273333333,437.5256546666666,0.022539042039992203,646471576.0,-1
2014-08-21,444.53100599999993,445.424988,441.25,444.319,322.243378,4298880.0,444.99069819999994,445.7020362545455,5.194000000000017,59.517809249918436,-2.579403672392453,20.762935558474624,33.83838048546574,2278443.941107085,-1317849.237871474,84.0,16.0,88.0,7.75,443.66466266666663,446.07932533333326,447.83965066666656,450.25431333333324,441.9043373333333,439.48967466666664,437.7293493333333,0.7350919331983776,650770456.0,+1
2014-08-22,443.618988,451.0,443.5,443.618988,326.96936,4855040.0,444.6544981999999,445.45263439999997,-3.3619999999999663,57.95830994038493,-2.7768894362122336,20.486835670392622,35.86147070973376,-318933.4952669898,-1272443.9425292725,80.0,12.0,88.0,10.319000000000017,446.03966266666663,448.57932533333326,453.5396626666666,456.07932533333326,441.07932533333326,438.53966266666663,433.57932533333326,0.015865066666666885,645915416.0,-1
2014-08-25,449.875,454.462006,445.256012,450.125,329.40274,4198352.0,445.8250976,446.4472710909091,11.705994000000032,67.18039098103421,-1.2201039567643621,19.595882155518495,43.92695694980067,6702145.655834006,-909962.3356582095,76.0,8.0,88.0,4.437012000000038,449.9476726666667,454.63933333333335,459.15366666666665,463.84532733333333,445.4333393333334,440.7416786666667,436.2273453333334,0.528893240643,650113768.0,+1
2014-08-26,452.75,455.0,450.0,453.47500599999995,329.071533,5842128.0,447.63949879999996,447.8381635272727,18.14401199999992,70.96444657304247,-0.4283691011236094,17.713606008246757,47.91038216554056,-676685.6044787017,-899358.8405757522,96.0,4.0,68.0,4.174987999999985,452.825002,455.65000399999997,457.82500200000004,460.65000399999997,450.65000399999997,447.825002,445.65000399999997,0.6950011999999901,655955896.0,+1
2014-08-27,453.75,456.25,450.13800000000003,453.01901200000003,329.652649,5569872.0,448.27260119999994,448.81625683636366,6.33102400000007,69.70223471088252,-0.9044053184044698,17.05208732953315,44.22849375347094,967270.5183753241,-814511.9957626616,96.0,0.0,68.0,7.5,453.1356706666667,456.1333413333334,459.24767066666675,462.2453413333334,450.02134133333345,447.02367066666676,443.9093413333335,0.47136976439790806,650386024.0,-1
2014-08-28,453.625,454.20599400000003,447.64999400000005,453.819,326.769592,7599304.0,448.94450059999997,449.8246929818182,6.718994000000066,70.75519599545433,-0.6804758572428224,16.9952505503403,36.398196144424304,-11205228.221861413,-1286817.575102558,96.0,0.0,68.0,10.843017999999972,451.89166266666666,456.1333313333333,458.44766266666664,462.68933133333326,449.5773313333333,445.3356626666667,443.0213313333333,0.9409710189139694,657985328.0,+1
2014-09-01,451.256012,452.36199999999997,448.125,449.85000599999995,326.846588,3643152.0,448.8245024,449.9893303272727,-1.199982000000034,59.01423907075626,-1.7914608817354933,14.90959523579869,25.695467583635757,10488125.942729443,-751592.5491982445,92.0,0.0,92.0,5.0,450.1123353333333,452.0996706666666,454.34933533333333,456.3366706666666,447.86267066666665,445.87533533333334,443.6256706666667,0.40712910077884457,654342176.0,-1
2014-09-02,450.0,453.125,444.444,449.95599400000003,328.127197,3583832.0,448.6632017999999,450.19505607272725,-1.6130059999999844,59.22273014311908,-1.7617931420573736,12.958834833811977,17.012405797349928,-5977726.718605663,-989144.2381568953,88.0,4.0,96.0,6.111999999999966,449.17499799999996,453.9059959999999,457.85599799999994,462.5869959999999,445.2249959999999,440.493998,436.54399599999994,0.6349491994009937,657926008.0,+1
2014-09-03,451.25,468.299988,451.25,451.71899400000007,339.068207,11857560.0,449.3376006,450.75065465454543,6.743988000000115,62.84982449006415,-4.489844175137075,11.33576427447099,47.54911492344392,-6955712.559253068,-1260352.037112667,84.0,0.0,96.0,6.555999999999983,457.0896606666667,462.9293213333334,474.13964866666674,479.9793093333334,445.8793333333334,440.0396726666667,428.82934533333344,0.027506998831909237,669783568.0,+1
2014-09-04,465.625,465.625,462.23098799999997,466.78100599999993,336.753174,6238464.0,451.66820060000003,453.9221829090909,23.305999999999983,80.20597495199462,-0.41131385035410584,10.20965579895244,83.04539912195898,10697975.400225803,-716791.4159159447,96.0,0.0,92.0,5.694000000000017,464.87899799999997,467.52700799999997,468.27300999999994,470.92102,464.13299599999993,461.48498599999994,460.7389839999999,1.3406016242723724,676022032.0,+1
2014-09-05,466.5,474.375,463.16900599999997,463.59399400000007,338.75079300000004,6468352.0,453.5957000000001,456.0905089818182,19.27499400000005,71.9941724342859,-2.8720628704628526,9.687315645347951,91.86979392652707,11018477.827007996,-183369.8214673277,92.0,8.0,84.0,8.680999999999983,467.046,470.922994,478.2519940000001,482.12898800000005,459.717,455.84000599999996,448.51100599999995,0.0379250604631858,669553680.0,-1
2014-09-08,466.587006,473.81201200000004,466.587006,466.34399400000007,343.37207,6517296.0,455.8682006000001,458.4083806181818,22.725006000000064,74.58489324917969,-2.1394621378621204,9.648282240090111,98.58337603582389,312825.71888325136,-160815.4680195173,96.0,4.0,84.0,18.343993999999952,468.9143373333334,471.2416686666668,476.1393433333335,478.46667466666685,464.0166626666667,461.6893313333333,456.79165666666665,-0.03363485096066435,676070976.0,+1
2014-09-09,468.5,469.431,465.0,472.70599400000003,339.231628,4316800.0,458.1263,461.4697976,22.580994000000032,79.61792320439096,-0.4446236430236344,9.754642402578213,92.20730614648865,694209.7596204483,-121950.66733765525,92.0,0.0,96.0,13.906005999999934,469.04566466666665,473.0913293333333,473.4766646666667,477.5223293333333,468.6603293333333,464.61466466666667,464.22932933333334,1.7391094561047307,680387776.0,+1
2014-09-10,463.5,463.5,457.5,467.006012,332.98974599999997,5080752.0,459.4794006,463.08429069090914,13.531006000000048,66.08819185715154,-1.9631003663003668,9.896606221418438,50.21079115365659,5420853.946859838,129995.10589736642,88.0,0.0,84.0,11.205994000000032,462.6686706666667,467.83734133333337,468.6686706666667,473.83734133333337,461.83734133333337,456.6686706666667,455.83734133333337,1.584335333333333,675307024.0,-1
2014-09-11,459.25,462.462006,453.825012,458.412994,334.519501,5013032.0,460.01879880000007,462.8903985818182,5.393981999999994,51.00987858916652,-4.252282650682644,8.797674155538118,23.096542599779205,-2369954.9629925797,16360.964949787905,84.0,0.0,92.0,10.218017999999972,458.23333733333334,462.64166266666666,466.8703313333333,471.2786566666666,454.0046686666667,449.5963433333334,445.36767466666674,0.5312012489530539,670293992.0,-1
2014-09-12,461.0,463.5,456.25,460.51901200000003,333.22506699999997,3907552.0,460.6888000000001,462.98134643636365,6.700012000000015,53.97913648079368,-3.6912388944388854,8.261841353038108,31.148859521096195,-12013929.305616787,-530470.6264517789,80.0,8.0,92.0,4.430999999999983,460.0896706666667,463.92934133333335,467.33967066666673,471.17934133333335,456.67934133333335,452.8396706666667,449.42934133333335,0.5888292413793148,674201544.0,+1
2014-09-15,458.125,458.5,453.412994,458.73699999999997,330.628876,4958800.0,461.5774994000001,462.62647370909093,8.886994000000016,50.963394359689254,-4.165967365967375,8.135620276214695,11.139733914912588,11851899.863764543,32364.60752280736,76.0,4.0,88.0,15.205994000000032,456.8833313333333,460.3536686666665,461.9703373333332,465.4406746666665,455.26666266666655,451.7963253333333,450.1796566666666,1.046589290439203,669242744.0,-1
2014-09-16,455.75,461.31201200000004,452.950012,455.162994,331.53186,5034904.0,462.0981994,461.46020000000004,5.206999999999994,45.12875304894294,-5.11808351648351,8.333443629389194,6.914307700682569,-10409561.649094462,-442268.57454488764,72.0,0.0,84.0,13.180999999999983,456.47500600000006,460.0000000000001,464.8370060000001,468.36200000000014,451.6380000000001,448.11300600000004,443.27600000000007,0.26464745276249757,664207840.0,-1
2014-09-17,459.98699999999997,468.51300000000003,458.88800000000003,456.40600599999993,339.685638,7926120.0,462.56690059999994,460.42525574545454,4.687011999999868,47.53899357990919,-4.786944788544806,8.628310667882204,35.53721094521535,15160720.688134069,266958.45317575324,68.0,0.0,72.0,7.25,461.269002,463.65000399999997,470.894002,473.27500399999997,454.02500399999997,451.644002,444.40000399999997,-0.25786950649351686,672133960.0,+1
2014-09-18,459.243988,466.212006,456.806,467.631012,335.686096,9104776.0,462.65190119999994,461.3460032727272,0.8500060000000644,64.01094794654531,-1.7966001998002004,9.080430719131527,47.62316976042996,3273933.257058024,403639.1707911035,64.0,16.0,72.0,7.106018000000006,463.5496726666667,470.29334533333343,472.95567866666676,479.6993513333334,460.88733933333344,454.1436666666667,451.48133333333345,1.1508616941133172,681238736.0,+1
2014-09-19,462.375,473.48699999999997,460.162994,462.125,336.14447,14755016.0,462.50500180000006,461.25020305454547,-1.468994000000066,54.352137951136186,-3.263403263403263,9.973183561024143,53.65384758065759,-4232682.263212853,192897.22162201797,60.0,12.0,72.0,8.362000000000023,465.2583313333333,470.3536686666665,478.58233733333327,483.67767466666646,457.0296626666666,451.93432533333333,443.70565666666664,0.14725346115875232,666483720.0,-1
2014-09-22,460.0,460.34399400000007,454.0,462.756012,331.472992,8612040.0,462.14620360000004,461.29584127272733,-3.5879820000000677,55.24515105416833,-3.0953014985014993,8.867733426700227,1.1928749137906753,-25798847.04987343,-988546.0519526798,56.00000000000001,8.0,68.0,13.350006000000008,459.03333533333335,464.0666706666667,465.37732933333336,470.4106646666668,457.72267666666664,452.6893413333333,451.3786826666666,1.3802049623628123,675095760.0,+1
2014-09-23,455.625,460.431,449.444,456.325012,327.52359,12962304.0,460.5081054,460.2374428,-16.380982000000017,44.91285483068374,-4.808521611721607,8.23076929623113,-29.352637667706027,186319.6453070206,-935143.0505197266,52.0,4.0,48.0,9.80600000000004,455.400004,461.35600800000003,466.387004,472.343008,450.36900800000006,444.41300400000006,439.3820080000001,0.6262867024665532,662133456.0,-1
2014-09-24,453.75,459.03100599999993,449.78100599999993,450.88800000000003,330.94635,5564560.0,458.8963041999999,458.48833272727273,-16.118011999999965,37.983033754603,-6.256943056943048,7.045184138437321,-49.14712383450962,-5115266.712555513,-1125148.7231233001,48.0,0.0,48.0,13.32400599999994,453.2333373333333,456.68566866666663,462.48333733333334,465.93566866666663,447.43566866666663,443.9833373333333,438.18566866666663,0.1196750270270378,656568896.0,-1
2014-09-25,456.25,464.85000599999995,455.75,455.60000599999995,335.141296,24975512.0,458.6150054,457.8890057818182,-2.8129880000000753,46.27274598454683,-5.001663403263416,4.546473421812436,-6.541861821146594,5106207.551635494,-841905.1826617479,44.0,4.0,48.00000000000001,8.125,458.7333373333333,461.71667466666656,467.83334333333323,470.8166806666665,452.6166686666666,449.63333133333333,443.51666266666666,-0.016482846275051914,681544408.0,+1
2014-09-26,460.625,465.03100599999993,457.56201200000004,461.375,334.156342,8864840.0,458.7006042,458.3908229818182,0.855987999999968,54.81407950205189,-3.3181999513932436,2.7158266834089204,15.345107037202009,-5934947.089037568,-1073407.1447828708,40.0,0.0,48.0,13.312011999999982,461.3226726666667,465.0833333333333,468.7916666666666,472.5523273333332,457.6143393333334,453.8536786666668,450.1453453333335,0.5105089119096916,690409248.0,+1
2014-09-29,462.625,470.118988,460.13800000000003,460.01901200000003,340.41204799999997,4996144.0,458.8288054,458.6305334909091,1.2820120000000657,52.55067812358786,-3.5963833190471055,2.008753795187374,38.61379443479165,5249532.087340136,-786000.748163136,36.0,0.0,48.0,9.25,463.42533333333336,466.7126666666667,473.40632133333327,476.69365466666665,456.7316786666667,453.4443453333334,446.75069066666674,-0.011921465089428224,685413104.0,-1
2014-09-30,468.02499400000005,469.537994,462.63800000000003,468.631012,340.294373,6927368.0,460.17560720000006,460.4127528727273,13.468017999999972,63.57330880566769,-1.296704024438757,1.156343348929056,92.93738413264319,30909907.271408796,654722.6684734108,32.0,20.0,40.0,13.962005999999917,466.9356686666667,471.23333733333334,473.83566266666674,478.13333133333333,464.33334333333335,460.0356746666667,457.43334933333335,0.8685532190317805,692340472.0,+1
2014-10-01,465.25,482.493988,465.25,468.46899400000007,349.333618,9470864.0,461.3819060000001,461.9206413818182,12.062988000000132,63.25433670045272,-3.6571613738048834,0.9448897957080362,179.62603463586828,-5587014.181424734,371007.29605318705,28.000000000000004,16.0,40.0,9.430999999999983,472.070994,478.89198799999997,489.314982,496.13597599999997,461.64799999999997,454.827006,444.40401199999997,0.18667340756674533,682869608.0,-1
2014-10-07,471.162994,486.618988,471.162994,480.912994,347.88088999999997,20063456.0,462.71010420000016,465.4717482909091,13.281982000000028,74.56439066995992,-1.472062560567847,1.7985188319628946,272.39562681050336,-25607825.232281584,-809848.9705538996,96.0,12.0,36.0,9.980987999999968,479.564992,487.96699,495.020986,503.422984,472.51099600000003,464.10899800000004,457.05500200000006,0.6308232262512534,702933064.0,+1
2014-10-08,473.125,474.0,455.125,478.912994,331.432343,20327680.0,464.38890360000005,468.4177282545454,16.787994000000026,70.5381428099317,-1.9880331558989508,2.5202077720506963,85.92179015994463,-17970022.28103746,-1589857.0012621016,96.0,8.0,12.0,9.518981999999994,469.345998,483.566996,488.220998,502.441996,464.691996,450.470998,445.816996,1.2602910728476835,682605384.0,-1
2014-10-09,462.5,464.25,453.23699999999997,456.26901200000003,331.12796000000003,12432832.0,463.7402036000001,466.9413843272727,-6.486999999999966,41.3614721275845,-7.829847592502349,1.2139696132578024,-59.226520868808166,2121903.5884307977,-1421140.5792402308,92.0,4.0,12.000000000000004,17.243988,457.9186706666667,462.6003413333334,468.9316706666667,473.61334133333344,451.58734133333337,446.90567066666665,440.57434133333334,0.27531208571688515,670172552.0,-1
2014-10-10,457.5,488.5,446.587006,455.85000599999995,353.087677,45893056.0,463.6927030000001,465.5068029454545,-0.47500600000006443,40.99939217604009,-8.3825401797176,0.329195979115525,17.086180074307734,0.0,-1356543.2686417925,88.0,0.0,84.0,18.149993999999936,463.6456706666666,480.70433533333323,505.5586646666666,522.6173293333333,438.7913413333332,421.7326766666666,396.8783473333332,0.2210054476184634,624279496.0,-1
2014-10-13,486.162994,498.125,486.162994,486.08099400000003,357.982178,17726984.0,467.2120024,469.57740130909093,35.192994,65.87127160429411,-3.017602505480731,0.08921435014639201,341.4919898260732,5244472.495994495,-1056497.0463474363,96.0,96.0,88.0,25.787994000000026,490.12299600000006,494.0829980000001,502.08500200000003,506.04500400000006,482.1209920000001,478.1609900000001,470.15898600000014,-0.006855037524642089,642006480.0,+1
2014-10-14,495.625,495.625,487.5,492.819,355.780396,6860512.0,470.93390180000006,474.2332190545455,37.218994000000066,69.2093597239519,-1.3294080801753796,1.1028449763241497,269.0433122971608,-2799847.760754398,-1135740.273539693,96.0,92.0,88.0,25.67599400000006,491.98133333333334,496.4626666666667,500.1063333333334,504.5876666666667,488.3376666666667,483.85633333333334,480.2126666666667,0.6546461538461559,648866992.0,+1
2014-10-16,487.51300000000003,492.287994,481.79400599999997,489.787994,373.867828,10017392.0,476.7520994000001,480.5726526909092,29.768981999999994,65.86556637181262,-2.088820795490128,6.190881440550356,135.55748447724983,12082438.655035604,-272000.9704231367,88.0,84.0,0.0,42.27499400000005,487.9566646666667,494.11932333333345,498.45065266666677,504.6133113333335,483.6253353333334,477.46267666666665,473.13134733333334,0.7617683572727559,648866992.0,-1
2014-10-17,483.11199999999997,490.35000599999995,479.63800000000003,483.162994,372.546906,8190016.0,478.20529760000005,481.7382698909091,14.531982000000028,57.746679083418066,-3.74870178515502,7.865900120783806,90.56523071678879,-6327536.547409526,-547252.6265335166,84.0,80.0,4.0,9.544005999999968,484.38366666666667,489.1293333333333,495.0956726666666,499.8413393333332,478.4173273333334,473.67166066666675,467.7053213333335,0.3290694572053096,640676976.0,-1
2014-10-20,481.625,482.819,475.26300000000003,481.45599400000003,368.74609399999997,7702720.0,479.50399760000005,482.3293056,12.986999999999966,55.705270600279874,-4.176387347322259,10.270064062945664,53.64640273134711,-2820127.530699139,-650565.1361411448,80.0,76.0,4.0,3.0310059999999908,479.84599800000007,484.4289960000001,487.40199800000005,491.9849960000001,476.8729960000001,472.2899980000001,469.31699600000013,0.8196127580730562,632974256.0,-1
2014-10-21,481.23699999999997,481.23699999999997,463.75,476.54400599999997,364.935181,26081384.0,479.06709880000005,481.79112530909094,-4.3689880000000585,49.853705656189376,-5.40707647979957,11.176955343899294,14.740006664330615,4046689.6331283203,-437053.52817327966,76.0,72.0,4.0,10.493988000000058,473.84366866666664,483.9373373333333,491.3306686666666,501.42433733333326,466.4503373333333,456.3566686666667,448.96333733333336,0.7316295533825122,606892872.0,-1
2014-10-22,476.162994,476.48699999999997,472.02499400000005,471.618988,367.169128,5353320.0,478.3376982000001,480.4369233454546,-7.294006000000024,44.45161667459135,-6.641030253679925,11.531906382220654,9.81894452410624,-13328050.998298083,-1023008.0307950476,72.0,68.0,4.0,10.712005999999917,473.37699399999997,474.7289939999999,477.8389999999999,479.1909999999998,470.26698799999997,468.91498800000005,465.80498200000005,-0.09099180951349127,601539552.0,-1
2014-10-27,481.25,481.25,472.77499400000005,474.506012,367.84612999999996,4767752.0,480.16139820000006,479.7402531272728,18.236999999999966,48.244840082867334,-5.917691951143126,10.376795154771116,20.662130408372335,-20449978.596413035,-1906052.2512197038,68.0,64.0,4.0,7.899993999999992,476.1770020000001,479.5790100000001,484.6520080000001,488.05401600000005,471.10400400000015,467.7019960000001,462.6289980000002,0.20424976690281507,606307304.0,+1
2014-10-28,470.625,476.54400599999997,470.625,475.381012,366.414642,6666368.0,482.1144988000001,478.87109200000003,19.531006000000048,49.45195041316834,-5.698462386470404,9.338050146293881,4.432683106279544,-17565672.22997937,-2617853.239216998,64.0,60.0,4.0,17.705994000000032,474.1833393333333,477.74167866666664,480.10234533333323,483.6606846666666,471.8226726666667,468.26433333333335,465.9036666666667,0.8035153199709587,612973672.0,+1
2014-10-29,476.618988,486.587006,476.618988,473.53100599999993,375.429352,8229336.0,480.8595000000001,477.3104569454545,-12.549988000000099,46.789655571718,-6.161977826495475,11.210085824445116,25.116699972423977,-4419276.522705273,-2699736.1245097043,60.0,56.00000000000001,4.0,4.519011999999918,478.91233333333327,481.20567866666653,488.8803513333332,491.1736966666665,471.23766066666656,468.9443153333333,461.2696426666666,-0.3097889670745053,604744336.0,-1
2014-10-30,487.0,497.65600599999993,487.0,485.181,381.72643999999997,15245208.0,480.0957,478.0961842181818,-7.638000000000034,61.75156117684334,-3.2430942687128135,13.749203520068193,88.22426194849793,-4139507.8828866547,-2765180.3020361494,56.00000000000001,52.0,4.0,9.631011999999998,489.9456686666667,492.89133733333335,500.60167466666667,503.5473433333333,482.2353313333334,479.28966266666674,471.5793253333335,-0.17070185583604477,619989544.0,+1
2014-10-31,498.381012,508.25,498.381012,493.319,391.853027,8670800.0,480.4488006000001,480.50042058181816,3.5310059999999908,68.81845227620168,-3.648381185094681,13.177743794840524,133.53815116784534,-7965995.3271590695,-3001581.008067674,52.0,48.0,4.0,5.919005999999968,499.98333733333334,501.5856626666667,509.85232533333334,511.4546506666667,491.7166746666667,490.11434933333334,481.8476866666667,-0.5129210816752418,628660344.0,+1
2014-11-03,509.61199999999997,513.75,504.056,506.40600599999993,395.204346,8578408.0,482.11060180000004,485.2199124727273,16.618011999999908,76.77931636940022,-1.7707037974683704,11.612014169969598,152.20259963141112,1646266.3051833254,-2790315.201420552,96.0,44.0,3.999999999999993,11.205993999999976,508.0706686666667,512.0853373333334,517.7646686666667,521.7793373333334,502.39133733333335,498.37666866666666,492.69733733333334,0.2424186094491383,637238752.0,+1
2014-11-05,510.625,519.25,507.125,510.73699999999997,398.96725499999997,10241080.0,484.8680024,490.42471214545446,27.57400599999994,78.84199878754028,-2.025698988697212,10.554797205154443,141.45382245593703,6358093.031865027,-2374478.426566128,96.0,40.0,4.000000000000007,24.125,512.3706666666667,517.6163333333334,524.4956666666667,529.7413333333334,505.4913333333334,500.2456666666667,493.3663333333334,0.2978969072164921,647479832.0,+1
2014-11-07,514.7869870000001,522.875,514.7869870000001,515.599976,403.01037599999995,9970400.0,488.2824006000001,496.0123437090909,34.14398199999994,81.02566556714564,-1.7163135358301458,9.194100245516609,153.70695702520425,260818.45742098347,-2254692.1943990365,96.0,36.0,4.0,23.069000000000017,517.7539876666666,520.7209883333331,525.8420006666664,528.8090013333331,512.6329753333332,509.66597466666667,504.5449623333333,0.10051776623008754,657450232.0,+1
2014-11-10,521.8809809999999,522.638,517.5,520.825012,402.904388,5594168.0,492.71050120000007,501.9291821454545,44.28100600000005,83.17806446678915,-0.4836303155411347,8.553676741449237,151.5252322196109,-5672371.187574968,-2410041.252130335,96.0,32.0,52.0,20.430999999999983,520.321004,523.142008,525.459004,528.2800080000001,518.004008,515.183004,512.866008,0.6471413001167756,663044400.0,+1
2014-11-11,520.625,520.625,512.974976,520.687988,399.006042,6255088.0,497.6174012000001,507.0159979272728,49.06900000000002,82.89353181252855,-0.515956826894717,8.528834745334848,124.07807978948894,-3947502.1213399176,-2479925.84249933,92.0,28.000000000000004,56.0,12.843994000000066,518.095988,523.2170000000001,525.7460120000001,530.8670240000001,515.5669760000001,510.445964,507.91695200000004,1.0082336996589838,656789312.0,-1
2014-11-12,515.125,518.8380129999999,512.138,515.650024,397.14892599999996,5392896.0,501.73180240000005,510.29465661818176,41.14401200000003,72.38846122132026,-1.704506281332933,9.567272770743386,96.4957657090407,499077.43230322713,-2344516.592738961,88.0,24.0,60.0,12.138000000000034,515.5420123333333,518.9460246666666,522.2420253333333,525.6460376666665,512.2460116666667,508.84199933333343,505.54599866666683,0.5241816694982606,651396416.0,-1
2014-11-13,515.25,525.1309809999999,514.049988,513.25,404.171112,4956680.0,505.5187012000001,512.3888743636364,37.868988,67.6742380566044,-2.788105425265925,11.369337365571937,89.91446007571456,3498375.3632704034,-2078930.5760228161,84.0,20.0,64.0,7.038024000000064,517.4769896666667,520.9039913333334,528.5579826666665,531.9849843333333,509.82299833333343,506.39599666666675,498.7420053333335,-0.0721946128835196,646439736.0,-1
2014-11-14,524.25,526.43103,521.75,522.325012,405.43310499999995,5233176.0,510.39810180000006,515.4445672363636,48.79400600000008,74.82676308241807,-0.9606270279441222,13.819837000305995,101.55433298060812,3626263.6083328323,-1819603.5501990286,96.0,16.0,64.0,7.8500360000000455,523.502014,525.2540280000001,528.1830439999999,529.935058,520.5729980000001,518.8209840000001,515.8919680000001,0.12283877693584949,651672912.0,+1
2014-11-17,523.125,528.487,518.513,523.955994,408.02533,5458184.0,514.2756012000001,517.9096385454546,38.77499400000005,75.93113679638978,-1.05498094238008,16.50878340681527,87.54404375708972,-7655624.968994169,-2084877.26808626,96.0,12.0,64.0,8.549987999999985,523.6519979999999,528.7909959999998,533.6259979999999,538.7649959999998,518.8169959999999,513.677998,508.84299599999997,0.5457182674954918,657131096.0,+1
2014-11-18,528.125,528.474976,521.513,527.30603,404.533936,5267120.0,517.6743042,520.2788074181818,33.98702999999995,78.19798218975258,-0.2749722343167551,20.69605682114758,81.51616435049304,23062498.988036416,-941814.640931218,96.0,8.0,64.0,11.080992999999921,525.7646686666666,530.0163373333331,532.7266446666666,536.9783133333331,523.0543613333332,518.8026926666666,516.0923853333333,0.8320956578994216,662398216.0,+1
2014-11-19,522.5,523.7440190000001,517.4689940000001,522.794006,403.663452,5201120.0,519.3131042,521.2096622909091,16.388000000000034,68.21388217990805,-1.3255334852975758,23.440465354584262,57.85820141382735,-22329484.912743885,-1913981.5283440987,92.0,4.0,80.0,13.181029999999964,521.335673,525.202352,527.6106980000002,531.477377,518.927327,515.060648,512.652302,0.848604109146956,657197096.0,-1
2014-11-20,523.75,529.062012,522.981018,521.669006,408.717102,5347928.0,520.4063047999999,521.6380080727273,10.932006000000001,65.79703748386586,-1.7190558090957389,23.896682498248936,58.022772802993416,-3169299.4587034164,-1971041.4374560334,88.0,0.0,84.0,9.973999999999933,524.5706786666666,526.1603393333332,530.6516726666666,532.2413333333333,520.0793453333332,518.4896846666666,513.9983513333332,-0.21575617407285297,651849168.0,-1
2014-11-21,521.25,522.375,512.700012,528.200012,401.032562,10463272.0,521.6663084,523.0550457454545,12.600036000000046,72.3574304616673,-0.20043621058071187,22.817721797920626,40.58067768133397,2940881.32353285,-1747772.2091457238,96.0,24.0,88.0,6.961975999999936,521.0916746666667,529.4833373333333,530.7666626666667,539.1583253333333,519.8083493333334,511.4166866666667,510.13336133333337,1.6020691705250718,662312440.0,+1
2014-11-24,525.0,535.205994,523.9940190000001,518.268982,413.50537099999997,11047440.0,521.4107054000001,522.4373500363636,-2.5560299999999643,54.13813624472309,-3.8828012986909988,22.837440187841423,46.03151526689619,-23627361.929694474,-2742299.065230294,92.0,20.0,88.0,9.837035999999898,525.8229983333334,527.6519776666668,537.0349733333334,538.8639526666667,516.4400026666668,514.6110233333335,505.2280276666669,-0.5106180668437161,651265000.0,-1
2014-11-25,536.875,539.9940190000001,530.75,534.388,416.2229,14886576.0,522.7807066,524.7968581454545,13.700012000000015,68.83461066651384,-1.2712233632356948,23.065260435713242,63.02750540972548,-2524668.3664193866,-2732406.7602584134,96.0,16.0,88.0,6.268006000000014,535.0440063333334,539.3380126666668,544.2880253333335,548.5820316666669,530.0939936666667,525.7999873333333,520.8499746666666,0.3935517657417187,666151576.0,+1
2014-11-26,537.5,539.7130129999999,533.950012,537.900024,415.956696,7930800.0,525.0057066,527.5458249454546,22.25,71.15815668419509,-0.47483523807157646,22.525790206331806,61.323218252161304,4166411.005187239,-2418824.1200177297,96.0,12.0,72.0,9.674987999999985,537.187683,540.425354,542.9506839999999,546.1883549999999,534.662353,531.4246820000001,528.8993520000001,0.6854088694414718,674082376.0,+1
2014-11-27,540.237,547.049988,539.0,537.55603,422.287079,17389032.0,527.4363096,529.8277019272728,24.306029999999964,70.56358983957475,-2.1189506203044517,22.02328641231054,64.4342748038441,14911217.168231903,-1631094.9356904721,92.0,8.0,72.0,11.211974999999939,541.202006,543.404012,549.251994,551.454,535.354024,533.152018,527.304036,-0.1793754226714423,656693344.0,-1
2014-11-28,546.263,549.75,542.924988,545.737,421.702118,14347264.0,529.7775084,533.1551001818182,23.41198799999995,76.05406197281354,-0.8902939545202515,22.06836701960333,70.76879847424817,9423744.18564455,-1128602.2271298072,96.0,4.0,80.0,21.725037000000043,546.1373293333332,549.3496706666665,552.9623413333331,556.1746826666665,542.5246586666665,539.3123173333332,535.6996466666665,0.41201568583322273,671040608.0,+1
2014-12-01,548.375,550.275024,536.575012,544.981018,420.73489400000005,18341864.0,531.8800108,535.9193746545454,21.025023999999917,74.57103323001418,-1.1731218699132084,22.450641462958174,58.355820023591285,1337385.761822093,-1016511.8594757285,96.0,0.0,84.0,5.763000999999917,543.9436846666666,551.3123573333332,557.6436966666668,565.0123693333333,537.6123453333332,530.2436726666666,523.9123333333332,0.6135765428526577,652698744.0,-1
2014-12-02,541.237,541.237,528.75,543.731018,411.386658,10654992.0,533.5225095999999,538.0741032363637,16.424987999999985,71.89630186274097,-1.4501148195606945,21.352354068846807,36.18676461070076,3523904.042819107,-810129.3105184908,96.0,8.0,84.0,9.149963999999954,537.906006,547.0620120000001,550.393006,559.5490120000001,534.5750120000001,525.4190060000001,522.0880120000002,1.1997291583246568,642043752.0,-1
2014-12-03,525.375,533.237,521.138,531.650024,410.786957,12775044.0,534.4081114,537.7336513090909,8.856018000000063,51.354819541405114,-4.1271949497475395,19.439299710680643,5.615105619639984,444933202.77117616,19450931.98306613,92.0,4.0,92.0,12.193970000000036,528.675008,536.2120160000001,540.774008,548.311016,524.1130160000001,516.5760080000001,512.0140160000002,0.8688341185221965,629268708.0,-1
2014-12-04,527.5,536.224976,523.75,530.875,406.58923300000004,9399228.0,535.3287108000001,537.0912674181818,9.205994000000032,50.29122084591648,-4.298935896793621,17.18092469460555,8.411202051683732,555948.1204674349,18592069.050099388,88.0,0.0,96.0,13.700012000000015,530.2833253333333,536.8166506666666,542.7583013333333,549.2916266666666,524.3416746666667,517.8083493333334,511.8666986666667,0.5711433833620215,619869480.0,-1
2014-12-05,528.75,529.150024,514.950012,525.450012,400.495544,7358760.0,535.0537108,535.2951403636364,-2.75,43.08433675254456,-5.50108263913139,15.41942510156423,-17.758780789847176,-4369393.149387099,17548366.187909912,84.0,0.0,88.0,16.23101799999995,523.1833493333334,531.4166866666667,537.3833613333334,545.6166986666667,517.2166746666667,508.98333733333334,503.01666266666666,0.7394359948428205,612510720.0,-1
2014-12-08,502.25,504.75,489.43798799999996,517.575012,381.12207,166320408.0,534.9843138,532.1171951272728,-0.6939700000000357,34.744754542416345,-7.2461382219105515,13.477957588112986,-92.7022684086016,12457385.199304925,17316957.953760408,80.0,0.0,88.0,22.593017999999915,503.921,518.404012,519.2330120000001,533.7160240000001,503.092,488.60898799999995,487.77998799999995,1.837578497195534,446190312.0,-1
2014-12-09,495.68798799999996,496.5,488.11199999999997,492.537994,380.086792,10050460.0,530.7993132,524.3996824363637,-41.85000600000001,20.317667011811054,-12.794200194868308,10.653878447391776,-134.8850303593067,-12538536.835702905,15959889.967390366,76.0,96.0,88.0,12.47497599999997,492.3833313333333,496.6546626666666,500.77133133333325,505.0426626666666,488.26666266666655,483.99533133333324,479.8786626666665,0.5276578445398238,436139852.0,-1
2014-12-10,491.5,496.25,489.77499400000005,491.200012,379.884033,7804712.0,526.129312,517.1998094909092,-46.700012000000015,19.810443708938834,-13.090689459472504,9.548519837231765,-122.76225039144526,3754018.3818575838,15405077.60643931,72.0,96.0,84.0,15.924987999999985,492.40833533333335,495.04167666666666,498.88334133333325,501.5166826666666,488.5666706666667,485.9333293333334,482.09166466666676,0.22007979606505024,428335140.0,-1
2014-12-11,487.75,488.48699999999997,478.75,490.93798799999996,371.62381,8285932.0,521.4675078,510.80138694545457,-46.618042,19.69931781839196,-13.148752499983264,6.906372215514352,-134.5818850820088,-19029185.147356905,13839883.801401868,68.0,92.0,80.0,36.01202400000005,486.05832933333335,493.3666586666667,495.79532933333326,503.10365866666666,483.6296586666667,476.3213293333334,473.89265866666676,1.251719009962001,420049208.0,-1
2014-12-12,484.76300000000003,490.10000599999995,479.52499400000005,480.26300000000003,375.028503,14572500.0,514.9201078,503.3096582545454,-65.47399999999993,15.588714378078492,-15.514269630840458,3.5234165562187627,-126.56987911674051,7297507.9830259215,13542503.074495396,64.0,96.0,-20.0,29.46301200000005,483.296,487.06700599999994,493.8710119999999,497.64201799999984,476.49199400000003,472.7209880000001,465.91698200000013,0.06978772222669735,405476708.0,-1
2014-12-15,476.23699999999997,489.31201200000004,476.22500599999995,484.662994,372.348877,12966284.0,508.8883054,497.8083648363637,-60.31802399999992,23.209416042521582,-14.539255777647469,0.277548193954658,-111.34422709983323,-26683190.65465584,11714062.404140221,60.0,92.0,-24.0,6.475005999999951,483.400004,490.5750020000001,496.4870100000001,503.6620080000002,477.487996,470.31299799999994,464.4009899999999,0.6447607649908633,418442992.0,+1
2014-12-16,481.424988,487.89999400000005,481.424988,481.200012,374.902405,17792756.0,502.63520480000005,492.7741296727273,-62.531005999999934,21.450751476992707,-15.306633056652391,-4.231910423897375,-100.34482916659914,-40414792.01171225,9344568.964324648,56.00000000000001,96.0,-24.0,12.450012000000015,483.5083313333334,485.5916746666668,489.98333733333345,492.06668066666685,479.1166686666667,477.0333253333333,472.64166266666666,-0.03474529598890988,400650236.0,-1
2014-12-17,484.0,488.875,474.075012,484.5,374.999115,17851776.0,497.9202024,489.47681970909093,-47.15002400000003,27.491846646395587,-14.575374328715348,-9.031311831533401,-94.30694797843553,3570267.6701155705,9082100.717622628,52.0,92.0,-32.0,11.412993999999912,482.48333733333334,490.89166266666666,497.2833253333333,505.69165066666665,476.0916746666667,467.68334933333335,461.2916866666667,0.7043916522094474,418502012.0,+1
2014-12-18,488.5,495.450012,486.18798799999996,484.625,380.299622,19949980.0,493.2952024,487.05951018181815,-46.25,27.734758473512443,-14.547675033750599,-14.466203940198795,-69.02350059769971,1926205.0855654182,8756832.727183262,48.0,96.0,-32.0,13.087006000000088,488.7543333333333,491.32067866666665,498.01635733333336,500.5827026666667,482.0586546666666,479.49230933333325,472.79663066666654,-0.16875231590848314,438451992.0,+1
2014-12-19,499.39999400000005,502.0,496.5,491.47500599999995,386.63537599999995,14294632.0,489.8977018,486.72856538181816,-33.975006000000064,40.366925574307736,-13.029752340116229,-18.689010465079036,-43.43872382656457,15675310.59488214,9071309.000508364,44.0,92.0,-39.99999999999999,6.475006000000064,496.6583353333333,496.8166706666666,502.1583353333333,502.3166706666666,491.3166706666666,491.1583353333333,485.8166706666666,-0.9136352727272817,452746624.0,+1
2014-12-22,501.5,502.52499400000005,493.837006,499.662994,386.818756,10465104.0,488.10650000000004,488.5040730545454,-17.91201799999999,51.95111971443674,-9.400842986905198,-22.430316350928138,-34.426361711602425,-2329142.3034056644,8553106.658112848,40.0,88.0,-40.0,14.799987999999985,498.674998,503.51299000000006,507.3629860000001,512.2009780000001,494.825002,489.98700999999994,486.1370139999999,0.6705796554967619,463211728.0,+1
2014-12-23,500.212006,505.47500599999995,490.89999400000005,499.89999400000005,381.412262,8196952.0,488.8427,490.64834469090914,7.362000000000023,52.26084198701688,-8.308075703342237,-25.674853881445244,-29.017364632688167,-2861998.0334800757,8034238.2531009605,36.0,84.0,-48.0,10.950012000000015,498.7583313333334,506.6166686666667,513.3333433333332,521.1916806666666,492.0416566666668,484.1833193333335,477.4666446666669,0.617495203434485,471408680.0,+1
2014-12-24,494.0,496.75,478.76300000000003,492.912994,373.461578,27339488.0,489.01399820000006,491.3883981454546,1.7129820000000109,42.86239840954212,-9.906108840406214,-28.108997394559196,-47.45850087453647,-4130599.8858405766,7481291.054856425,32.0,80.0,-48.0,17.375,489.4753313333334,500.1876626666667,507.4623313333333,518.1746626666667,482.20066266666674,471.4883313333334,464.2136626666668,0.7866789347862355,444069192.0,-1
2014-12-29,489.01300000000003,493.200012,488.125,488.06201200000004,378.732635,2792676.0,488.9639006,490.2069462181818,7.799012000000005,41.212830500103294,-4.283902759816901,-27.26010263465679,-28.55435566828871,495024.36933265737,6878280.847112091,24.0,72.0,-48.0,14.575011999999901,489.7956746666667,491.46634933333337,494.87068666666664,496.5413613333334,486.39133733333335,484.72066266666667,481.31632533333334,-0.012411399224270099,444593120.0,+1
2014-12-30,490.56201200000004,493.75,489.200012,489.450012,380.38622999999995,4640552.0,489.44260240000006,490.29533010909097,4.787017999999989,43.299830129424265,-3.9424303495797077,-26.237881681436875,-19.832483692105495,-6086824.179219645,6288957.881997437,20.0,68.0,-48.0,21.136994000000016,490.800008,492.40000399999997,495.3499959999999,496.94999199999995,487.850016,486.25002,483.300028,0.05494519985547233,449233672.0,+1
2014-12-31,488.75,494.73699999999997,487.5,491.587006,381.58639500000004,6968808.0,490.4813018,490.6852216727273,10.386993999999959,46.66359262735682,-3.4166922430649964,-24.23671013895057,-13.383404716558944,3577310.4694418055,6165701.179555614,16.0,64.0,-48.0,10.17599400000006,491.2746686666666,495.04933733333326,498.51166866666654,502.2863373333332,487.8123373333333,484.03766866666666,480.5753373333333,0.5647375984523965,456202480.0,+1
2015-01-01,492.23699999999997,495.5,489.22500599999995,493.13800000000003,381.94390899999996,2002764.0,491.34510180000007,491.16825770909094,8.638000000000034,49.188014041030115,-3.0351204423132274,-21.661068397300255,-4.77215737464612,13807745.341077816,6513066.828294703,12.0,60.0,-48.0,10.562011999999982,492.62100200000003,496.0169980000001,498.89599600000014,502.29199200000016,489.74200400000007,486.346008,483.46701,0.6235852974520856,458205244.0,+1
2015-01-02,493.0,504.76300000000003,493.0,493.60000599999995,389.449677,6778320.0,492.24260239999995,491.5782402909091,8.97500599999995,50.001371755603415,-2.9214588411864124,-18.20853020178845,16.463632761092608,-4789560.614369666,5999311.028340088,8.0,56.00000000000001,-48.0,5.687987999999962,497.12100200000003,501.24200400000007,508.884002,513.0050040000001,489.47900400000003,485.358002,477.716004,0.051007906146386894,464983564.0,+1
2015-07-02,499.5,500.700012,492.52499400000005,498.700012,418.759796,4007568.0,499.2125,497.9554559636363,0.8500060000000644,49.990778871312955,-3.7736955762864843,-1.5399288022554742,-40.195860283628825,4018380.1637778273,263308.3540893959,8.0,48.0,-40.0,7.924987999999985,497.3083393333334,502.0916846666667,505.48335733333334,510.2667026666667,493.91666666666674,489.1333213333334,485.7416486666668,0.7553522206311951,543753904.0,+1
2015-07-06,492.5,494.0,487.5,495.14999400000005,416.767731,4305602.0,498.2625,496.39590952727275,-2.5249939999999356,46.03202526255108,-4.6283493229009816,-1.9170473104545067,-116.95958481323792,-4380487.324722539,-103865.2630219038,0.0,40.0,-40.0,8.5,492.2166646666667,496.9333293333334,498.7166646666667,503.4333293333334,490.4333293333334,485.7166646666667,483.9333293333334,1.1769221538461614,545364200.0,+1
2015-07-09,478.75,483.0,467.02499400000005,478.75,397.567505,8587772.0,493.36000060000003,491.1072720727273,-18.799987999999985,28.093455148606154,-8.576587421005117,-3.604634587506041,-282.20186829426706,-868234.5,-392547.5887912308,48.0,96.0,-40.0,8.52502400000003,476.2583313333334,485.4916686666667,492.2333373333334,501.4666746666667,469.5166626666668,460.28332533333344,453.5416566666668,0.7339594113454472,526254832.0,-1
2015-07-10,474.049988,476.049988,466.325012,469.0,397.355591,7411522.0,490.73749999999995,486.67818105454546,-26.22500599999995,21.84979219184396,-10.923863978332832,-4.493919846374013,-269.4098853025957,-3470362.0591759537,-532448.2465412494,44.0,96.0,-40.0,7.700012000000015,470.4583333333333,474.5916546666666,480.1833093333332,484.3166306666666,464.86667866666664,460.73335733333334,455.1417026666667,0.2750637122394948,518843310.0,-1
2015-07-13,470.5,477.5,467.02499400000005,468.75,402.71725499999997,6531768.0,487.35,482.68045378181824,-33.875,21.707061088201925,-10.839163419170582,-5.0390939703539175,-196.87429558831602,1028814.7182277332,-461481.74814011314,40.0,96.0,-40.0,6.5,471.0916646666667,475.15833533333335,481.56667066666665,485.6333413333333,464.6833293333334,460.61665866666675,454.20832333333345,0.16467828276183888,512311542.0,-1
2015-07-14,477.5,486.75,472.75,475.075012,411.660339,5367074.0,485.35,480.4486377818182,-20.0,34.24604742178231,-7.937573561811502,-5.464607948365767,-110.20144568050178,-60993730.94736842,-3212947.6209265417,36.0,92.0,20.000000000000007,5.649994000000049,478.19167066666665,483.6333413333333,492.1916706666666,497.6333413333333,469.6333413333333,464.19167066666665,455.6333413333333,0.1660722857142868,517678616.0,+1
2015-07-15,485.0,492.97500599999995,484.0,485.625,417.064392,4129566.0,484.6950012,480.4986377818182,-6.549987999999985,49.7383260873007,-4.959436724467157,-6.948836363533076,-31.495694329878553,13131458.504408626,-2470020.0697506554,32.0,88.0,20.0,14.25,487.5333353333333,491.0666706666666,496.5083413333332,500.04167666666655,482.09166466666665,478.55832933333335,473.1166586666667,0.18105837477991757,521808182.0,+1
2015-07-16,493.85000599999995,495.75,489.75,492.0,419.204834,3472938.0,484.02500000000003,481.8268193818182,-6.700012000000015,56.830040072659735,-3.392327533696974,-7.479527723850083,4.62556201589504,-199894.5734850197,-2366832.5471899062,28.000000000000004,84.0,-48.0,23.22500599999995,492.5,495.25,498.5,501.25,489.25,486.5,483.25,0.375,525281120.0,+1
2015-07-17,495.5,502.25,494.549988,494.52499400000005,424.630066,3447978.0,484.0774994000001,483.7359092,0.5249940000000493,59.445122744676034,-1.9764574969020943,-7.049945773629133,37.57336641969195,1237614.5689290836,-2202994.04190689,24.0,80.0,-52.0,12.424987999999985,497.10832733333336,499.66666666666674,504.8083393333334,507.36667866666676,491.9666546666667,489.40831533333335,484.2666426666667,-0.0032459689673127157,528729098.0,+1
2015-07-20,500.700012,505.39999400000005,493.700012,500.924988,424.375763,4377180.0,484.6549988,486.79908894545457,5.774993999999936,65.54860531389313,-1.1011333823986384,-7.844350540506412,57.955554766219805,6580380.483916814,-1803749.7452671884,20.0,76.0,-56.0,10.47500599999995,500.0083313333334,506.31665066666676,511.7083133333334,518.0166326666667,494.6166686666667,488.30834933333335,482.9166866666667,0.6175202662704907,533106278.0,+1
2015-07-21,517.5,574.5,517.5,500.625,471.59225499999997,38310112.0,485.55249940000004,489.7027255272727,8.97500599999995,65.01936905518846,-15.53627760252366,-8.41415958239952,256.50710304361024,136442.503622668,-1715559.1884970744,16.0,72.0,-56.0,18.0,530.875,544.25,587.875,601.25,487.25,473.875,430.25,-0.29605263157894735,494796166.0,-1
2015-07-22,552.5,556.0,538.325012,556.325012,467.565704,12665660.0,492.1600006,502.57045509090915,66.07501200000002,87.18544800091712,-3.8222898002103016,-7.6623925292021795,297.69181292479755,-8197521.986075276,-2010193.8611218983,96.0,68.0,-56.0,17.899993999999936,550.2166746666667,562.1083373333333,567.8916626666667,579.7833253333333,544.4333493333334,532.5416866666667,526.7583613333334,1.018388244450294,507461826.0,+1
2015-07-23,551.974976,558.5,545.0,551.575012,465.382935,7710748.0,499.4425018,513.3731844363637,72.82501200000002,82.06835629798489,-4.821238275499471,-6.106679216136172,223.3430367150776,8519094.009897023,-1531589.8669728392,92.0,64.0,-56.0,10.125,551.6916706666667,558.3833413333334,565.1916706666666,571.8833413333334,544.8833413333334,538.1916706666667,531.3833413333334,0.48703792592592704,499751078.0,-1
2015-07-24,547.775024,553.224976,541.549988,549.0,460.974854,4480302.0,507.44250180000006,522.3836386545454,80.0,79.1621248765732,-5.3627760252365935,-4.329430092098505,162.8634618439042,-501484.210366877,-1484766.8825805539,88.0,60.0,-56.0,10.25,547.924988,554.299988,559.599976,565.974976,542.625,536.25,530.950012,0.6381173154096625,495270776.0,-1
2015-07-27,543.450012,543.974976,530.224976,543.799988,451.52313200000003,6752244.0,514.9475006,528.994090690909,75.04998799999998,73.12804034982683,-6.456364248159835,-0.6121322298854466,110.0032481818448,-2365799.2301912084,-1524813.8074728495,84.0,56.00000000000001,-56.0,11.699982000000034,539.3333133333333,548.4416506666666,553.0833133333333,562.1916506666666,534.6916506666666,525.5833133333333,520.9416506666666,0.9872736000000011,488518532.0,-1
2015-07-28,534.25,538.0,527.125,532.650024,450.48461900000007,8476602.0,520.7050018000001,532.2127313090909,57.575012000000015,61.52520696477895,-8.801256782334379,4.405242087049203,76.82563741558084,9099054.0,-1041910.7253046065,80.0,52.0,-56.0,73.57501200000002,532.5916746666667,538.0583493333334,543.4666746666667,548.9333493333334,527.1833493333334,521.7166746666667,516.3083493333334,0.5080481839080487,480041930.0,-1
2015-07-29,537.0,546.0,532.5,531.424988,460.04238899999996,7071334.0,525.2850006,534.1618197090909,45.799987999999985,60.31207599229518,-9.058887907465829,10.848766521984999,78.52817092078105,-6346422.224773068,-1283024.884376305,76.0,48.0,28.0,55.375,536.6416626666667,540.7833253333333,550.1416626666667,554.2833253333333,527.2833253333333,523.1416626666667,513.7833253333333,-0.07963051851851964,472970596.0,-1
2015-07-30,545.0,545.0,529.0,542.700012,453.515167,11956598.0,530.3550018000001,537.3281854181819,50.700012000000015,67.18371782927221,-6.687694637223972,16.546650541309248,76.77469549330841,-2488954.983722682,-1337839.8888931235,72.0,44.0,28.0,13.5,538.900004,548.8000079999999,554.9000040000001,564.8000079999999,532.8000079999999,522.900004,516.8000079999999,0.856250750000001,484927194.0,+1
2015-07-31,539.275024,540.674988,530.0,535.0,456.503296,7931012.0,534.4025024000001,538.1727305454546,40.47500599999995,59.11798896851768,-8.307045215562566,20.958947074222067,61.359000568795146,-1241493.4957141604,-1333460.507384907,68.0,40.0,28.0,11.674987999999985,535.224996,540.4499920000001,545.8999840000001,551.12498,529.7750040000001,524.550008,519.1000160000001,0.4683846014627845,476996182.0,-1
2015-08-03,539.0,546.0,534.474976,538.525024,457.308624,7961012.0,538.1625060000001,538.9222799272727,37.600036000000046,61.555952861962965,-7.565715247108301,24.873861500716714,66.08076928024006,1811197.1167124456,-1190521.5244688385,64.0,36.0,27.999999999999993,18.77502400000003,539.6666666666666,544.8583573333333,551.1916906666665,556.3833813333333,533.3333333333333,528.1416426666666,521.8083093333332,0.3514134113733776,484957194.0,+1
2015-08-04,539.0,539.474976,525.5,539.474976,448.111176,9099054.0,542.0475036,539.1609108363637,38.84997599999997,62.255846740784605,-7.365935646687703,29.35751394936335,47.431977532975445,-14505644.217352396,-1795754.3741556797,60.0,32.0,28.0,16.674987999999985,534.8166506666666,544.1333013333333,548.7916266666666,558.1082773333333,530.1583253333333,520.8416746666667,516.1833493333334,1.0,494056248.0,+1
2015-08-05,531.0,545.0,530.974976,528.625,460.445038,4753476.0,539.2775024000001,536.7204556363637,-27.700012000000015,50.20930640674961,-9.647739221871714,32.63874736846492,40.15130342537139,-11158512.103023142,-2221334.2709293067,56.00000000000001,28.000000000000004,28.0,13.5,534.8666586666667,538.7583413333334,548.8916826666668,552.7833653333334,524.7333173333334,520.8416346666667,510.70829333333336,-0.16755593430713306,489302772.0,-1
2015-08-06,547.0,552.75,538.5,543.174988,460.699341,7238252.0,538.4375,537.4290893818181,-8.40002400000003,61.68202840804725,-6.587804837013674,36.527417802029845,52.85090757337917,5839363.875518777,-1854938.9006305218,52.0,24.0,28.0,16.0,544.8083293333333,551.1166586666666,559.0583293333334,565.3666586666666,536.8666586666666,530.5583293333333,522.6166586666666,0.32806933333333227,496541024.0,+1
2015-08-07,539.75,550.5,539.25,543.474976,464.36557,4988058.0,537.8849976000001,538.3449941090909,-5.52502400000003,61.89092715323223,-6.524715878023139,33.31296166264758,42.02180797923264,838221.2957056089,-1732522.5280679741,48.0,20.0,28.0,12.700012000000015,544.4083253333333,549.5666506666666,555.6583253333333,560.8166506666666,538.3166506666666,533.1583253333333,527.0666506666666,0.37555342222221955,501529082.0,+1
2015-08-10,549.0,553.174988,533.5,547.799988,460.296722,3992754.0,538.2849976000001,540.1477196363636,4.0,65.05970122215176,-5.615144479495272,30.359410627244188,34.26489078189084,2264069.131898115,-1550859.270794218,44.0,16.0,28.0,11.52502400000003,544.824992,556.1499839999999,564.49998,575.8249719999999,536.4749959999999,525.150004,516.8000079999999,0.7268105068221641,505521836.0,+1
2015-08-11,549.400024,558.450012,547.849976,543.0,470.10873399999997,7574406.0,539.3199952,541.0049928,10.34997599999997,58.79886195357032,-3.373231773667029,27.537750191808698,38.90106805061147,-6502861.736265243,-1775950.291955032,40.0,12.0,28.0,13.97497599999997,549.7666626666667,551.6833493333334,560.3666986666667,562.2833853333334,541.0833133333333,539.1666266666666,530.4832773333333,-0.4575433517395553,497947430.0,-1
2015-08-12,557.5,574.5,555.5,554.575012,485.04937699999994,10168440.0,541.6349976,543.7786322181819,23.15002400000003,67.50090081356188,-4.190323449001048,25.360265262590474,61.497832463539574,-5959492.190090401,-1966111.287327273,36.0,8.0,28.000000000000004,14.02502400000003,561.525004,567.5500079999999,580.5250040000001,586.5500079999999,548.5500079999999,542.525004,529.5500079999999,-0.04868357894736762,508115870.0,+1
2015-08-13,573.5,583.424988,527.775024,572.200012,490.813599,9787960.0,544.5849976000001,549.3359075636364,29.5,76.29671323939266,-2.3171752651207105,25.059453174508235,56.461232891313095,11282825.378640616,-1363886.8934122303,32.0,4.0,28.0,24.125,561.1333413333333,594.4916586666666,616.7833053333334,650.1416226666665,538.8416946666666,505.48337733333335,483.1917306666667,0.7982932028491523,517903830.0,+1
2015-08-14,582.5,584.349976,571.549988,579.0,487.10495,5109066.0,548.9849976,555.5931807272727,44.0,78.8455043250452,-1.1022924208406617,24.505516607217942,96.26986612013077,-2328782.0734888306,-1407745.7652344091,96.0,0.0,28.0,11.25,578.299988,585.049988,591.099976,597.849976,572.25,565.5,559.450012,0.5820327331556893,523012896.0,+1
2015-08-17,575.0,576.724976,561.25,574.625,484.095642,3107436.0,552.5949952000001,560.2549993454545,36.09997599999997,73.0168713750833,-2.003703818046541,21.758670946786538,66.77110932381099,31235311.621301115,76029.57053384367,96.0,0.0,28.0,19.674987999999985,570.8666586666667,580.4833173333334,586.3416346666668,595.9582933333334,565.0083413333334,555.3916826666667,549.5333653333334,0.8642985940656727,519905460.0,-1
2015-08-18,575.0,588.849976,575.0,571.075012,493.505005,4150446.0,555.7549988000001,563.6150024,31.600036000000046,68.29030706234842,-3.6286546638516026,19.986933937069125,81.57416412484562,3797905.038489794,245205.72817001582,92.0,0.0,28.0,10.65002400000003,578.3083293333333,581.6166586666666,592.1583053333334,595.4666346666666,567.7666826666666,564.4583533333333,553.9167066666666,-0.2833931264574028,515755014.0,-1
2015-08-19,585.0,593.099976,581.400024,582.174988,498.252136,6869518.0,561.1099976,568.4186368,53.549987999999985,74.29379205182008,-2.2110885510344542,18.47424097643693,96.99857295080594,4629557.77668886,444494.45765018114,96.0,0.0,28.0,31.5,585.5583293333333,589.7166346666666,597.2582813333333,601.4165866666665,578.0166826666666,573.8583773333334,566.3167306666667,0.0662365110557683,522624532.0,+1
2015-08-20,579.5,584.25,564.0,587.775024,480.87448099999995,8369114.0,565.5700012,573.2668234181818,44.600036000000046,76.84567210687037,-1.0777073990385986,17.740741133471943,73.23584727272052,-34061795.71761996,-1123973.2776046675,96.0,0.0,28.0,55.649963999999954,578.675008,593.3500160000001,598.9250080000002,613.6000160000001,573.1000160000001,558.425008,552.8500160000001,1.1740752592592607,530993646.0,+1
2015-08-21,570.450012,580.474976,558.75,567.275024,487.38046299999996,10822142.0,567.950006,573.5768275636365,23.80004800000006,54.143054170725016,-5.226665301436878,18.59470978704269,43.2124284433008,-18841868.73577591,-1929332.1620744942,92.0,4.0,96.0,12.799987999999985,568.8333333333334,578.9166666666667,590.5583093333335,600.6416426666667,557.1916906666668,547.1083573333334,535.4667146666668,0.3924066015078701,520171504.0,-1
2015-08-24,554.974976,561.5,539.299988,574.950012,462.860992,14122684.0,570.6650084,574.8495559272727,27.15002400000003,59.33308042451574,-3.673338369075321,17.994524683575605,13.12703246600998,899852.2568125252,-1800732.8703057594,88.0,0.0,96.0,17.75,558.5833333333334,577.8666786666668,580.7833453333335,600.0666906666668,555.6666666666667,536.3833213333334,533.4666546666667,1.6058560689066297,534294188.0,+1
2015-08-25,550.0,559.5,522.25,546.025024,460.148376,13735078.0,570.9675108000001,570.3695587636364,3.0250240000000304,39.763170618273456,-9.527414346605825,17.15170106772507,-34.8541078893055,-2170475.120852826,-1817539.3362398597,84.0,0.0,92.0,14.22497599999997,542.5916746666667,562.9333493333334,579.8416746666667,600.1833493333334,525.6833493333334,505.3416746666667,488.43334933333335,0.6382556778523498,520559110.0,-1
2015-08-26,544.900024,548.5,529.5,542.825012,451.226379,11498212.0,569.7925108,565.2527408,-11.75,38.156642231123186,-10.175058984418966,15.658995779435713,-42.999688139106716,-12065576.4,-2283359.202778183,80.0,96.0,96.0,22.024963999999954,540.275004,551.0500079999999,559.2750040000001,570.0500079999999,532.0500079999999,521.275004,513.0500079999999,0.7013164210526324,509060898.0,-1
2015-08-27,544.0,550.049988,539.025024,532.299988,458.940491,15343392.0,565.8025084,558.4359184727273,-39.90002400000003,33.08389294237229,-12.305199545283926,18.111187865893044,-44.067358114340394,-2467068.014946515,-2291709.6033313535,76.0,92.0,96.0,20.25,540.4583333333334,541.8916426666667,551.4832973333332,552.9166066666667,530.8666786666668,529.4333693333334,519.8417146666668,-0.6099825813490252,493717506.0,-1
2015-08-28,550.799988,562.450012,550.799988,541.400024,470.914093,7208820.0,562.0425108,553.9991031272726,-37.59997599999997,40.91970205771724,-10.46345972702495,19.03068422979277,-12.454474024397443,3443196.143031263,-2031032.069403857,72.0,88.0,88.0,29.02502400000003,551.550008,552.3000280000001,563.200032,563.9500520000001,540.6500040000001,539.899984,528.99998,-0.8068622004555467,500926326.0,+1
2015-08-31,567.424988,567.424988,541.25,555.525024,463.85699500000004,9917064.0,560.1325132000001,552.8141055272728,-19.09997599999997,51.16213449451572,-7.6047265381773546,17.697280645332057,-4.990708290739829,1364310.260838379,-1876698.3271190322,68.0,84.0,88.0,27.975036000000046,554.7333373333333,568.2166746666667,580.9083253333333,594.3916626666667,542.0416866666667,528.5583493333334,515.8666986666667,0.5453688842187832,510843390.0,+1
2015-09-01,545.0,557.299988,541.0,547.200012,461.56820700000003,9071550.0,557.7450132,550.4627416727272,-23.875,45.76638966259604,-9.289610651590067,14.727620989067532,-29.575784820946833,-2214006.13493562,-1892030.5002017072,64.0,80.0,84.0,52.700012000000015,548.5,556.0,564.799988,572.299988,539.700012,532.200012,523.400024,0.38036911438217136,501771840.0,-1
2015-09-02,549.0,557.5,545.0,544.5,465.997437,11171830.0,553.9775144000001,548.0545574545455,-37.674987999999985,44.028718759806885,-9.83606119422276,11.345255601024292,-32.462733876398325,-17899535.7880137,-2619644.3769251024,60.0,76.0,-16.0,19.0,549.0,553.0,561.5,565.5,540.5,536.5,528.0,-0.04,490600010.0,-1
2015-09-03,555.075012,556.0,546.25,549.724976,465.955078,8590536.0,550.1725096000001,547.2813686545454,-38.05004800000006,48.403047691760605,-8.778587756903676,8.25949534728204,-28.92186475357166,6827475.303331639,-2190229.8460017117,56.00000000000001,72.0,-16.0,11.024963999999954,550.6583253333333,555.0666506666666,560.4083253333333,564.8166506666666,545.3166506666666,540.9083253333333,535.5666506666666,0.35640779487179175,499190546.0,+1
2015-09-04,551.5,555.5,533.5,549.674988,455.18942300000003,7318888.0,548.4125060000001,547.1909101818181,-17.600036000000046,48.36132486289542,-8.788704737763434,4.0645513574803545,-53.32183459495491,-14660236.565144666,-2757048.333238796,52.0,68.0,-16.0,30.15002400000003,546.224996,558.9499920000001,568.2249959999999,580.9499920000001,536.9499920000001,524.224996,514.9499920000001,0.7352267272727265,491871658.0,-1
2015-09-07,542.474976,542.5,527.5,536.974976,448.746918,5180988.0,544.6150024,545.1113592727273,-37.975036000000046,38.60599308715591,-11.359037184005045,-2.1175100872582107,-105.49191158729607,-1581692.5869061514,-2703623.072041559,48.0,64.0,-16.0,26.174987999999985,535.6583253333333,543.8166506666666,550.6583253333333,558.8166506666666,528.8166506666666,520.6583253333333,513.8166506666666,0.6316650666666647,486690670.0,-1
2015-09-08,531.0,537.0,526.150024,529.375,448.768158,5459496.0,542.95,542.3404497454545,-16.65002400000003,33.88620228473033,-12.897182573431246,-5.8829979267767385,-129.21253841046848,2865727.8563235933,-2450470.7571145217,44.0,60.0,-16.0,16.299987999999985,530.8416746666667,535.5333253333333,541.6916506666666,546.3833013333333,524.6833493333334,519.9916986666667,513.8333733333334,0.2972334685348593,481231174.0,-1
2015-09-09,543.549988,549.799988,536.0,529.400024,461.441101,9148664.0,541.6075012,539.8768177454547,-13.424987999999985,33.916896099774235,-11.303446883049968,-11.024881064518013,-89.98116697391842,-6302741.956172545,-2625573.9934362313,40.0,56.00000000000001,-16.0,12.5,538.400004,540.8000079999999,552.1999919999998,554.5999959999999,527.00002,524.600016,513.200032,-0.4782595463126473,490379838.0,+1
2015-09-10,542.450012,545.75,530.5,544.349976,457.944336,8363004.0,542.8125000000001,540.3754495272727,12.049987999999985,49.93815369830232,-7.502985991114105,-12.790774725368465,-79.31778042006577,-8383280.4479445815,-2887287.9231878812,36.0,52.0,-15.999999999999993,11.5,540.199992,549.8999839999999,555.4499919999998,565.1499839999999,534.6499839999999,524.949992,519.3999839999999,0.9081951475409816,498742842.0,+1
2015-09-11,545.775024,553.200012,542.75,540.224976,462.309937,9883810.0,542.6949952,539.9049906181817,-1.1750480000000607,46.359826624506596,-5.806695350761266,-13.379254713870978,-41.57176465128185,2009269.2130650019,-2664717.1442662645,32.0,48.0,-16.0,22.0,545.3916626666667,548.0333253333333,555.8416746666667,558.4833373333333,537.5833133333333,534.9416506666666,527.1333013333333,-0.24162881344059955,488859032.0,-1
2015-09-14,549.5,552.0,541.325012,545.375,466.12460300000004,6557076.0,541.6799928,540.3922642181817,-10.15002400000003,51.37871138909063,-4.707261261647294,-12.340317903654068,-29.402186942113264,-7665649.648128273,-2892032.258079179,28.000000000000004,44.0,-16.0,22.174987999999985,546.2333373333333,551.1416626666667,556.9083253333333,561.8166506666666,540.4666746666667,535.5583493333334,529.7916866666667,0.37939040306181054,495416108.0,+1
2015-09-15,549.700012,551.599976,544.075012,549.875,465.891418,5291886.0,541.9474916,541.8822655272727,2.674987999999985,55.56997323399115,-3.746595175234329,-12.08808026992699,-8.815038490335214,-1465347.3920331728,-2827182.945985905,24.0,40.0,-16.0,10.84997599999997,548.5166626666667,552.9583133333333,556.0416266666666,560.4832773333333,545.4333493333334,540.9916986666667,537.9083853333334,0.7707662123034767,500707994.0,+1
2015-09-16,554.0,554.875,549.150024,549.599976,466.929901,7478240.0,542.4574892,543.2736263272727,5.09997599999997,55.234210519639895,-3.8053076707342557,-14.125029265579428,18.058279449806232,-9476757.005146604,-3129436.3123126086,20.0,36.0,-16.000000000000007,20.424987999999985,551.2083333333334,553.2666426666667,556.9333093333335,558.9916186666667,547.5416666666667,545.4833573333334,541.8166906666668,0.07859456528725041,493229754.0,-1
2015-09-18,555.900024,558.950012,549.525024,550.825012,468.11666900000006,11576876.0,542.5674928000001,544.7949941090909,1.1000360000000455,56.58250033228415,-3.5437853285486915,-14.36240015719659,41.050183920912346,8712584.652753009,-2591162.632080283,16.0,32.0,-16.0,16.34997599999997,553.100016,556.6750079999999,562.5250040000001,566.0999959999999,547.25002,543.675028,537.825032,0.1379299368869209,504806630.0,+1
2015-09-21,550.0,554.424988,546.25,552.224976,468.201447,4351234.0,542.8224916,546.5509001454545,2.549987999999985,58.24095456457418,-3.2449191203266925,-13.085310568827708,32.14609839869309,-4797960.570872015,-2691471.629298457,12.0,28.000000000000004,-16.0,10.450012000000015,550.9666546666666,555.6833093333332,559.1416426666665,563.8582973333332,547.5083213333332,542.7916666666666,539.3333333333333,0.7308849872317832,509157864.0,+1
2015-09-22,557.5,567.974976,550.549988,552.325012,469.38821399999995,9626986.0,544.3574952000001,548.2786311272727,15.350036000000046,58.372057069146386,-3.337057369986401,-12.06092789362242,70.98490364810232,-11306487.781553103,-3083063.272584131,8.0,24.0,-15.999999999999996,11.77502400000003,556.949992,563.3499959999999,574.3749799999998,580.7749839999999,545.9250079999999,539.525004,528.50002,0.10186658378186728,518784850.0,+1
2015-09-23,553.724976,563.174988,548.724976,553.724976,473.11807300000004,4758254.0,546.7924928,549.9818094545454,24.34997599999997,60.3805808884911,-3.038541655578655,-11.25470898337312,54.56734290962273,-9742007.414088087,-3385742.5517444145,4.0,20.0,-16.0,7.5249639999999545,555.2083133333333,561.6916506666666,569.6583253333333,576.1416626666667,547.2416386666666,540.7583013333333,532.7916266666666,0.3460204738930317,523543104.0,+1
2015-09-24,556.75,576.349976,555.0,558.125,483.41754199999997,13399262.0,549.6649904000001,552.0422653090908,28.72497599999997,66.28065249144225,-3.817948447953828,-8.731671871812637,98.32346012425629,-1320966.9430349406,-3291889.114984594,0.0,16.0,-16.0,5.72497599999997,563.1583253333333,571.3166506666666,584.5083013333333,592.6666266666666,549.9666746666667,541.8083493333334,528.6166986666667,0.14637018795712017,536942366.0,+1
2015-09-28,569.974976,571.424988,550.5,570.275024,468.58288600000003,9788464.0,552.2574952,555.7895441454544,25.92504800000006,77.13138468387697,-1.2726411030551597,-3.919730333612506,91.51286017835669,4478423.542595821,-2938693.0850934987,0.0,12.0,-16.0,9.424987999999985,564.0666706666667,577.6333413333334,584.9916586666668,598.5583293333334,556.7083533333334,543.1416826666667,535.7833653333334,0.9450435049233981,546730830.0,+1
2015-09-29,551.0,566.700012,548.75,552.775024,475.491608,8699370.0,553.5125,555.8836402909092,12.55004800000006,50.255115680939305,-4.938714399348779,1.167663063630016,40.644461744238406,2734236.346318988,-2680832.656392181,0.0,8.0,-16.000000000000004,8.174987999999985,556.075012,563.400024,574.025024,581.350036,545.450012,538.125,527.5,0.2242351704277427,538031460.0,-1
2015-09-30,567.200012,584.474976,562.974976,560.924988,492.48788499999995,9495692.0,555.0674988000001,557.2313653818183,15.549987999999985,58.100469828213186,-4.850916970847121,3.3891652282947007,128.37227967432167,-3566854.8203154462,-2721106.391116077,88.0,4.0,-16.0,17.424987999999985,569.4583133333333,575.9416506666666,590.9583133333333,597.4416506666666,554.4416506666666,547.9583133333333,532.9416506666666,-0.09534827906976674,547527152.0,+1
2015-10-01,584.950012,598.875,580.0,580.974976,497.192474,10864394.0,558.1774964,561.9418157818181,31.09997599999997,71.05752128653043,-3.5809000250062577,7.366586092656689,239.62386497792448,-14240724.397054246,-3244725.3913873816,96.0,0.0,-16.0,14.450012000000015,586.6166586666667,593.2333173333334,605.4916586666668,612.1083173333334,574.3583173333334,567.7416586666667,555.4833173333334,0.05165435761589243,558391546.0,+1
2015-10-05,586.5,594.674988,581.0,586.525024,500.88003499999996,6881760.0,561.8700011999999,567.0959117090908,36.92504800000006,73.65921557382413,-2.4706128532132974,9.249085042149545,205.00417705116539,1646477.8065800106,-3022397.9732973925,96.0,36.0,-16.0,22.625,587.400004,593.8000079999999,601.0749919999998,607.4749959999999,580.12502,573.725016,566.450032,0.404024047406845,565273306.0,+1
2015-10-06,593.525024,596.275024,574.049988,590.875,489.37249800000006,8711880.0,565.875,572.3695478545455,40.049987999999985,75.63957251280672,-1.6004001000250063,10.62705723013346,170.28170505959775,29465597.373258844,-1545670.9120867248,92.0,32.0,-12.0,20.924987999999985,587.0666706666667,600.0833533333334,609.2917066666666,622.3083893333335,577.8583173333334,564.8416346666667,555.6332813333333,0.757029684901297,573985186.0,+1
2015-10-07,578.0,584.375,564.224976,577.299988,480.30227699999995,9182488.0,568.3825012,574.4468184,25.075012000000015,59.525097718760854,-4.316081420355092,11.229781491237532,86.56674025378119,-1235210.595248754,-1531559.0795031483,88.0,28.000000000000004,-8.0,21.52502400000003,575.299988,586.375,595.450012,606.525024,566.224976,555.149964,546.0749519999999,0.6488831973599632,564802698.0,-1
2015-10-08,568.200012,574.799988,563.025024,566.599976,479.857208,9080874.0,569.8099976,574.1227229090908,14.274963999999954,49.86363329317529,-6.4566189547386905,12.103995280732306,42.04972644221506,947371.5081967213,-1418880.4164256337,84.0,24.0,84.0,31.69995199999994,568.1416626666667,573.2583013333333,579.9166266666666,585.0332653333332,561.4833373333333,556.3666986666667,549.7083733333334,0.30360619361553487,555721824.0,-1
2015-10-09,568.0,586.450012,568.0,566.075012,494.79776,11782138.0,571.0450012,573.4436346181818,12.350036000000046,49.409641803606675,-6.5616380095023725,13.789993344377422,54.41833384382758,1858084.8103982378,-1269927.4515696904,80.0,20.0,96.0,37.950012000000015,573.5083413333333,579.0166826666666,591.9583533333334,597.4666946666666,560.5666706666666,555.0583293333333,542.1166586666666,-0.10433532509355459,543939686.0,-1
2015-10-12,599.5,609.900024,554.5,583.700012,475.936554,30404970.0,573.6025024,575.7445456727273,25.575012000000015,62.60059085656205,-5.128207236099095,15.556018807145279,80.76977390794228,-12656628.201308874,-1787504.7583770545,76.0,16.0,60.0,13.700012000000015,582.700012,610.900024,638.100036,666.3000480000001,555.5,527.299988,500.09997599999997,0.5270758005447795,574344656.0,+1
2015-10-13,553.724976,555.5,542.599976,561.450012,465.97625700000003,15326862.0,572.7200012000001,573.5350019636363,-8.825012000000015,45.36926116781431,-9.483266730087296,16.598661049523685,-40.862349962276646,-7565217.948097413,-2050128.085183028,96.0,12.0,60.0,22.225036000000046,553.1833293333333,563.7666826666666,566.0833533333334,576.6667066666666,550.8666586666666,540.2833053333333,537.9666346666666,1.4612403821884363,559017794.0,-1
2015-10-14,545.724976,557.775024,543.599976,549.700012,465.21331799999996,8865510.0,572.4124999999999,569.3495493818182,-3.075012000000015,38.85271482577837,-11.783129608934999,17.17507066867222,-51.563751815445904,-6645251.194923823,-2258997.3174443548,92.0,8.0,60.0,26.65002400000003,550.3583373333333,557.1166986666667,564.5333853333334,571.2917466666668,542.9416506666666,536.1832893333333,528.7666026666666,0.4303361794612632,550152284.0,-1
2015-10-15,549.950012,552.174988,544.549988,548.799988,465.107391,8255666.0,571.1999999999999,565.0563653818183,-12.125,38.365676904827204,-11.959294016396454,16.04691600407216,-58.3618800375915,-281108.58248492697,-2169093.284036951,88.0,4.0,60.0,14.274963999999954,548.5083213333334,552.4666546666667,556.1333213333335,560.0916546666667,544.8416546666667,540.8833213333334,537.2166546666667,0.5573770491803278,541896618.0,-1
2015-10-16,549.5,550.700012,545.0,548.674988,472.683929,6418992.0,567.9700012000001,560.9609086545454,-32.299987999999985,38.288760930112225,-11.983760642767173,16.522013418346432,-58.078111307476114,-385174.28283874283,-2088006.0567096248,84.0,0.0,60.0,19.850036000000046,548.125,551.25,553.825012,556.950012,545.549988,542.424988,539.849976,0.6447333795086704,535477626.0,-1
2015-10-19,551.0,558.0,550.25,547.450012,480.044647,7347494.0,564.0625000000001,557.2300015272727,-39.075012000000015,37.440019842555714,-12.223528883607962,15.414336639760677,-44.33386345597521,2511175.075381155,-1878952.3688869847,80.0,4.0,60.0,55.40002400000003,551.900004,553.5500079999999,559.6500040000001,561.3000079999999,545.8000079999999,544.150004,538.0500079999999,-0.36128877419354644,528130132.0,-1
2015-10-20,556.5,565.0,555.299988,555.974976,486.088562,8788310.0,560.5724976000001,555.7595426181819,-34.90002400000003,46.89299663157763,-10.554912011513245,11.627692519034326,-20.648143428107637,497900.09803454316,-1770913.6203903875,76.0,0.0,84.0,41.100036000000046,558.7583213333334,562.2166546666667,568.4583333333333,571.9166666666667,552.5166426666667,549.0583093333333,542.8166306666667,0.0695863056664243,536918442.0,+1
2015-10-21,562.5,573.424988,562.5,562.974976,491.46359299999995,7278098.0,559.1399964,556.1963568727273,-14.325012000000015,53.54373244251234,-9.184780934752913,7.901216587142244,4.289739883564776,4285689.953960996,-1495613.4579194717,72.0,4.0,84.0,17.850036000000046,566.299988,570.099976,577.224976,581.024964,559.174988,555.375,548.25,0.043476111827305465,544196540.0,+1
2015-10-23,570.900024,576.5,562.549988,569.200012,496.42825300000004,6033362.0,559.4000000000001,558.0254506181818,2.6000360000000455,58.83368338040589,-7.966335895102642,3.1494891080014895,14.558987393768328,4071666.3925930993,-1242555.2828958232,68.0,0.0,84.0,7.625,569.4166666666666,576.2833453333333,583.3666786666665,590.2333573333333,562.3333333333333,555.4666546666666,548.3833213333332,0.4767038193228811,550229902.0,+1
2015-10-26,577.0,579.25,571.575012,574.950012,497.399567,3195942.0,560.2875,560.8527255272727,8.875,63.2889895329635,-6.840871082049511,0.4407590441952607,39.01293216300913,3430602.562122335,-1030139.0172128996,64.0,68.0,84.0,5.700012000000015,575.2583413333333,578.9416706666666,582.9333293333332,586.6166586666666,571.2666826666666,567.5833533333333,563.5916946666666,0.43974010122230894,553425844.0,+1
2015-10-27,575.0,577.5,572.049988,576.075012,496.21237199999996,5263748.0,559.525,563.7231822545456,-7.625,64.16453985571962,-6.620671444713029,-0.610627000580962,41.08941804820264,-4547537.629314607,-1190020.772308633,60.0,64.0,76.0,9.325012000000015,575.2083333333334,578.3666786666668,580.6583453333335,583.8166906666668,572.9166666666667,569.7583213333334,567.4666546666667,0.7385348876296087,558689592.0,+1
2015-10-28,572.25,579.0,569.5,574.700012,497.85293600000006,5255472.0,560.85,566.4822753454546,13.25,62.07663351606341,-6.889804334790951,-1.6823605034010143,39.35872815068309,139370.0514195896,-1129593.9166845502,56.00000000000001,60.0,76.0,17.549987999999985,574.400004,579.3000079999999,583.9000040000001,588.8000079999999,569.8000079999999,564.900004,560.3000079999999,0.5473696842105279,553434120.0,-1
2015-10-29,576.549988,577.950012,568.025024,576.599976,494.33450300000004,5887324.0,563.5399964000001,569.3459073454545,26.899963999999954,63.94708682738755,-6.517918660344408,-5.196528366839402,35.300093566436345,842851.7300966313,-1039937.296376212,52.0,56.00000000000001,68.0,17.450012000000015,574.1916706666667,580.3583173333334,584.1166586666668,590.2833053333334,570.4333293333334,564.2666826666667,560.5083413333334,0.8639760572002658,559321444.0,+1
2015-10-30,572.5,572.5,565.0,572.525024,490.18991100000005,4044676.0,565.9125,570.9795487272727,23.725036000000046,56.990910007127894,-7.3155212848453495,-5.813931649269193,8.007865699819368,-3026172.0,-1130220.691995574,48.0,52.0,68.0,13.950012000000015,570.0083413333333,575.0166826666666,577.5083413333332,582.5166826666666,567.5166826666666,562.5083413333333,560.0166826666666,1.0033365333333373,555276768.0,-1
2015-11-02,565.0,567.900024,557.049988,567.724976,488.355133,3544988.0,567.8174988000001,571.3090898181819,19.049987999999985,49.650144448321576,-8.255049132665544,-4.871722862282468,-25.457453502326768,5285890.918329868,-838579.2551622945,44.0,48.0,-4.0,10.049987999999985,564.224996,571.4000040000001,575.075032,582.2500400000001,560.549968,553.37496,549.699932,0.9838665973089804,551731780.0,-1
2015-11-03,566.700012,575.224976,566.700012,565.599976,494.528687,3614682.0,569.6324952,570.9059038545455,18.149963999999954,46.58505180164922,-2.8422746486205166,-3.629256549346678,20.052700499234756,7105470.085674073,-477486.10330573574,40.0,44.0,-4.0,5.450012000000015,569.174988,571.649964,577.6999519999999,580.1749279999999,563.125,560.650024,554.600036,-0.12903702584551108,548117098.0,-1
2015-11-04,575.049988,578.799988,566.150024,572.75,490.772766,3205572.0,571.3099976,571.472722909091,16.77502400000003,56.912074795058835,-1.353461738677772,-1.74551559961958,58.932856591918096,2574624.1623959867,-338753.8185009799,36.0,40.0,-3.999999999999993,9.5,572.5666706666667,578.9833173333334,585.2166346666668,591.6332813333333,566.3333533333334,559.9167066666668,553.6833893333335,0.521738717991608,551322670.0,+1
2015-11-05,571.474976,572.5,559.700012,568.400024,484.77197300000006,2345306.0,571.8525024,570.9436367999999,5.425048000000061,50.11106730358696,-2.2592349817803163,1.1856468696208822,11.93551478133622,10263327.662700329,143158.9760995175,32.0,36.0,-4.000000000000007,9.924987999999985,566.8666786666666,574.0333453333333,579.6666666666667,586.8333333333333,561.2333573333333,554.0666906666667,548.4333693333333,0.6796890747085095,548977364.0,-1
2015-11-06,561.5,571.950012,561.450012,561.450012,491.42037999999997,3026172.0,571.0775024000001,569.0522749090909,-7.75,41.064531482445794,-3.706400416449763,1.8825514893335367,-6.067908648045585,5928598.660870902,406133.50722571765,28.000000000000004,32.0,-4.0,11.59997599999997,564.950012,568.450012,575.450012,578.950012,557.950012,554.450012,547.450012,0.0,545951192.0,-1
2015-11-09,560.0,570.0,557.599976,569.150024,489.823029,6125676.0,570.4975036000001,568.701824290909,-5.799987999999985,52.11543847279362,-2.1030663196251886,2.3998647204024337,7.03922184547747,19892066.74880086,1291857.7454798666,24.0,28.000000000000004,-4.0,15.475036000000046,565.5833333333334,573.5666906666668,577.9833573333335,585.9667146666668,561.1666666666667,553.1833093333333,548.7666426666667,0.9314536810573941,552076868.0,+1
2015-11-10,563.75,563.75,550.049988,567.299988,476.547791,4680052.0,569.6200012,568.1204578181819,-8.77502400000003,49.540210308290476,-2.488289849036963,3.319204034653467,-61.67234749172118,-10841072.164243685,740360.9314010874,20.0,24.0,-4.0,8.524963999999954,560.3666586666667,570.6833293333334,574.0666706666668,584.3833413333334,556.9833173333334,546.6666466666667,543.2833053333334,1.2591229847097931,547396816.0,-1
2015-11-13,549.974976,553.0,545.0,551.924988,475.23104900000004,3520868.0,567.3424988,564.903182690909,-22.77502400000003,33.613006719267474,-5.689747423217078,3.412391642868897,-245.9934396945922,-2775433.5780489403,580552.0900623292,16.0,20.0,-4.0,13.200012000000015,549.974996,554.9499920000001,557.9749959999999,562.9499920000001,546.9499920000001,541.974996,538.9499920000001,0.8656234999999981,543875948.0,-1
2015-11-16,541.825012,547.0,533.599976,550.400024,466.337738,6808334.0,564.7225036000001,561.8227327272728,-26.19995199999994,32.42014788638292,-6.007282873503377,3.5061387956531007,-283.7274145169537,1012788.9543223458,600199.2202559805,12.0,16.0,-4.0,13.049987999999985,543.6666666666666,553.7333573333333,557.0666906666665,567.1333813333333,540.3333333333333,530.2666426666666,526.9333093333332,1.2537326798817692,537067614.0,-1
2015-11-17,540.0,541.450012,526.0,540.099976,458.264679,7184106.0,561.4799988000001,557.3459095272727,-32.42504800000006,25.396241677730146,-8.152009161894853,2.5805427377151773,-309.82912290893154,6143826.187018396,852182.2641998999,8.0,96.0,-3.9999999999999964,10.5,535.849996,545.6999920000001,551.3000080000002,561.1500040000001,530.24998,520.399984,514.799968,0.9126190969948733,529883508.0,-1
2015-11-18,520.5,522.575012,505.625,530.75,440.348572,10125252.0,557.7825012000001,551.7586370181818,-36.97497599999997,20.69909410013406,-10.052083333333334,0.3051836754920032,-390.59547102332044,-8739401.927572908,416201.16457357723,4.0,96.0,-4.0000000000000036,12.40002400000003,519.650004,533.6750079999999,536.6000159999999,550.62502,516.7249959999999,502.69999199999995,499.7749839999999,1.4822998355399382,519758256.0,-1
2015-11-19,515.125,526.0,511.89999400000005,510.0,452.35022000000004,8539622.0,552.2225036,543.0709095272728,-55.59997599999997,14.04652741232536,-14.374999999999998,-2.221905338747092,-304.6724739266216,-2098121.1504422277,301913.78661824187,0.0,96.0,-4.0,19.100036000000046,515.9666646666667,520.0333353333333,530.0666706666666,534.1333413333333,505.9333293333334,501.86665866666675,491.83332333333345,-0.1347512901767599,511218634.0,-1
2015-11-20,524.0,531.599976,521.025024,523.900024,454.33609,6082978.0,547.337506,537.9213677818182,-48.84997599999997,31.15009155757525,-11.442260394554232,-2.9055764121037555,-177.24923733461787,-9375311.40702463,-137960.08582033328,32.0,92.0,-4.0,22.299987999999985,525.5083413333333,529.9916586666666,536.0832933333331,540.5666106666665,519.4167066666666,514.9333893333334,508.8417546666667,0.2718688463077673,517301612.0,+1
2015-11-23,525.0,531.200012,519.0,526.200012,454.897308,5616350.0,543.1175048000001,534.0781870545454,-42.200012000000015,33.67003553023282,-10.962896480939465,-4.817017742439248,-143.59393841248348,2099958.4110111953,-36236.5177824785,28.000000000000004,88.0,-4.0,18.325012000000015,525.4666746666667,531.9333493333334,537.6666866666667,544.1333613333334,519.7333373333333,513.2666626666667,507.5333253333333,0.590164337543275,522917962.0,+1
2015-11-24,525.0,525.400024,518.5,526.849976,449.47934000000004,4325802.0,539.6575012000001,531.1204545454545,-34.600036000000046,34.45230535684088,-10.827430866880308,-8.707960269497903,-123.42232535205761,5817430.602493444,229839.2604120265,24.0,84.0,-88.0,24.40002400000003,523.5833333333334,528.6666666666667,530.4833573333335,535.5666906666668,521.7666426666667,516.6833093333333,514.8666186666667,1.2101372401023436,527243764.0,+1
2015-11-26,520.474976,529.75,520.025024,520.575012,454.33609,9853968.0,534.8000000000001,527.6509110545455,-48.575012000000015,30.45167974627941,-12.135259995046097,-12.573597746346536,-101.46120219713264,2638706.310641693,339333.2172407046,20.0,80.0,-92.0,34.47497599999997,523.450012,526.875,533.174988,536.599976,517.150024,513.725036,507.42504800000006,0.05655417555786117,517389796.0,-1
2015-11-27,529.0,535.0,522.5,526.200012,460.35849,5142478.0,530.6900024,526.0872768727273,-41.09997599999997,37.90922501828169,-10.962896480939465,-15.687524102060706,-69.49117110631254,3546084.467255861,485094.6376960113,16.0,76.0,-96.0,18.85000599999995,527.900004,533.3000079999999,540.4000040000001,545.8000079999999,520.8000079999999,515.400004,508.30000799999993,0.2960009600000012,522532274.0,+1
2015-11-30,535.0,549.150024,528.099976,533.174988,469.661926,18105534.0,528.8150023999999,526.5390924363636,-18.75,46.16803680852025,-8.305176768743404,-20.105545040271295,-31.76876288217443,-213792.087814708,453327.05926369084,12.0,72.0,-60.0,21.59997599999997,536.8083293333333,545.5166826666666,557.8583773333335,566.5667306666667,524.4666346666666,515.7582813333332,503.4165866666665,0.24109265689085368,540637808.0,+1
2015-12-01,544.0,547.5,536.474976,543.950012,465.819641,5898550.0,528.1700012,529.2909123636364,-6.450012000000015,56.48501979253239,-5.920287406610743,-23.85721973018849,-7.940259971277996,-2331263.9347772007,326754.74135268404,8.0,68.0,-60.0,12.200012000000015,542.6416626666667,548.8083493333334,553.6666866666667,559.8333733333334,537.7833253333333,531.6166386666666,526.7583013333333,0.678006324521382,546536358.0,+1
2015-12-02,539.974976,539.974976,529.5,539.5,457.919312,6397616.0,528.1100036,531.3509121454546,-0.5999759999999696,51.75806578363725,-6.475583864118896,-25.446355774379867,-22.110491237720083,5393165.275630448,557046.1292745,4.0,64.0,-60.0,7.700012000000015,536.324992,543.1499839999999,546.7999679999998,553.6249599999999,532.6750079999999,525.850016,522.200032,0.9546561252264472,540138742.0,-1
2015-12-03,530.5,532.400024,524.525024,530.349976,456.645721,5504726.0,528.0700012,531.7581798545455,-0.40002400000003036,43.18411356835985,-7.186664658418511,-26.852131744349663,-38.08609699796638,-6689609.163445128,227652.7068780176,0.0,60.0,-60.0,9.72497599999997,529.0916746666667,533.6583253333333,536.9666746666667,541.5333253333333,525.7833253333333,521.2166746666667,517.9083253333333,0.7396764444444367,534634016.0,-1
2015-12-04,524.5,532.450012,520.049988,528.875,452.889862,8375530.0,529.9575012,531.9045432727272,18.875,41.8933152881995,-5.313876651982379,-26.66541763490045,-36.60849108917262,-4413256.953688041,16702.26776129566,4.0,56.00000000000001,-60.0,14.424987999999985,527.125,534.200012,539.525024,546.600036,521.799988,514.724976,509.39996399999995,0.7116931386584407,526258486.0,-1
2015-12-07,527.650024,529.5,520.0,524.525024,451.68106100000006,4513870.0,530.0200012,530.9168201454546,0.625,38.025553431534895,-5.470398464312866,-25.26156747370601,-36.919163484278926,-2993627.069598471,-120130.88393692685,0.0,52.0,-60.0,22.950012000000015,524.675008,529.3500160000001,534.1750080000002,538.8500160000001,519.8500160000001,515.175008,510.3500160000001,0.47631831578947686,521744616.0,-1
2015-12-08,522.525024,531.375,519.650024,523.125,450.88235499999996,5724372.0,529.7125000000001,529.6631835636364,-3.075012000000015,36.76504256048377,-5.78141122125099,-20.985825405426,-31.32977951304379,294329.04572902236,-101291.7962248315,16.0,48.0,-60.0,14.325012000000015,524.7166746666667,529.7833253333333,536.4416506666666,541.5083013333333,518.0583493333334,512.9916986666667,506.3333733333334,0.29637382626625236,516020244.0,-1
2015-12-09,521.5,523.474976,511.27499400000005,522.200012,443.888611,6818254.0,529.2475036,528.2972766545455,-4.6499639999999545,35.85885927673772,-5.986895604386331,-18.313087711424146,-43.966302313386564,-9900051.335608758,-546689.9571060712,12.0,44.0,-60.0,14.450012000000015,518.9833273333334,526.6916606666666,531.1833093333332,538.8916426666666,514.4916786666668,506.78334533333344,502.29169666666684,0.8954945999100685,509201990.0,-1
2015-12-10,518.299988,525.799988,515.150024,514.099976,452.15591399999994,5587746.0,528.6,525.5431807272727,-6.4750360000000455,28.708996021306163,-7.786303705717465,-16.308286464864295,-42.515149378507935,-1387567.8733859905,-584911.6805733526,8.0,40.0,-60.0,14.97497599999997,518.349996,521.549968,528.9999600000001,532.199932,510.9000040000001,507.7000320000001,500.2500400000001,-0.09859638962160484,503614244.0,-1
2015-12-11,527.0,530.950012,522.950012,523.674988,454.508789,5390198.0,528.3474976,524.6477239999999,-2.5250240000000304,43.95175462296134,-5.659232398485898,-14.388773807510574,-11.585314902990454,9450542.934665035,-128754.65260782941,4.0,36.0,-52.00000000000001,12.40002400000003,525.8583373333333,528.7666626666667,533.8583373333333,536.7666626666667,520.7666626666667,517.8583373333333,512.7666626666667,0.0906219999999962,509004442.0,+1
2015-12-14,524.75,536.575012,524.025024,526.400024,461.71841399999994,4816672.0,527.6700012,524.293637890909,-6.7749639999999545,47.62882532089037,-5.053870662461633,-11.555449445753538,5.755552360077765,-736628.9440253696,-156385.30221772578,0.0,32.0,-52.0,9.5,529.0000200000001,533.9750160000001,541.5500080000002,546.5250040000001,521.4250280000001,516.4500320000001,508.8750400000001,0.1892432088381282,513821114.0,+1
2015-12-15,536.625,539.549988,529.400024,534.75,465.193695,5431808.0,526.7500000000001,525.5809104,-9.200012000000015,57.489323640317096,-3.1989388497733433,-8.68963878058662,38.524608211853895,6951393.262901579,166695.5416514251,0.0,28.000000000000004,-32.0,11.72497599999997,534.5666706666667,539.7333173333334,544.7166346666668,549.8832813333333,529.5833533333334,524.4167066666668,519.4333893333335,0.5270931010198651,519252922.0,+1
2015-12-16,541.700012,549.0,541.700012,538.775024,473.09405499999997,5495852.0,526.6775024000001,527.7672784,-0.7249759999999696,61.519116614862796,-2.304787170243492,-6.83772118458387,94.11299283335406,-4097365.4937273865,-27125.414502209678,0.0,24.0,-32.0,12.19998199999992,543.1583453333334,544.6166786666668,550.4583333333333,551.9166666666667,537.3166906666668,535.8583573333334,530.0167026666668,-0.40068394632977355,524748774.0,+1
2015-12-17,550.0,554.900024,544.0,547.924988,477.95083600000004,4958782.0,528.4350036000001,531.6304576,17.575012000000015,69.18194026642992,-1.5299485924133325,-6.657460765096857,130.5421962760147,612887.131051373,1966.0648411425007,0.0,20.0,-32.0,10.649963999999954,548.9416706666667,553.8833413333334,559.8416946666666,564.7833653333334,542.9833173333334,538.0416466666667,532.0832933333334,0.36008984934344856,529707556.0,+1
2015-12-18,551.700012,551.700012,539.724976,553.549988,467.61129800000003,7219820.0,530.9025024000001,536.1968184,24.674987999999985,72.9962728435308,-0.29612545052203054,-5.261584351995225,116.60203744166792,-2017350.7446848168,-89821.06286460554,0.0,16.0,-32.0,16.850036000000046,548.324992,556.9250079999999,560.3000280000001,568.900044,544.9499719999999,536.3499559999999,532.9749359999998,1.1544860491442333,536927376.0,+1
2015-12-21,538.5,553.700012,532.974976,541.575012,476.375061,4331012.0,532.6075012,538.1372746909092,17.049987999999985,55.97754347860434,-2.9227925638363237,-2.940719621156518,70.1630450752352,579449.1063449556,-59399.691536891056,92.0,12.0,-32.0,12.90002400000003,542.75,552.525024,563.475036,573.2500600000001,531.799988,522.024964,511.07495199999994,0.4149587966940094,532596364.0,-1
2015-12-22,548.724976,548.724976,540.049988,551.724976,467.87036100000006,4109254.0,535.4674988,541.6131792,28.59997599999997,64.15154396069386,-0.6964351464916924,-1.0009701788477514,84.23581437669036,4324082.147971662,139849.48298626972,88.0,8.0,-28.000000000000004,13.149963999999954,546.8333133333333,553.6166386666666,555.5083013333333,562.2916266666666,544.9416506666666,538.1583253333333,536.2666626666667,1.3458218040186345,536705618.0,+1
2015-12-23,547.525024,551.25,543.525024,541.875,475.25259400000004,2870928.0,537.4349976,542.7781794181818,19.674987999999985,53.10946413451628,-2.8569912950914933,1.351849934237066,67.10635685915517,-8428503.308979778,-249621.09846681592,84.0,4.0,-24.0,14.25,545.550008,547.5749920000001,553.2749840000001,555.299968,539.8500160000001,537.8250320000001,532.1250400000001,-0.21359600340506388,533834690.0,-1
2015-12-24,551.025024,552.224976,545.049988,550.424988,473.30990599999996,1230054.0,541.0674988,545.1399958545454,36.325012000000015,60.0044540903445,-0.9815827515727538,3.647125723077579,81.16015629142905,992185.2471873225,-193175.3554825254,80.0,0.0,-20.0,16.125,549.2333173333333,553.4166466666666,556.4083053333331,560.5916346666666,546.2416586666666,542.0583293333333,539.0666706666666,0.7491301727612661,535064744.0,+1
2015-12-28,545.0,555.0,545.0,548.174988,476.93630999999993,5526952.0,543.5174988,546.4322666181819,24.5,57.439814227816,-1.4967131578947401,5.63588534434632,75.16063144390017,4818638.128381095,34634.34832950178,76.0,52.0,-16.0,11.975036000000046,549.3916626666667,553.7833253333333,559.3916626666667,563.7833253333333,543.7833253333333,539.3916626666667,533.7833253333333,0.31749879999999847,529537792.0,-1
2015-12-29,550.625,555.0,548.650024,552.375,476.914734,3345062.0,546.1149964,548.0427213818182,25.97497599999997,61.02752032301002,-0.575657894736842,7.793186682689452,85.32161101882926,2139595.1350420774,130314.38408918212,96.0,48.0,80.0,20.725036000000046,552.0083413333333,555.3666586666666,558.3583173333332,561.7166346666666,549.0166826666666,545.6583653333333,542.6667066666666,0.5866126108193145,532882854.0,+1
2015-12-30,550.549988,553.299988,541.5,552.349976,468.97122199999995,5153970.0,547.8749940000001,549.1763540363636,17.59997599999997,60.99217421782572,-0.5811456140350943,9.757215290288741,64.99533698412537,5162567.659666307,359053.16934272845,92.0,44.0,80.0,8.674987999999985,549.049988,556.599976,560.849976,568.399964,544.799988,537.25,533.0,0.9194904266004325,527728884.0,-1
2015-12-31,545.075012,554.974976,543.5,543.150024,477.216949,7943938.0,548.312494,548.3172685818181,4.375,48.96244892921776,-2.5986789473684144,11.478282370342413,52.53976097582481,6061705.348377568,618264.6320261742,88.0,40.0,80.0,8.19995199999994,547.2083333333334,550.9166666666667,558.6833093333335,562.3916426666667,539.4416906666668,535.7333573333334,527.9667146666668,-0.030499061610235224,519784946.0,-1
2016-01-01,550.0,554.474976,546.599976,552.700012,477.152191,1806550.0,548.7899964000001,549.1149991272728,4.77502400000003,58.715378230795444,-0.5043833333333301,12.490409815699877,69.98273462602333,-5650225.87487618,333333.2453487484,84.0,36.0,80.0,10.34997599999997,551.2583213333334,555.9166666666667,559.1333213333332,563.7916666666667,548.0416666666667,543.3833213333334,540.1666666666667,0.7746077460317519,521591496.0,+1
2016-01-11,528.150024,534.974976,526.049988,531.650024,455.760742,5360622.0,542.1400083999999,537.7968304,-16.524963999999954,40.37331882209063,-5.120608771929818,9.168254069408704,-69.652150833121,-3176546.708303608,-1312794.1748467628,60.0,12.0,48.0,14.674987999999985,530.8916626666667,535.7333373333333,539.8166506666666,544.6583253333333,526.8083493333334,521.9666746666667,517.8833613333334,0.6274558576437363,503987838.0,+1
2016-07-05,592.5,593.75,585.525024,591.974976,519.414978,3596416.0,592.0549988,589.0859086545455,-12.40002400000003,48.50379827161923,-3.0387987145903255,-13.762531256429384,-17.04380980347428,-4583935.509799508,-5641.926168369303,12.0,80.0,-60.0,19.725036000000046,590.4166666666666,595.3083093333332,598.6416426666665,603.5332853333332,587.0833333333333,582.1916906666667,578.8583573333333,0.784190981225959,552766700.0,+1
2016-07-11,583.700012,589.349976,580.0,579.099976,519.2382809999999,6668882.0,585.7399964,584.4427191999999,-26.700012000000015,35.40412162122129,-5.571129009890446,-11.756234642203822,-40.76902763931644,2432989.888253878,2509182.115033803,0.0,96.0,-68.0,4.950012000000015,582.8166506666666,585.6333013333333,592.1666266666666,594.9832773333333,576.2833253333333,573.4666746666667,566.9333493333334,-0.09625949842010646,547929058.0,+1
2016-07-12,590.0,590.174988,584.0,587.525024,519.9011230000001,6197368.0,584.7649964000001,584.7672696727273,-9.75,48.25208959914362,-3.914041298064594,-11.09907043711678,-16.944949139880254,-130922.94290681218,2389177.339672866,0.0,92.0,-68.0,11.899963999999954,587.2333373333333,590.4666746666667,593.4083253333333,596.6416626666667,584.2916866666667,581.0583493333334,578.1166986666667,0.570855198423064,554126426.0,+1
2016-07-13,590.0,597.900024,587.599976,588.275024,527.523621,5275420.0,585.2825012,585.405456509091,5.175048000000061,49.288128498713945,-3.766526911930606,-11.173991868264125,5.553588126703991,6910512.532672238,2594692.575718292,0.0,88.0,-68.0,8.22497599999997,591.2583413333333,594.9167066666666,601.5583893333333,605.2167546666667,584.6166586666666,580.9582933333332,574.3166106666665,0.06553833535533589,559401846.0,+1
2016-07-14,597.5,598.025024,582.0,596.900024,519.768555,7413328.0,587.0150024000001,587.5177333818182,17.325012000000015,59.93252350088909,-2.070111471389749,-9.945141912751524,12.120676864992628,2540644.4661651314,2592235.8434658754,0.0,84.0,-68.0,14.47497599999997,592.3083493333334,602.6166986666667,608.3333733333334,618.6417226666667,586.5916746666667,576.2833253333333,570.5666506666666,0.9297972970274492,566815174.0,+1
2016-07-19,544.299988,545.0,537.049988,540.974976,480.30810499999995,10404644.0,577.5500000000001,571.0272770909091,-45.225036000000046,24.98442110040726,-11.432302040227958,-7.190236421753525,-222.0646586469055,533225.7700195687,2643065.357365319,32.0,92.0,-92.0,11.075012000000015,541.0083213333334,544.9666546666667,548.9583333333333,552.9166666666667,537.0166426666667,533.0583093333333,529.0666306666667,0.49370843716965174,501402868.0,+1
2016-07-20,535.0,544.950012,535.0,543.474976,478.60678099999996,9822896.0,572.7,564.8318181818182,-48.5,27.504669585179528,-10.931325159357149,-8.451769964980144,-184.77280571913377,972911.0594790842,2567149.252915945,28.000000000000004,88.0,-88.0,10.375,541.1416626666667,547.2833253333333,551.0916746666667,557.2333373333333,537.3333133333333,531.1916506666666,527.3833013333333,0.8517553546669046,511225764.0,+1
2016-07-25,531.5,541.625,531.5,536.224976,477.612549,8469552.0,559.9275024,548.964085890909,-42.875,24.225188288563956,-12.384158113882492,-15.131777616960449,-121.95635106880832,-3965211.641025641,2808839.220071057,16.0,76.0,-60.0,60.549987999999985,536.449992,541.3999839999999,546.5749919999998,551.5249839999999,531.2749839999999,526.324992,521.1499839999999,0.4666642962962933,484701672.0,-1
2016-07-26,535.174988,544.950012,535.174988,540.424988,481.08135999999996,7189610.0,555.2174987999999,545.4181741818181,-47.100036000000046,30.361458072523646,-11.542514549330503,-16.362495804065475,-90.48631147758115,7163627.100000001,3006784.123704191,12.0,72.0,-60.0,8.72497599999997,540.1833293333333,545.1916706666666,549.9583533333332,554.9666946666666,535.4166466666666,530.4083053333333,525.6416226666665,0.5370830803075249,491891282.0,+1
2016-07-27,542.349976,548.25,539.275024,544.349976,479.60107400000004,7431820.0,550.824994,543.4422609454544,-43.92504800000006,35.95397691253794,-10.755983251052367,-17.966048794707376,-66.99163629100241,4809008.955463616,3088703.43423871,8.0,68.0,-60.0,9.950012000000015,543.9583333333334,548.6416426666667,552.9333093333335,557.6166186666667,539.6666666666667,534.9833573333334,530.6916906666668,0.5654557739207277,499323102.0,+1
2016-07-28,542.700012,543.474976,537.025024,542.674988,476.13229400000006,11258562.0,545.4024903999999,541.9604416727273,-54.225036000000046,34.586301065382784,-11.091635356546778,-20.12108624752318,-66.26440824991799,3231394.5494835107,3095189.394022565,4.0,64.0,-60.0,5.799987999999985,541.0583293333333,545.0916346666666,547.5082813333333,551.5415866666665,538.6416826666666,534.6083773333334,532.1917306666667,0.8759699296987028,488064540.0,-1
2016-07-29,536.299988,538.375,533.25,538.75,474.51934800000004,8156784.0,540.4649903999999,540.7508979636364,-49.375,31.36079511474442,-11.878166654824915,-22.900219594030432,-68.33342775022368,4233619.795475351,3146936.230452237,0.0,60.0,-60.0,8.200012000000015,536.7916666666666,540.3333333333333,541.9166666666665,545.4583333333333,535.2083333333333,531.6666666666666,530.0833333333333,1.0731707317073171,479907756.0,-1
2016-08-01,535.75,543.924988,534.174988,536.924988,479.55688499999997,9096662.0,540.5299867999998,540.1072611636363,0.6499639999999545,29.86644435077696,-12.243882182549635,-27.567197094030803,-54.89590075917905,-1900024.2421808143,2917528.9362416435,0.0,56.00000000000001,-60.0,10.125,538.3416546666666,542.5083213333332,548.0916546666665,552.2583213333332,532.7583213333332,528.5916546666666,523.0083213333332,0.28205128205128205,470811094.0,-1
2016-08-02,539.950012,542.5,537.5,542.625,478.916138,6822502.0,540.6949892,540.4881726545455,1.6500240000000304,40.14483398199947,-11.101652489475162,-31.019848352691497,-40.156872410565164,774541.4695580867,2820120.4150287546,48.0,52.0,-60.0,9.77502400000003,540.875,544.25,545.875,549.25,539.25,535.875,534.25,1.025,477633596.0,+1
2016-08-03,542.825012,543.25,535.150024,541.900024,479.402222,7213460.0,540.537494,540.7072698909091,-1.5749519999999393,39.29958825087649,-11.246930975549635,-28.074622703700015,-34.55992812028561,1624658.608603822,2765781.2420094395,44.0,48.0,-60.0,8.97497599999997,540.100016,545.0500079999999,548.1999919999998,553.1499839999999,536.950032,532.00004,528.850056,0.8333358024764549,470420136.0,-1
2016-08-04,543.200012,543.450012,535.025024,542.450012,473.61358600000005,4237278.0,540.6274964,541.0550004363637,0.9000240000000304,40.3980657485187,-10.585744274566123,-26.5280570526279,-28.161544686567957,-1415909.1367339902,2575704.4066120107,40.0,44.0,-60.0,7.324951999999939,540.3083493333334,545.5916746666667,548.7333373333333,554.0166626666667,537.1666866666667,531.8833613333334,528.7416986666667,0.8813054689217359,474657414.0,+1
2016-08-05,536.0,536.724976,530.0,535.900024,471.93435700000003,5609968.0,540.2224976,540.19546,-4.049987999999985,32.35270796128958,-2.749020812465213,-25.664914913501775,-37.380935396015836,6300682.849687975,2745021.608570009,36.0,40.0,-60.0,9.424987999999985,534.2083333333334,538.4166666666667,540.9333093333335,545.1416426666667,531.6916906666668,527.4833573333334,524.9667146666668,0.8773301198398413,469047446.0,-1
2016-08-08,534.5,540.5,531.275024,534.0,476.66250599999995,4643064.0,540.0,539.0640968,-2.2249759999999696,30.330914512514198,-3.1719532554257093,-24.014017898603015,-32.293957035302675,21350021.504510865,3590703.422021867,32.0,36.0,-56.00000000000001,9.75,535.2583413333333,539.2416586666666,544.4833173333332,548.4666346666666,530.0166826666666,526.0333653333333,520.7917066666666,0.2953911208007456,464404382.0,-1
2016-08-09,538.5,542.25,535.75,539.349976,478.739471,7192664.0,539.8924988,538.9459106181818,-1.0750120000000152,42.08880313403171,-1.9810849193099678,-22.14520615517904,-18.123801234368617,6092837.071000574,3704436.769702717,28.000000000000004,32.0,-4.0,5.575012000000015,539.1166586666667,542.4833173333334,545.6166586666668,548.9833173333334,535.9833173333334,532.6166586666667,529.4833173333334,0.5538424615384568,471597046.0,+1
2016-08-10,538.0,543.950012,537.599976,541.700012,478.275452,5576454.0,539.6275024,539.2745493818182,-2.6499639999999545,46.6520847646067,-1.457982860322757,-19.557105234419055,-6.6393675256136335,2875288.6981210294,3666748.2209944585,24.0,28.000000000000004,-4.0,8.09997599999997,541.0833333333334,544.5666906666668,547.4333693333333,550.9167266666668,538.2166546666667,534.7332973333333,531.8666186666667,0.6456713001312144,477173500.0,+1
2016-08-11,540.849976,547.5,537.625,541.174988,476.06600999999995,5038552.0,539.4775024,539.5559104,-1.5,45.72332145360199,-1.5748496382860355,-17.081338934050223,4.398439691802205,-2946759.1758896797,3366134.2484088154,20.0,24.0,-4.0,8.424987999999985,542.099996,546.5749920000001,551.9749959999999,556.4499920000001,536.6999920000001,532.224996,526.8249920000001,0.359492455696201,472134948.0,-1
2016-08-12,537.525024,539.400024,530.0,538.674988,469.52609299999995,7449928.0,539.4700012000001,539.4099986909091,-0.07501200000001518,41.215157352935954,-2.1313326655537037,-15.397831213833001,-11.886337031926024,1717094.344006604,3291177.8891178058,16.0,20.0,-4.0,12.450012000000015,536.025004,542.0500079999999,545.4250280000001,551.450032,532.6499839999999,526.6249799999999,523.2499599999999,0.9228687075692527,464685020.0,-1
2016-08-16,521.0,529.025024,514.0,531.275024,464.77581799999996,16429408.0,538.9050048,537.9200028363637,-5.6499639999999545,30.8325059250091,-3.7785144129103996,-14.206011669701184,-61.327013592515925,-10551182.50579894,2661979.6893488625,12.0,16.0,-4.0,9.22497599999997,524.7666826666667,535.5333653333334,539.7917066666669,550.5583893333335,520.5083413333334,509.7416586666667,505.4833173333334,1.149750176771764,448255612.0,-1
2016-08-17,524.974976,526.325012,515.25,525.900024,456.60095199999995,6599316.0,537.2325072000001,535.5554608727273,-16.72497599999997,25.45765445449497,-4.974952921535887,-12.556455543984953,-72.51379878633601,-12117336.004509704,1990192.6123552907,8.0,96.0,-3.9999999999999964,8.25,522.4916786666666,529.7333573333333,533.5666906666665,540.8083693333333,518.6583453333333,511.41666666666663,507.58333333333326,0.9616264072670997,441656296.0,-1
2016-08-18,518.25,519.549988,510.75,516.650024,452.22625700000003,8434000.0,534.7075072000001,531.8131912000001,-25.25,18.911404335203287,-6.878478483834999,-10.317420100968775,-103.3933050116746,4721339.869409905,2114335.6694941367,4.0,92.0,-4.0000000000000036,6.3500360000000455,515.650004,520.5500079999999,524.4499919999998,529.3499959999999,511.75001999999995,506.850016,502.95003199999996,0.6704581869884414,433222296.0,-1
2016-08-19,515.0,519.5,509.22500599999995,511.700012,451.29821799999996,5686016.0,531.6325072000001,527.6300102545455,-30.75,16.320146201898567,-7.982160089186173,-8.929702868795403,-109.27449078735592,2198623.0044823457,2118166.911993601,0.0,96.0,-4.0,9.875,513.475006,517.7250060000001,523.7500000000002,528.0000000000001,507.450012,503.20001199999996,497.17501799999997,0.2408766370082603,427536280.0,-1
2016-08-22,509.0,515.0,504.549988,510.64999400000005,448.71322599999996,10253518.0,529.1075042,523.8150078545455,-25.25002999999998,15.790576319331024,-8.216277814938673,-6.971152671132927,-122.30175588847185,-137375.84210526315,2015642.2413527432,0.0,96.0,-4.0,11.174987999999985,510.0666606666667,515.5833333333334,520.5166726666666,526.0333453333334,505.13332133333336,499.61664866666666,494.68330933333334,0.5837319612647388,417282762.0,-1
2016-08-23,510.049988,521.0,510.049988,507.72500599999995,459.40689100000003,7406138.0,526.4800048,519.9272809090909,-26.27499400000005,14.299203164970692,-8.86844905239689,-5.755208364900909,-100.30832179716474,-5338039.610525557,1681383.9753582748,28.000000000000004,96.0,-4.0,24.674987999999985,512.924998,515.8000079999999,523.87501,526.75002,504.8499959999999,501.97498599999994,493.8999839999999,-0.21232689060067064,409876624.0,-1
2016-08-24,523.5,531.025024,523.5,519.825012,467.25036600000004,6129966.0,524.5275084,518.7172822181818,-19.524963999999954,40.9291780942948,-6.170565886287622,-6.648381883289858,-34.84918975279709,4499379.803355479,1809474.6948126932,24.0,92.0,-88.0,16.02502400000003,524.7833453333334,526.0666906666668,532.3083693333333,533.5917146666668,518.5416666666667,517.2583213333334,511.0166426666667,-0.4883689407502182,416006590.0,+1
2016-08-25,527.5,528.799988,516.049988,528.700012,457.860321,4796562.0,523.2275084,519.4759192363637,-13.0,53.228874712325364,-4.191747603121513,-6.847277873910116,-32.705606736978005,-255429.79415741243,1715615.3998595064,20.0,88.0,-88.0,15.15002400000003,524.5166626666667,532.9833373333333,537.2666626666667,545.7333373333333,520.2333373333333,511.76666266666666,507.48333733333334,0.9921587450980416,420803152.0,+1
2016-08-26,518.0,523.0,508.52499400000005,518.075012,450.83432,6881054.0,520.9175108000001,518.5391017090909,-23.09997599999997,41.33873299169697,-6.560755406911925,-7.973457389668624,-71.03099690070641,2149307.64684648,1735328.68381346,16.0,84.0,-96.0,10.27499400000005,516.5333353333334,524.5416766666667,531.0083413333334,539.0166826666667,510.0666706666668,502.05832933333346,495.5916646666669,0.6597591738476654,413922098.0,-1
2016-08-29,508.799988,515.0,505.5,510.125,451.96109,5220282.0,518.062512,516.5768270181818,-28.549987999999985,34.65534434306868,-8.333333333333332,-9.917959272556573,-100.498809331549,-12847570.890128495,1072469.6122706432,12.0,80.0,-96.0,10.450012000000015,510.2083333333333,514.9166666666666,519.7083333333333,524.4166666666666,505.41666666666663,500.7083333333333,495.91666666666663,0.4868421052631579,408701816.0,-1
2016-08-30,516.224976,522.5,512.5,511.39999400000005,459.738312,4375438.0,516.075009,515.3654601090909,-19.87502999999998,36.55351555116983,-8.049053734671114,-12.092837491139562,-62.74721211602254,-6435407.333333334,731202.4783795531,8.0,76.0,-68.0,10.950012000000015,515.4666646666667,518.4333293333334,525.4666646666667,528.4333293333334,508.4333293333334,505.4666646666667,498.4333293333334,-0.11000059999999508,413077254.0,+1
2016-08-31,518.549988,522.875,513.900024,520.200012,457.727692,11139814.0,515.5050078,516.1154606545455,-5.700012000000015,48.47357999487125,-6.086953846153842,-14.1718707818859,-36.580473075191165,17189651.9688975,1479313.8188576421,4.0,72.0,-68.0,23.30001800000008,518.9916786666666,524.0833333333333,527.9666546666667,533.0583093333332,515.1083573333333,510.0167026666667,506.1333813333333,0.7019504007587325,424217068.0,+1
2016-09-01,519.0,520.224976,516.0,517.924988,458.47894299999996,2877826.0,515.6325042000001,516.5554570545455,1.2749639999999545,45.90114231168568,-6.594205574136012,-15.208031681639795,-34.803302895792086,2710330.4218588523,1535269.118994061,0.0,68.0,-68.0,12.75,518.049988,520.099976,522.274964,524.3249519999999,515.875,513.825012,511.65002400000003,0.45562104968170203,421339242.0,-1
2016-09-02,519.525024,520.0,513.099976,518.775024,455.960144,3332592.0,516.3400054000001,517.1268242909091,7.075012000000015,47.11119087078232,-4.683242251594427,-15.347144549842142,-31.82309875475327,-2320242.0152671756,1360018.6128912773,40.0,64.0,-68.0,20.175017999999966,517.2916666666666,521.4833573333333,524.1916906666665,528.3833813333333,514.5833333333333,510.3916426666666,507.6833093333332,0.8224678638798989,424671834.0,+1
2016-09-06,519.125,524.450012,517.799988,515.924988,461.770966,8215044.0,516.8675048000001,517.0513665818181,5.274993999999936,43.359238761230756,-3.4951762423835997,-14.411808164217973,-17.30200528340715,2869105.0768152536,1428613.4521605491,36.0,60.0,-68.0,12.575012000000015,519.3916626666667,520.9833373333333,526.0416866666667,527.6333613333334,514.3333133333333,512.7416386666666,507.6832893333333,-0.28195386964016844,416456790.0,-1
2016-09-07,524.0,529.5,522.0,522.5,465.902557,7425470.0,518.3450042000002,518.0754566181818,14.77499400000005,53.26653778761232,-1.9732708816422702,-12.81468117352199,11.891217368805288,3716155.2849637303,1532592.6263788755,32.0,56.00000000000001,-68.0,12.375,524.6666666666666,527.3333333333333,532.1666666666665,534.8333333333333,519.8333333333333,517.1666666666666,512.3333333333333,0.06666666666666667,423882260.0,+1
2016-09-08,522.5,522.5,512.0,527.174988,458.52310199999994,9092774.0,519.0800018000001,519.6809082181818,7.34997599999997,59.131281839669334,-0.891160415744817,-10.949157039749252,-5.0068074596194885,-6859065.929472213,1151153.6011129166,28.000000000000004,52.0,-68.0,11.47500599999995,520.5583293333333,529.1166586666666,531.0583293333334,539.6166586666666,518.6166586666666,510.0583293333333,508.1166586666666,1.445236952380951,432975034.0,+1
2016-09-09,518.5,520.5,513.275024,518.825012,457.573059,5053438.0,518.0925018,519.6345464363636,-9.875,46.98078560661954,-2.823913274060721,-8.37210290901362,-17.43122727667221,2119135.2022106177,1195152.7647991758,24.0,48.0,-68.0,4.22497599999997,517.5333453333334,521.7916666666667,524.7583213333332,529.0166426666667,514.5666906666668,510.3083693333334,507.3417146666668,0.7681669807622902,427921596.0,-1
2016-09-12,512.625,529.0,512.625,517.75,465.74789400000003,6203096.0,518.0600006,519.5722733818183,-0.3250120000000152,45.589185211037616,-3.072744230667534,-7.417542807155883,4.612216631062522,7208105.203946863,1468468.7847604344,20.0,44.0,-24.0,6.90002400000003,519.7916666666666,526.9583333333333,536.1666666666665,543.3333333333333,510.58333333333326,503.41666666666663,494.20833333333326,0.31297709923664124,421718500.0,-1
2016-09-14,526.974976,528.900024,520.325012,527.0,462.03610199999997,5152418.0,519.7475006000001,521.1977278181819,16.875,57.954168673913685,-0.9316645509867572,-7.431836424631911,60.22276705972697,-4978296.368453528,1175434.0050688903,16.0,40.0,-24.0,6.65002400000003,525.4083453333334,530.4916786666668,533.9833573333333,539.0666906666668,521.9166666666667,516.8333333333334,513.3416546666667,0.7784231672212205,426870918.0,+1
2016-09-15,522.799988,523.400024,517.674988,522.799988,460.53369100000003,4701722.0,520.8874999999999,521.7527255272727,11.399993999999936,51.78826954718407,-1.903833237215455,-6.501406076557714,28.6752255712802,-604919.0,1094508.8684748497,12.0,36.0,-24.000000000000007,13.575012000000015,521.2916666666666,524.9083453333333,527.0167026666666,530.6333813333333,519.1833093333332,515.5666306666666,513.4582733333332,0.8951908774023358,422169196.0,-1
2016-09-16,524.5,532.25,519.049988,521.099976,468.465576,9949384.0,520.9774964,521.7913575272728,0.8999639999999545,49.336770034238825,-2.5735773802654425,-4.546457728961059,59.16094771593392,5205294.0,1281362.7380896294,8.0,32.0,-23.999999999999996,10.5,524.1333213333334,529.2166546666667,537.3333333333333,542.4166666666667,516.0166426666667,510.93330933333334,502.8166306666667,0.15530198002850168,412219812.0,-1
2016-09-19,523.0,534.450012,520.674988,530.075012,468.929504,5809154.0,522.1924988,523.4454512727273,12.15002400000003,60.67613486762791,-1.0047077458801401,-2.055314499245924,98.1732962848113,4950443.960969905,1448139.1573114602,4.0,28.000000000000004,-24.0,13.899963999999954,528.400004,536.12502,542.1750279999999,549.900044,522.3499959999999,514.6249799999999,508.5749719999999,0.6823961976400194,418028966.0,+1
2016-09-20,526.650024,528.575012,522.875,530.599976,464.046722,4214004.0,523.374994,524.974083490909,11.82495199999994,61.261304892798904,-0.8841510836839857,-0.47192389071062735,83.1358493461211,-4514699.520407393,1177101.0355969667,0.0,24.0,-24.0,16.375,527.349996,531.8249920000001,533.0500080000002,537.5250040000001,526.12498,521.649984,520.424968,1.3552560941976874,422242970.0,+1
2016-09-21,527.0,530.625,525.525024,525.075012,466.521271,4231532.0,524.2899964,525.2831776727273,9.15002400000003,51.88529601972404,-2.1529451697431576,1.3574435803006963,80.66803377538427,2372013.4671126083,1231415.2370294959,0.0,20.0,-24.0,11.15002400000003,527.075012,528.625,532.174988,533.724976,523.525024,521.975036,518.4250480000001,-0.08823806229676726,418011438.0,-1
2016-09-22,529.5,530.5,526.0,527.875,467.86901900000004,3629514.0,524.8274964,525.9349965090909,5.375,55.83767282195135,-1.5099349681496885,3.091567162369415,90.73170395164114,3803263.2615757636,1348317.419963417,88.0,16.0,-24.0,9.325012000000015,528.125,530.25,532.625,534.75,525.75,523.625,521.25,0.4166666666666667,421640952.0,+1
2016-09-23,528.5,529.400024,520.0,529.400024,460.688354,5205294.0,525.05,526.7663651636364,2.2250360000000455,58.00557925294241,-1.1597170423318268,4.918852935602786,64.60269843142837,-8432757.48856444,903723.1059394232,84.0,12.0,-24.0,13.200012000000015,526.2666826666667,532.5333653333334,535.6667066666669,541.9333893333335,523.1333413333334,516.8666586666667,513.7333173333334,1.0,426846246.0,+1
2016-09-26,521.375,522.0,515.5,521.275024,457.749847,6371798.0,525.2950012,526.0800058909091,2.450012000000015,44.558838250171846,-3.02560285610923,5.401148004259312,-24.220852869210816,1578227.4001253888,934382.3920387854,80.0,8.0,-24.000000000000004,13.77502400000003,519.5916746666667,523.6833493333334,526.0916746666667,530.1833493333334,517.1833493333334,513.0916746666667,510.68334933333335,0.8884652307692354,420474448.0,-1
2016-09-27,517.525024,524.950012,516.674988,517.950012,459.451111,6525660.0,525.3150024000001,524.744553309091,0.20001200000001518,40.1625486739271,-3.789183498747957,4.569586328446803,-24.526383446655828,-5221346.893331784,654576.5154310319,76.0,4.0,-24.0,7.200012000000015,519.8583373333333,523.0416866666667,528.1333613333334,531.3167106666667,514.7666626666667,511.5833133333333,506.49163866666663,0.15408100326960086,413948788.0,-1
2016-09-28,520.0,521.150024,516.625,519.875,459.097534,5434708.0,524.6025024,523.7554619636363,-7.125,43.862437699156445,-3.3471148463305163,4.599621306068343,-42.4351428107392,2074113.8780859865,719100.9410062572,72.0,0.0,-20.0,5.09997599999997,519.2166746666667,521.8083493333334,523.7416986666667,526.3333733333334,517.2833253333333,514.6916506666666,512.7583013333333,0.7182282348115675,419383496.0,+1
2016-09-29,522.474976,522.474976,512.0,519.474976,454.789154,8902638.0,524.2700012,522.8231844363637,-3.325012000000015,43.22163732881935,-3.4389793517791993,4.7364081756882115,-63.301637072023695,2354264.7635499965,793426.5693037,68.0,16.0,72.0,5.424987999999985,517.9833173333333,523.9666346666666,528.4582933333331,534.4416106666665,513.4916586666666,507.5083413333333,503.0166826666666,0.7136031624320658,410480858.0,-1
2016-09-30,515.549988,521.950012,515.549988,514.599976,457.816101,6502354.0,523.6200012,521.0649980363636,-6.5,35.855747074047684,-4.558510840045641,3.2807123720260734,-68.03821628262497,2892203.5817187363,888825.5244134745,64.0,12.0,72.0,9.40002400000003,517.3666586666667,519.1833293333334,523.7666826666666,525.5833533333334,512.7833053333334,510.96663466666666,506.38328133333334,-0.14843881835443284,403978504.0,-1
2016-10-03,517.75,520.0,513.049988,518.025024,458.72198499999996,3656160.0,522.4150024,520.0477294545454,-12.049987999999985,43.64185891932211,-3.7719571816201913,3.17662362034082,-70.26254358371837,-4143880.938670296,660066.1397278483,60.0,8.0,72.0,13.90002400000003,517.025004,521.00002,523.9750160000001,527.950032,514.0500079999999,510.07499199999995,507.0999959999999,0.7158312820179353,407634664.0,+1
2016-10-04,520.0,525.700012,519.150024,519.049988,463.626892,5066586.0,521.2600036000001,519.4359086545454,-11.549987999999985,45.908996026674856,-3.536576777037735,3.8930526105781382,-11.009648340741736,-5209993.264553005,393245.2577150821,56.00000000000001,4.0,72.0,8.27502400000003,521.300008,523.4499920000001,527.8499959999999,529.99998,516.9000040000001,514.7500200000001,510.3500160000001,-0.015272699736250778,412701250.0,+1
2016-10-05,524.599976,524.924988,518.5,524.599976,460.22436500000003,2307574.0,521.2125000000001,520.0431763636363,-0.47503600000004553,56.77335274099204,-2.2620359923196065,2.835069857596409,5.814537812140624,9966905.678559551,828411.6404807401,52.0,0.0,72.0,4.52502400000003,522.674988,526.849976,529.099976,533.274964,520.424988,516.25,514.0,0.9494143802291901,415008824.0,+1
2016-10-06,522.5,522.5,512.974976,520.75,453.993805,3721882.0,520.5000000000001,519.9590854545454,-7.125,48.910268851187055,-3.1461732971544887,1.0128347210553557,-49.7609532365413,-1589846.808770445,718490.8018784134,48.0,24.0,52.0,10.47497599999997,518.7416586666667,524.5083413333334,528.2666826666668,534.0333653333334,514.9833173333334,509.21663466666666,505.45829333333336,0.8162734288123584,411286942.0,-1
2016-10-07,514.974976,516.900024,505.049988,513.700012,447.431763,6288558.0,518.9299988,518.722724,-15.700012000000015,37.837641434583816,-4.765185309031522,-0.256602088912814,-154.31389346400164,-11130880.021381946,179883.0371847603,44.0,20.0,52.0,6.40002400000003,511.88334133333336,518.7166946666667,523.7333773333335,530.5667306666668,506.8666586666667,500.0333053333333,495.01662266666665,0.7299576136308782,404998384.0,-1
2016-10-10,508.5,515.875,505.0,506.27499400000005,455.120575,5413170.0,517.4299958,516.4218140363637,-15.000029999999981,29.674002249956587,-5.641472574572823,-1.659815865024143,-191.32435859936584,-1302573.887336292,112498.6315247124,40.0,96.0,52.0,6.950012000000015,509.049998,513.099996,519.924998,523.974996,502.22499600000003,498.174998,491.34999600000003,0.11724082758621143,399585214.0,-1
2016-10-13,510.700012,529.0,510.700012,514.974976,465.01885999999996,9778690.0,517.1324922,515.9754468,-2.9750360000000455,45.55524664063634,-3.625838169707508,-3.34761007033228,-41.492697706225066,-188261.51870209404,98827.7156053121,36.0,96.0,52.00000000000001,7.674987999999985,518.224996,525.74998,536.5249839999999,544.049968,507.44999200000007,499.92500800000005,489.1500040000001,0.23360474334737039,409363904.0,+1
2016-10-14,526.450012,541.349976,498.125,526.174988,453.88333099999994,33461690.0,517.762491,517.6195369454546,6.299987999999985,59.23089310093319,-3.4305388998144735,-3.6845081897514547,15.73703584716796,2046684.4029059587,187366.65593715975,32.0,92.0,52.0,6.424987999999985,521.8833213333334,545.6416426666667,565.1082973333332,588.8666186666667,502.41666666666674,478.6583453333334,459.1916906666668,0.6489301000421609,442825594.0,+1
2016-10-17,517.474976,520.900024,508.674988,513.575012,451.784363,8014858.0,517.1724946,516.8581771272727,-5.8999639999999545,44.666993197737284,-6.278956823092482,-4.067252480354114,-105.51817810299748,1417759.748879335,243293.61470725865,96.0,96.0,24.0,11.625,514.3833413333333,520.0916946666666,526.6083773333332,532.3167306666667,507.8666586666666,502.15830533333326,495.64162266666654,0.40081877877496735,434810736.0,-1
2016-10-18,515.0,520.25,513.650024,511.200012,459.14178499999997,6388134.0,516.8324982,515.7722712000001,-3.3999639999999545,42.39956963459048,-6.815862017815495,-4.398447213405575,-84.3208976114529,23760.66201249345,233314.84413022385,92.0,92.0,24.0,15.700012000000015,515.0333453333334,516.4166666666667,521.6333213333332,523.0166426666667,509.8166906666668,508.4333693333334,503.2167146666668,-0.37121528926772257,428422602.0,-1
2016-10-19,521.0,522.849976,518.0,519.525024,460.35699500000004,3509836.0,516.9824982,516.2618213454546,1.5,52.21120083778765,-4.9338653066864735,-4.208587621317065,7.37736015090626,1381049.0128481134,285484.57907194615,88.0,88.0,-56.0,10.875,520.125,522.25,524.974976,527.099976,517.400024,515.275024,512.5500480000001,0.31443949413358746,431932438.0,+1
2016-10-20,522.375,525.349976,516.900024,520.900024,458.081238,3535490.0,517.1675018000001,516.9740987636364,1.8500360000000455,53.71376518055662,-4.623025457109993,-3.814994872641364,27.496492250462783,4010679.662668957,454811.6283263558,84.0,84.0,-60.0,22.72500599999995,521.050008,525.1999920000001,529.4999600000001,533.649944,516.7500400000001,512.6000560000001,508.3000880000002,0.47337547006184516,435467928.0,+1
2016-10-21,517.5,520.5,511.25,518.325012,468.75845300000003,3863620.0,516.5400054,517.1845551636364,-6.2749639999999545,50.29656992246998,-5.205146433646457,-4.001118306504964,-34.94447512549141,1334516.911065978,494798.23208724783,80.0,80.0,-60.0,43.22497599999997,516.6916706666667,522.1333413333334,525.9416706666666,531.3833413333334,512.8833413333334,507.4416706666667,503.6333413333334,0.7648661621621639,431604308.0,-1
2016-10-24,518.75,521.349976,512.75,519.150024,463.70196500000003,2902974.0,516.3800078,517.6591040000001,-1.5999759999999696,51.43866878080697,-5.018639811116422,-3.7377391205766344,-9.416068999143159,558773.5550132905,497706.20131115883,76.0,76.0,0.0,17.5,517.75,522.75,526.349976,531.349976,514.150024,509.15002400000003,505.55004800000006,0.7441909140211616,434507282.0,+1
2016-10-25,518.25,519.450012,507.60000599999995,513.549988,459.232483,5636014.0,516.3650054000001,517.1445549454545,-0.15002400000003036,43.59326662511428,-6.284613882289436,-4.675855758716239,-75.72272464883277,8173352.087020659,846599.1961161364,72.0,72.0,0.0,6.674987999999985,513.5333353333333,519.4666646666667,525.3833413333334,531.3166706666667,507.6166586666666,501.68332933333323,495.7666526666665,0.5021079314221446,428871268.0,-1
2016-10-26,508.5,509.924988,504.64999400000005,508.60000599999995,457.878113,2775216.0,516.5975066000001,515.7327368727272,2.3250119999999015,37.72493442417635,-7.403633271588562,-5.401384456322489,-173.80211763051818,4637663.236454637,1018920.2888587955,68.0,68.0,0.0,11.649963999999954,507.724996,510.7999979999999,512.9999899999998,516.0749919999998,505.52500399999997,502.45000200000004,500.25001000000003,0.7488182924947308,426096052.0,-1
2016-10-27,508.950012,508.97500599999995,500.549988,507.10000599999995,453.04739400000005,7227790.0,515.8100096000001,514.0059185818182,-7.874970000000019,36.029097053617086,-7.74273128930836,-4.67334562710073,-171.87084074891425,-2144856.955747061,875112.232285802,64.0,64.0,0.0,8.44995199999994,505.5416666666666,510.53334533333316,513.9666846666665,518.9583633333332,502.1083273333332,497.1166486666666,493.6833093333332,0.7774485466974661,418868262.0,-1
2016-10-28,502.60000599999995,505.0,496.575012,501.75,450.338562,5840706.0,513.3675108,511.4495532,-24.424987999999985,30.40435709259762,-8.952182242234365,-2.965723644902937,-193.5755179989731,-7837797.090909091,479070.8994133067,60.0,60.0,0.0,9.65002400000003,501.10833733333334,505.64166266666666,509.5333253333333,514.0666506666666,497.2166746666667,492.68334933333335,488.7916866666667,0.6142427739956418,413027556.0,-1
2016-11-01,503.39999400000005,503.39999400000005,493.200012,498.75,446.704254,6332798.0,511.88500960000005,508.7918239636363,-14.825012000000015,27.614971444973335,-9.630378277673959,-2.827598454930012,-186.35470704592427,-751571.080414631,423132.62760294584,56.00000000000001,96.0,0.0,8.59997599999997,498.45000200000004,503.69999200000007,508.64998400000013,513.8999740000002,493.50001000000003,488.25002,483.300028,0.5441174307954628,406694758.0,-1
2016-11-02,492.39999400000005,493.75,490.0,494.72500599999995,442.91195700000003,5377194.0,510.237509,505.67182330909094,-16.475006000000064,24.180707776935904,-10.54028993549669,-4.254694359102018,-220.05680043768527,15538975.861353653,1110216.4109552512,52.0,96.0,0.0,11.850006000000064,492.825002,495.65000399999997,496.57500200000004,499.40000399999997,491.90000399999997,489.075002,488.15000399999997,1.260001599999987,401317564.0,-1
2016-11-03,490.52499400000005,491.0,482.549988,490.52499400000005,436.501068,5225108.0,507.337506,502.0877296727273,-29.00002999999998,21.031555685537057,-11.489767097896241,-4.086605302486703,-233.63440988154747,5061375.567421143,1289814.5544309737,48.0,96.0,0.0,8.899993999999936,488.02499400000005,493.5000000000001,496.4750060000001,501.95001200000013,485.0499880000001,479.57498200000003,476.5999760000001,0.9437863520193877,396092456.0,-1
2016-11-04,483.5,489.60000599999995,480.5,483.424988,438.37469500000003,6005548.0,503.5900024,497.7399991272727,-37.475036000000046,16.7712078402281,-13.094832404828702,-4.333741212383188,-204.91206266576563,4074589.8319099126,1416395.2488618346,44.0,96.0,0.0,8.425017999999966,484.5083313333333,488.51666266666655,493.6083373333332,497.6166686666665,479.4166566666666,475.4083253333333,470.31665066666665,0.3214270408173358,390086908.0,-1
2016-11-07,492.5,493.0,487.5,485.5,441.51239000000004,4537672.0,500.3075012,494.4509077818181,-32.825012000000015,22.093023360350458,-9.346775710854027,-6.01286916115555,-130.27793031354798,-1588336.7369527647,1279816.5222338983,40.0,96.0,0.0,10.524993999999936,488.6666666666667,489.83333333333337,494.16666666666674,495.33333333333337,484.33333333333337,483.1666666666667,478.83333333333337,-0.36363636363636365,394624580.0,+1
2016-11-08,493.450012,493.875,485.299988,488.97500599999995,443.61169400000006,5261108.0,497.2899994,492.3904541090909,-30.17501800000008,30.660444750736374,-8.531716206781262,-7.885219151657225,-105.63105978601511,-16541563.414394682,469753.79784168943,36.0,92.0,-39.99999999999999,10.199982000000034,489.3833313333333,493.46667466666656,497.95834333333323,502.0416866666666,484.89166266666655,480.80831933333326,476.31665066666653,0.4285729279445859,399885688.0,+1
2016-11-09,465.0,487.299988,450.5,491.299988,432.641083,12764158.0,495.06499940000003,491.30136112727274,-22.25,36.08643216507628,-7.986393788374457,-9.583906149349218,-160.89746562584438,1616072.9091712409,521859.2119930327,32.0,88.0,-44.0,8.75,476.36665866666664,502.2333173333333,513.1666466666666,539.0333053333333,465.4333293333333,439.56667066666665,428.6333413333333,1.108695687618159,412649846.0,+1
2016-11-10,481.25,481.25,467.5,479.14999400000005,424.108307,7287330.0,492.11999820000005,488.40772378181816,-29.4500119999999,24.517771202917558,-10.836163856146182,-12.2339131645669,-131.546386489139,3394023.672033599,652412.1419948767,28.000000000000004,96.0,-48.0,12.175017999999966,475.9666646666667,484.4333293333334,489.7166646666667,498.1833293333334,470.6833293333334,462.2166646666667,456.9333293333334,0.8472722909090945,405362516.0,-1
2016-11-11,470.0,472.5,459.35000599999995,469.700012,416.049652,7096782.0,488.37999880000007,484.3313626545455,-37.399993999999936,19.039950752732537,-12.229185967800307,-14.411412291275894,-142.61884599947334,2447828.469454165,734021.975061208,24.0,92.0,-52.0,10.02499400000005,467.1833393333333,475.0166726666667,480.3333333333334,488.16666666666674,461.86667866666664,454.0333453333333,448.7166846666666,0.7870730587405611,398265734.0,-1
2016-11-15,462.0,469.97500599999995,454.27499400000005,460.77499400000005,416.95254500000004,9235850.0,484.2824982000001,479.3122708727273,-40.97500599999995,15.311899314876698,-14.34236662535052,-16.327781534593328,-134.03099582911477,-5837947.469417452,435296.0912212687,20.0,88.0,-56.0,9.575012000000015,461.674998,469.075002,477.3750099999999,484.7750139999999,453.3749900000001,445.9749860000001,437.6749780000002,0.4140124224108899,389029884.0,-1
2016-11-16,465.0,478.424988,464.27499400000005,461.77499400000005,424.78555300000005,12222616.0,480.58499760000007,475.2199973818182,-36.97500599999995,17.40273802612053,-13.71744948362612,-17.92801794748698,-88.83924897584113,-5488033.097132554,166053.8553870038,16.0,84.0,-56.0,8.575012000000015,468.1583253333334,472.0416566666667,482.30831933333326,486.19165066666665,457.8916626666668,454.00833133333344,443.74166866666684,-0.17667852014636978,401252500.0,+1
2016-11-17,467.125,474.5,463.200012,470.450012,419.774261,5706730.0,478.1574982000001,473.3772727272728,-24.274993999999936,33.7698534975236,-9.606370299389038,-19.047012247145688,-71.64956917893987,-22946987.5949505,-884538.9378101564,12.0,80.0,-56.0,38.47500599999995,469.38334133333336,475.5666706666667,480.6833293333334,486.8666586666667,464.2666826666667,458.0833533333334,452.96669466666674,0.6415936016923213,406959230.0,+1
2016-11-18,465.0,466.625,458.75,464.89999400000005,415.349854,6040228.0,475.5949982,470.9668174181819,-25.625,29.460444584369952,-10.750658297447504,-20.52606776143358,-77.43224682087566,-12700857.931071864,-1421644.3465947798,8.0,76.0,-68.0,23.799987999999985,463.424998,468.09999600000003,471.29999799999996,475.97499600000003,460.22499600000003,455.549998,452.34999600000003,0.7809516190476253,400919002.0,-1
2016-11-21,463.450012,463.450012,453.47500599999995,460.0,411.331787,7940568.0,473.25249940000003,468.1313632,-23.424987999999985,26.07122967699253,-11.083743842364532,-22.245868363570878,-77.45465428837149,544552.1544488269,-1332271.778365525,4.0,72.0,-68.0,19.7999880000001,458.97500599999995,464.47500599999995,468.95001199999996,474.450012,454.4999999999999,448.9999999999999,444.5249939999998,0.6541343433778393,392978434.0,-1
2016-11-22,458.450012,464.325012,455.825012,455.549988,412.731354,5483126.0,470.25749820000004,464.91272476363633,-29.950012000000015,23.266422774398464,-11.832345872883485,-23.1585856479594,-67.84087732022982,2679907.5698522986,-1149899.9898101692,0.0,68.0,-68.0,15.700011999999901,458.56667066666665,461.3083293333333,467.0666706666666,469.8083293333333,452.8083293333333,450.06667066666665,444.3083293333333,-0.03235576470588592,387495308.0,-1
2016-11-23,461.049988,461.450012,456.22500599999995,457.10000599999995,415.462708,8251786.0,467.06999820000004,462.5204534545455,-31.875,26.446714749413474,-9.313072238050028,-22.496956609826043,-59.19905580040156,3810734.290792447,-924416.613419141,12.0,64.0,-68.0,17.649993999999936,458.25834133333325,460.29167666666655,463.48334733333326,465.5166826666666,455.0666706666665,453.0333353333332,449.8416646666664,0.16746392252946488,395747094.0,+1
2016-11-24,464.10000599999995,469.950012,461.64999400000005,460.125,420.0,16780644.0,463.9524994000001,461.25772650909096,-31.174987999999985,32.725395277985854,-8.547008547008547,-22.930961469101305,-38.10357303046306,153252.02416584466,-875431.675347096,8.0,60.0,-68.0,12.72500599999995,463.90833533333335,466.16667666666666,472.20835333333326,474.4666946666666,457.8666586666667,455.6083173333334,449.56664066666673,-0.18373381840859326,412527738.0,+1
2016-11-25,465.22500599999995,492.5,465.22500599999995,465.14999400000005,441.30923499999994,12631380.0,462.55249940000004,461.4754528,-14.0,42.184864999664505,-7.274455460588782,-24.027408302463357,-7.6571821781909035,10740138.117647057,-347451.2302109977,4.0,56.00000000000001,-68.0,11.700012000000015,474.2916666666667,483.3583273333334,501.5666606666668,510.63332133333347,456.08333333333337,447.01667266666664,428.8083393333333,-0.0027502114207578325,425159118.0,+1
2016-11-28,489.64999400000005,491.72500599999995,485.299988,488.75,442.325043,7365712.0,464.45749820000003,466.2386347272727,19.049987999999985,67.18729249474987,-1.2978790756568535,-24.519334715636262,33.90012587676419,828593.407176029,-293994.6557843146,0.0,52.0,-68.0,11.424988000000099,488.59166466666665,491.8833413333333,495.0166826666666,498.30835933333327,485.45832333333334,482.1666466666667,479.0333053333334,0.5369653439103258,432524830.0,+1
2016-11-29,489.39999400000005,492.35000599999995,483.549988,489.875,439.09701500000006,6125506.0,467.3674988000001,470.8599986909091,29.10000599999995,67.94965522030542,-1.0129787907565686,-23.29774794648432,36.439359314803504,-3562110.0,-442545.3532486641,4.0,48.0,-68.0,8.5,488.59166466666665,493.6333413333333,497.3916826666666,502.43335933333327,484.83332333333334,479.7916466666667,476.0333053333334,0.7187498934661315,438650336.0,+1
2016-11-30,486.5,488.5,480.52499400000005,486.299988,440.428864,8500918.0,469.81999820000004,474.3022694545454,24.524993999999936,62.61540177203845,-1.5756066073697623,-20.964531572536885,28.843449415875437,-52909.161458562405,-424834.617258205,0.0,44.0,-52.0,5.90002400000003,485.10832733333336,489.6916606666667,493.0833333333333,497.66666666666663,481.7166546666667,477.1333213333334,473.7416486666668,0.724136633878391,430149418.0,-1
2016-12-01,488.0,491.77499400000005,483.5,487.77499400000005,440.451416,4611590.0,471.55249640000005,477.5668141454545,17.324982000000034,63.96221887339675,-1.2007639135959214,-17.14382201962843,39.25677372249541,-8644075.5345358,-798436.4771344597,0.0,40.0,-52.0,12.850006000000064,487.6833293333334,491.8666586666668,495.9583233333335,500.14165266666686,483.59166466666676,479.40833533333335,475.3166706666667,0.5166159637094629,434761008.0,+1
2016-12-02,482.39999400000005,484.799988,480.549988,487.799988,435.440155,4453228.0,473.84249580000005,480.5209035272727,22.899993999999936,63.98758522648842,-1.1944121982210965,-13.56467751272504,31.21642166052104,-6603911.7577824155,-1062321.7171639125,0.0,36.0,-52.00000000000001,32.375,484.3833213333333,488.2166546666666,488.63332133333324,492.4666546666666,483.9666546666666,480.1333213333333,479.7166546666666,1.7058823529411764,439214236.0,+1
2016-12-05,482.950012,484.299988,479.0,482.25,434.153503,3659576.0,476.0674958000001,482.04954065454547,22.25,54.21091601697074,-2.6048284625158833,-11.4381459214718,25.619531701573862,9323413.704600383,-590242.8343564441,0.0,32.0,-52.0,26.5750119999999,481.849996,484.69999199999995,487.1499839999999,489.99997999999994,479.40000399999997,476.550008,474.100016,0.6132089355674031,435554660.0,-1
2016-12-06,480.89999400000005,489.75,480.825012,480.825012,436.34310899999997,3562110.0,478.5949982000001,482.9145436,25.27502400000003,51.86332403167546,-2.9669601016518383,-8.53318998443683,37.31025712568206,-2064464.7586206896,-657252.9218230008,0.0,28.000000000000004,-44.0,8.800017999999966,483.800008,486.77500399999997,492.7249959999999,495.69999199999995,477.850016,474.87502,468.925028,0.0,431992550.0,-1
2016-12-07,484.0,486.5,480.10000599999995,483.25,436.297943,3385980.0,481.20999760000007,483.76090756363635,26.14999400000005,55.63570664274224,-2.3506988564167726,-5.012626228355089,39.428387109505984,-2233061.723533548,-728880.5946280257,0.0,24.0,-44.0,9.35000599999995,483.2833353333333,486.46666466666665,489.68332933333335,492.8666586666667,480.0666706666666,476.88334133333325,473.66667666666655,0.49218702392533886,435378530.0,+1
2016-12-08,485.02499400000005,493.049988,485.02499400000005,483.200012,444.537262,5941662.0,483.5174988000001,484.1227283636364,23.075012000000015,55.53219515458472,-2.4996767668979016,-0.7802362235200917,57.0402067933145,-2247622.164458279,-797914.3023475826,16.0,20.0,-40.0,8.27499400000005,487.0916646666667,489.15833533333335,495.11665866666664,497.1833293333333,481.1333413333334,479.06667066666677,473.1083473333335,-0.2274122572552763,429436868.0,-1
2016-12-09,492.5,504.075012,490.75,492.325012,446.65911900000003,8648384.0,486.23500060000003,485.7240944,27.175017999999966,68.05191879182473,-2.9006973157850573,3.5515099701503914,98.53602558563679,-12254068.590434968,-1318648.588169737,12.0,16.0,-36.0,7.225006000000064,495.7166746666667,500.68334933333335,509.0416866666667,514.0083613333334,487.35833733333334,482.39166266666666,474.0333253333333,0.1181996684130576,438085252.0,+1
2016-12-12,491.39999400000005,491.39999400000005,482.60000599999995,494.674988,441.241516,5345020.0,486.8274994,487.2586375636363,5.924987999999985,70.51840393216825,-2.3205637774566137,7.616965955240289,65.84917322154232,2317110.0089758364,-1153386.8337540291,96.0,12.0,-32.0,8.799987999999985,489.55832933333335,496.51665266666674,498.35831733333345,505.31664066666684,487.71666466666665,480.75834133333325,478.91667666666655,1.3721589165803294,443430272.0,+1
2016-12-13,490.25,496.424988,485.549988,488.674988,447.042877,4854282.0,486.7074982,487.5945445818182,-1.2000120000000152,57.4515458905992,-3.801770917431962,10.72105878070181,66.60360269692595,-4745817.110752284,-1316679.1190721318,92.0,8.0,-28.000000000000004,8.924987999999985,490.21665466666667,494.88332133333336,501.0916546666667,505.75832133333336,484.00832133333336,479.34165466666667,473.13332133333336,0.28735632183908044,438575990.0,-1
2016-12-14,495.5,502.47500599999995,492.049988,495.10000599999995,451.35437,5382614.0,487.58750000000003,489.12045509090905,8.800017999999966,65.37819167585346,-2.2156404947536146,11.026463468777763,99.85291029093266,1252356.0130883558,-1199904.7948830186,88.0,4.0,-24.0,6.399994000000049,496.5416666666666,501.03334533333316,506.96668466666654,511.4583633333331,490.6083273333332,486.1166486666666,480.1833093333332,0.292567168708963,443958604.0,+1
2016-12-15,498.700012,509.47500599999995,494.5,499.875,448.01351900000003,7966416.0,488.79750060000003,491.35454599999997,12.10000599999995,70.14728564229463,-2.3387553102319587,11.533743459573316,116.72500795600652,5007927.118898811,-917730.6169838442,84.0,0.0,-4.0,9.799987999999985,501.2833353333333,508.0666706666666,516.2583413333332,523.0416766666665,493.09166466666665,486.30832933333335,478.1166586666667,0.35893140877539664,451925020.0,+1
2016-12-16,501.89999400000005,504.85000599999995,498.875,496.174988,453.79229699999996,6436742.0,489.63500060000007,492.6959073454546,8.375,62.45537608895259,-3.2401529461211496,12.637690387939188,89.06453924529961,-2391050.3868305758,-984699.6974314229,96.0,24.0,-4.0,20.875,499.96666466666665,501.0583293333333,505.9416706666666,507.03333533333324,495.08332333333334,493.9916586666667,489.1083173333334,-0.45188439978136213,445488278.0,-1
2016-12-19,503.049988,504.125,497.049988,502.575012,453.566559,4124134.0,491.6675018000001,495.0486366909091,20.325012000000015,69.1967219772634,-1.6809778668959778,13.00548487265712,82.48773582216938,1326348.1921368684,-879652.0660874095,92.0,20.0,84.0,9.725006000000064,501.25,505.450012,508.325012,512.525024,498.375,494.174988,491.299988,0.7809207956113741,449612412.0,+1
2016-12-20,501.0,509.5,500.64999400000005,502.325012,456.95257599999997,7636498.0,493.81750180000006,496.9863658181818,21.5,68.64121422683341,-1.7478655298416528,12.821835115358681,84.11395790276133,-3679005.114678597,-1006895.3864779182,88.0,16.0,84.0,10.875,504.15833533333335,507.66667666666666,513.0083413333332,516.5166826666666,498.8166706666667,495.3083293333334,489.96666466666676,0.18926744230455608,441975914.0,-1
2016-12-21,508.0,511.0,499.125,506.075012,452.16702300000003,7343976.0,496.100003,499.21500403636367,22.825012000000015,72.46681943472646,-1.1953854368932002,13.002592288897006,75.7786520692769,-2553369.180746996,-1077189.6498537855,96.0,12.0,84.0,13.800017999999966,505.400004,511.67500800000005,517.2750040000001,523.550008,499.80000800000005,493.525004,487.92500800000005,0.5852641684210539,449319890.0,+1
2016-12-22,501.25,503.5,484.75,500.77499400000005,444.559784,7060054.0,497.85750120000006,500.0650024,17.574982000000034,60.442111816291515,-2.481797572815522,13.421359004873807,24.08445284676383,267202.11838159495,-1016080.9331158136,96.0,8.0,84.0,14.97500599999995,496.3416646666667,507.9333293333334,515.0916646666667,526.6833293333334,489.1833293333334,477.5916646666667,470.4333293333334,0.8546663466666693,442259836.0,-1
2016-12-23,492.450012,503.299988,486.799988,492.35000599999995,446.252777,7306036.0,497.86000060000003,499.06363963636363,0.024993999999935568,46.338828560357946,-4.526697572815546,13.946626429634762,9.22201673690511,-7569823.233915036,-1313978.3104248694,92.0,4.0,72.0,5.975005999999951,494.14999399999994,501.4999999999999,510.6499939999999,517.9999999999999,484.9999999999999,477.64999399999994,468.4999999999999,0.3363647272727252,434953800.0,-1
2016-12-26,494.0,497.0,487.549988,494.22500599999995,443.679443,3213828.0,497.81500239999997,498.4027315272727,-0.4499820000000341,49.372357821090276,-4.071600485436906,14.274796022030785,2.2954786988389917,1528186.5233303988,-1184788.99979963,88.0,0.0,72.0,7.950012000000015,492.92499799999996,498.30000799999993,502.37501,507.75001999999995,488.8499959999999,483.47498599999994,479.3999839999999,0.7063502141584534,438167628.0,+1
2016-12-27,491.375,500.950012,490.0,491.375,450.993195,4912816.0,498.08500359999994,497.23182199999997,2.700012000000015,44.9187860183361,-4.763349514563107,13.014511569254864,7.171581427923308,4528828.727397633,-925079.1031088451,84.0,0.0,72.0,8.85000599999995,494.10833733333334,498.2166746666667,505.05834933333335,509.1666866666667,487.26666266666666,483.1583253333333,476.31665066666665,0.1255706386440488,433254812.0,-1
2016-12-28,501.47500599999995,504.89999400000005,497.5,499.47500599999995,450.79007,5476816.0,498.5225036,497.48454970909086,4.375,57.492813926401375,-2.7973286407767106,11.31299149946517,39.019645960813335,-5179434.289702825,-1118458.8843176626,80.0,0.0,84.0,11.875,500.625,503.75,508.0249940000001,511.14999400000005,496.35000599999995,493.22500599999995,488.9500119999999,0.2668929191023584,438731628.0,+1
2016-12-29,501.875,504.0,494.075012,499.25,448.01351900000003,6240124.0,498.4600036,497.6168217818182,-0.625,57.07519995143407,-2.8519417475728157,10.517222101231027,28.47535487512095,-1087684.5060240964,-1117060.0489406823,76.0,0.0,88.0,21.325012000000015,499.10833733333334,504.14166266666666,509.0333253333333,514.0666506666666,494.2166746666667,489.18334933333335,484.2916866666667,0.5214100006972293,432491504.0,-1
2016-12-30,499.0,506.0,496.375,496.174988,456.252777,7267768.0,498.46000360000005,497.2013644,0.0,51.209587584690766,-3.598303883495149,8.951421911947136,29.196505354065717,11869965.282117428,-526740.7157107678,72.0,0.0,88.0,16.5,499.51666266666666,502.6583253333333,509.14166266666666,512.2833253333333,493.0333253333333,489.89166266666666,483.4083253333333,-0.02078046753246911,425223736.0,-1
2017-01-02,505.549988,506.47500599999995,499.674988,505.299988,451.963867,2335222.0,498.73250120000006,498.44499792727277,2.7249759999999696,63.909328148359236,-1.3834980582524308,7.210699995792538,52.08887000808374,2250323.100235988,-400510.54225864244,68.0,20.0,88.0,9.450012000000015,503.8166606666666,507.95833333333326,510.61667866666653,514.7583513333332,501.1583153333333,497.01664266666666,494.3582973333333,0.8272036926961117,427558958.0,+1
2017-01-03,502.049988,502.450012,491.0,500.549988,448.690704,6778482.0,498.5549988000001,498.77545007272715,-1.7750240000000304,55.2686494647514,-2.536410679611654,7.305189817504413,9.19186326295513,-7548245.400014069,-725407.5812475258,64.0,16.0,84.0,10.950012000000015,498.0,505.0,509.450012,516.450012,493.549988,486.549988,482.09997599999997,0.8340592132130492,420780476.0,-1
2017-01-04,497.52499400000005,502.10000599999995,496.125,496.924988,450.451416,7073586.0,497.6399964000001,498.47908447272727,-9.15002400000003,49.38870105361943,-3.4162650485436927,6.490027859257623,7.5208620310506635,-1097560.9514170466,-742323.6435279584,60.0,12.0,80.0,13.52499400000005,498.3833313333333,500.64166266666655,504.3583373333332,506.6166686666665,494.6666566666666,492.4083253333333,488.69165066666665,0.13388907057164318,413706890.0,-1
2017-01-05,500.799988,504.75,494.375,498.875,449.72909500000003,8207074.0,497.44999700000005,498.7036305818182,-1.8999940000000493,52.523776581978076,-2.9429611650485437,5.471575387713472,12.041440362111127,-19318012.696310855,-1586673.145927182,56.00000000000001,8.0,76.0,9.924987999999985,499.3333333333333,504.29166666666663,509.70833333333326,514.6666666666666,493.91666666666663,488.9583333333333,483.54166666666663,0.43373493975903615,421913964.0,+1
2017-01-06,497.450012,499.424988,484.02499400000005,498.075012,438.93902599999996,14393448.0,498.0224976,498.8172696727272,5.725006000000064,51.02754340468025,-3.137133009708734,3.9201809494810504,-44.31507522982307,-1051997.130256303,-1562369.6906694148,52.0,4.0,72.0,9.625,493.8416646666667,503.65833533333335,509.24165866666664,519.0583293333333,488.2583413333334,478.44167066666677,472.8583473333335,0.9123391866256587,407520516.0,-1
2017-01-09,486.125,488.47500599999995,482.5,486.125,438.081238,10545692.0,497.21249700000004,496.65408829090904,-8.10000599999995,34.22384414472211,-6.0376213592233015,2.6977043969299643,-152.06283494253026,32018511.041088372,-35966.0210440596,48.0,0.0,48.0,10.300017999999966,485.700002,488.90000399999997,491.67500799999993,494.8750099999999,482.924998,479.72499600000003,476.94999200000007,0.6066939514370412,396974824.0,-1
2017-01-10,488.5,490.5,483.97500599999995,485.174988,438.17153899999994,11939854.0,496.59249579999994,494.46545029090913,-6.200012000000015,33.220353909640295,-6.268206796116509,2.201899008798364,-148.77073178612434,-2444517.6401868337,-145445.64009600398,44.0,4.0,48.0,14.299987999999985,486.54999799999996,489.12498999999997,493.074992,495.649984,482.5999959999999,480.0250039999999,476.07500199999987,0.1839054564647914,385034970.0,-1
2017-07-07,471.924988,472.72500599999995,466.52499400000005,473.5,435.44998200000003,5776886.0,470.64250480000004,472.35909636363635,1.8250120000000152,50.935869068393224,-2.9792746113989637,-6.707567700449999,-12.978957765727898,-10357589.180218348,-933644.3059765311,16.0,72.0,-88.0,6.649994000000049,470.9166666666667,475.3083393333333,477.1166786666666,481.5083513333332,469.1083273333334,464.7166546666668,462.9083153333335,1.1249987903249319,356945842.0,-1
2017-07-10,471.60000599999995,479.89999400000005,470.0,467.700012,445.528503,1464376.0,470.4050048000001,471.8240976727273,-2.375,41.89161956368512,-4.481862176165799,-6.108158032379038,-0.5603411517738713,-9366214.430999916,-1316942.948023049,12.0,68.0,-88.0,12.39999400000005,472.53333533333335,475.0666706666667,482.4333293333334,484.96666466666676,465.16667666666666,462.6333413333333,455.2666826666666,-0.2323221610033272,355481466.0,-1
2017-07-13,488.625,491.72500599999995,482.049988,486.174988,454.838959,5170392.0,475.89250180000005,478.61772629090916,23.824982000000034,64.31129990981022,-2.1667749842072053,-3.563372523841849,122.85394857057193,6809740.0,-916979.2535858381,92.0,56.00000000000001,-76.0,8.975006000000064,486.64999399999994,491.2499999999999,496.3250119999999,500.92501799999985,481.5749819999999,476.97497599999997,471.89996399999995,0.42635579592720285,368126758.0,-1
2017-07-17,487.5,496.0,487.0,486.02499400000005,458.097626,7698250.0,480.0600006,482.3309054909091,18.25,61.697136290024496,-4.302403292647174,1.3699208110691643,120.02618569146362,-8817405.428288916,-1586564.8715557002,96.0,48.0,-56.0,9.89999400000005,489.674998,492.34999600000003,498.67499799999996,501.34999600000003,483.34999600000003,480.674998,474.34999600000003,-0.10833399999999453,382906688.0,-1
2017-07-19,490.72500599999995,494.325012,484.549988,492.799988,456.142456,5890278.0,482.8399964,486.5304477818182,11.72497599999997,69.0122249165045,-2.6271868245688124,5.301236152348338,98.46201170771796,-1358089.3064967468,-1606650.7425009478,88.0,40.0,36.0,12.22500599999995,490.55832933333335,496.5666706666667,500.33335333333343,506.34169466666674,486.7916466666667,480.7833053333333,477.01662266666665,0.8439876976261106,397057146.0,+1
2017-07-20,489.64999400000005,489.924988,483.47500599999995,489.924988,451.301025,6809740.0,484.28749400000004,487.81862807272734,14.47497599999997,62.39623252421228,-3.3380726712168443,6.495400105300121,68.87029202543081,5895411.740130025,-1265647.9023813577,84.0,36.0,35.99999999999999,9.675017999999966,487.77499399999994,492.0749819999999,494.2249759999999,498.52496399999995,485.6249999999999,481.3250119999999,479.17501799999985,1.0,390247406.0,-1
2017-07-21,486.5,491.27499400000005,485.700012,484.72500599999995,456.25882,5980754.0,485.40999460000006,487.8981757090909,11.22500599999995,51.99384953857776,-4.623844360477556,6.737978810209256,59.79720309579796,-6326378.055641249,-1495681.0911658984,80.0,32.0,36.0,20.399993999999936,487.23333733333334,488.76666266666666,492.80831933333343,494.3416446666667,483.1916806666666,481.6583553333333,477.6166986666666,-0.1748895332756336,384266652.0,-1
2017-07-24,491.75,497.0,491.299988,490.049988,461.12356600000004,6129176.0,487.6449922,488.7418108727273,22.34997599999997,59.89419253033403,-3.307164590927799,7.970853060645879,89.33073580674225,-7537252.333271874,-1770297.9658070793,76.0,28.000000000000004,48.0,9.0,492.7833253333333,494.26666266666666,498.48333733333334,499.9666746666667,488.56665066666665,487.0833133333333,482.86663866666663,-0.21929778393448937,390395828.0,+1
2017-07-25,495.0,499.5,493.10000599999995,495.27499400000005,462.65975999999995,7145614.0,489.3199922,490.12908392727275,16.75,66.19317018936131,-2.0152053512578547,9.53365490908459,96.59653384011385,2906732.18388902,-1557705.6862754384,72.0,24.0,48.0,16.375,495.9583333333333,498.8166606666667,502.3583273333333,505.2166546666667,492.41666666666663,489.55833933333327,486.0166726666666,0.3398421936020693,397541442.0,+1
2017-07-26,499.049988,499.5,495.200012,496.924988,462.75286900000003,6870024.0,490.24499220000007,491.5118104363636,9.25,68.0231327142633,-1.6072201750303323,11.765955706044338,87.33768218713418,1858001.198551525,-1402446.2824196673,68.0,20.0,48.0,9.77502400000003,497.2083333333333,499.2166546666666,501.50832133333324,503.5166426666666,494.91666666666663,492.90834533333333,490.61667866666664,0.4011583288139352,404411466.0,+1
2017-07-27,498.0,502.0,483.39999400000005,497.02499400000005,452.045837,12676852.0,491.32999280000007,492.7445380363637,10.850006000000064,68.14372633120155,-1.5824922272112265,12.377889812293802,55.26445778361652,1931376.0466646336,-1250908.9038249264,64.0,16.0,48.0,9.324982000000034,494.1416626666667,504.8833313333334,512.7416686666666,523.4833373333333,486.28332533333344,475.54165666666677,467.6833193333335,0.7325266454215141,417088318.0,+1
2017-07-28,488.0,501.5,481.14999400000005,485.52499400000005,464.289093,11098428.0,491.0299928,491.6890837090909,-3.0,45.417360695557704,-4.426035613803353,11.936056735869101,20.008333732970367,1218505.997385608,-1138662.7719517201,60.0,12.0,48.0,5.574982000000034,489.3916626666667,497.6333313333334,509.7416686666666,517.9833373333333,477.28332533333344,469.04165666666677,456.9333193333335,0.21498765160069291,405989890.0,-1
2017-07-31,495.950012,510.85000599999995,493.375,498.674988,470.73657199999997,19158248.0,492.2949922,493.0790828363636,12.649993999999936,62.09611091144681,-2.9561776915452973,12.02953356333586,74.12390454723302,6073744.0,-810826.100499369,56.00000000000001,8.0,48.0,12.27499400000005,500.96666466666665,508.5583293333333,518.4416706666666,526.0333353333333,491.08332333333334,483.4916586666667,473.6083173333334,0.30328962404934223,425148138.0,+1
2017-08-01,505.5,508.5,499.174988,505.60000599999995,468.106384,7689398.0,493.6524934,495.4981762545454,13.575011999999901,68.031791591636,-1.2747359289828444,11.919544491058218,84.45761314446202,4424478.721186263,-572857.6995136583,96.0,4.0,48.0,9.450012000000015,504.42499799999996,509.67500799999993,513.75001,519.00002,500.3499959999999,495.09998599999994,491.0249839999999,0.689009086529857,432837536.0,+1
2017-08-02,503.0,506.375,493.60000599999995,502.77499400000005,462.426971,4257584.0,494.649994,497.1568127272728,9.975006000000064,63.36134468595529,-1.9606681758795221,12.244562543660436,59.039520238649644,-4509730.534149927,-751806.4647243979,92.0,0.0,48.0,4.299987999999985,500.9166666666667,508.2333273333334,513.6916606666668,521.0083213333335,495.45833333333337,488.14167266666664,482.6833393333333,0.7181990065905364,428579952.0,-1
2017-08-03,495.5,499.375,490.125,496.674988,458.074371,4640348.0,495.32499400000006,497.5249934545454,6.75,54.10677823702855,-3.441791378776857,11.12795875092172,24.823507015024372,-9140684.0,-1133119.0799641982,88.0,0.0,48.0,18.60000599999995,495.39166266666666,500.6583253333333,504.64166266666666,509.9083253333333,491.4083253333333,486.14166266666666,482.1583253333333,0.7081068108108092,423939604.0,-1
2017-08-04,494.0,494.5,488.02499400000005,492.0,457.95797699999997,5349018.0,496.05249340000006,496.9204490909091,7.274994000000049,47.91770215739506,-4.576910458998501,9.677928654017592,-1.4539385763813948,-979228.432072022,-1126124.050514554,84.0,0.0,48.0,20.35000599999995,491.5083313333334,494.9916686666667,497.9833373333334,501.4666746666667,488.5166626666668,485.03332533333344,482.0416566666668,0.613899971675699,418590586.0,-1
2017-08-07,491.75,491.875,482.85000599999995,491.875,450.742401,6073744.0,496.2349946,496.16090483636367,1.8250120000000152,47.74919528315546,-4.607261314450473,8.752661811431437,-23.33920175631043,2866310.5475590415,-944649.7506021176,80.0,16.0,48.00000000000001,25.3250119999999,488.8666686666666,494.8833313333333,497.8916626666666,503.9083253333333,485.8583373333332,479.84167466666656,476.8333433333332,1.0,412516842.0,-1
2017-08-08,484.25,485.125,477.52499400000005,484.125,448.694092,6004648.0,495.1199952,493.9590876363636,-11.14999400000005,38.15139590088817,-6.4890143524727675,8.527306748551212,-71.46848834963487,2818092.8761443323,-773615.9948409153,76.0,12.0,92.0,9.825012000000015,482.2583313333334,486.9916686666667,489.8583373333334,494.5916746666667,479.3916626666668,474.65832533333344,471.7916566666668,0.8684211565096124,406512194.0,-1
2017-08-09,483.825012,486.950012,482.27499400000005,481.924988,451.254425,3922410.0,493.61999520000006,491.55999541818176,-15.0,35.794740498583096,-7.02319232210961,8.035121463484927,-61.142122701210646,-63551535.35731505,-3627157.7840442876,72.0,8.0,92.0,12.77499400000005,483.7166646666667,485.15833533333335,488.39168266666667,489.8333533333333,480.4833173333334,479.04164666666674,475.8082993333334,-0.07486730532375854,402589784.0,-1
2017-08-10,484.950012,493.75,484.674988,484.674988,456.794159,9140684.0,492.3849946,489.93363047272726,-12.350006000000064,41.04701039774028,-6.355473502166216,7.1720393329259196,-33.32985739404016,171659809.61903983,4340431.643368633,68.0,4.0,88.0,12.64999400000005,487.699992,490.72499600000003,496.7750040000001,499.80000800000005,481.649984,478.62498,472.574972,0.0,411730468.0,+1
2017-08-11,488.0,498.5,484.799988,490.625,459.796814,6544156.0,492.89499520000004,489.61363145454544,5.100005999999951,51.044882587853955,-4.910769868970198,5.806171077210422,-7.5760804646282525,87895865.55555555,8138405.9121044045,64.0,0.0,84.0,8.649993999999936,491.30832933333335,497.8166706666667,505.0083413333334,511.5166826666667,484.1166586666667,477.60831733333333,470.4166466666667,0.4251829852411814,418274624.0,+1
2017-08-14,494.0,494.60000599999995,488.575012,493.85000599999995,456.88729900000004,3816470.0,492.41249700000003,489.78726978181817,-4.824982000000034,55.73928938722098,-4.1277163414682585,4.300598544301579,-1.0547210656041834,-13623045.571408028,7149249.026490202,60.0,0.0,64.0,9.14999400000005,492.3416746666666,496.1083373333332,498.36666866666656,502.13333133333316,490.0833433333333,486.3166806666667,484.05834933333335,0.8755185482342376,422091094.0,+1
2017-08-16,491.0,493.049988,484.5,490.72500599999995,453.977753,6178080.0,490.924997,489.4804532363636,-14.875,50.34194626705414,-4.8864877277675705,3.9097918178754867,-25.555870907073366,-55114638.18675763,4319072.334978934,56.00000000000001,80.0,64.0,14.35000599999995,489.42499799999996,494.3499959999999,497.97498599999994,502.8999839999999,485.80000799999993,480.87501,477.25001999999995,0.7280718990482749,415913014.0,-1
2017-08-17,502.5,514.625,499.02499400000005,487.60000599999995,475.22885099999996,25784260.0,489.4074982000001,488.8759094181818,-15.174988000000099,45.2825637652808,-6.502254195488734,2.275114279998718,80.24138063844926,-93290320.81964076,-117718.26295832757,52.0,76.0,64.0,4.675017999999966,500.4166666666667,501.8083393333333,516.0166726666666,517.4083453333333,486.20833333333337,484.81666066666673,470.6083273333334,-0.7323707439599789,390128754.0,-1
2017-08-18,508.950012,508.950012,442.10000599999995,510.424988,429.793854,164404960.0,490.7824982000001,492.69727119999993,13.75,70.37473007708502,-1.0105292030075224,0.6969330743241358,-58.231519404343175,-172675270.74989802,-7961243.376001048,96.0,72.0,64.0,11.825012000000015,487.1583353333333,532.2166646666667,554.0083413333334,599.0666706666667,465.3666586666666,420.30832933333323,398.5166526666665,1.0220639621184173,554533714.0,+1
2017-08-21,462.0,462.0,435.0,461.625,406.587585,90407176.0,487.74499820000005,487.3959078909091,-30.375,33.01995716043602,-12.75187969924812,-1.946495972162893,-394.75948113876984,11743935.191822585,-7065553.441099973,92.0,96.0,64.0,13.825012000000015,452.875,470.75,479.875,497.75,443.75,425.875,416.75,0.9861111111111112,464126538.0,-1
2017-08-22,447.60000599999995,448.52499400000005,430.0,436.700012,407.518616,49242598.0,482.22749940000006,478.11500130909087,-55.174987999999985,25.15195796971321,-18.748869293233078,-4.480149913954222,-406.4990781824438,-8887668.20886533,-7148376.839634763,88.0,96.0,60.0,6.024993999999936,438.40833533333335,446.8166706666667,456.9333293333334,465.34166466666676,428.29167666666666,419.8833413333333,409.7666826666666,0.361674179219707,414883940.0,-1
2017-08-23,440.0,451.85000599999995,436.950012,437.700012,415.61868300000003,61284190.0,477.58500060000006,470.01909450909096,-46.424987999999985,25.968572073051476,-18.50826778947368,-6.773340180290347,-272.860612174971,10716970.982746363,-6336315.574981076,84.0,96.0,-23.999999999999993,9.35000599999995,442.16667666666666,447.3833413333333,457.0666706666666,462.28333533333324,432.48334733333337,427.2666826666667,417.58335333333343,0.05033559073916427,476168130.0,+1
2017-08-24,455.0,459.125,451.174988,446.39999400000005,424.62655599999994,42380524.0,474.0325012000001,464.34909330909085,-35.524993999999936,33.27630673625045,-16.415039037593974,-8.71233536616694,-160.54003066881546,-3182607.2715363083,-6192965.197551769,80.0,92.0,-24.0,23.89999400000005,452.23332733333336,453.29166666666674,460.1833393333334,461.24167866666676,445.3416546666667,444.28331533333335,437.3916426666667,-0.6006272694934205,518548654.0,+1
2017-08-28,471.97500599999995,476.97500599999995,469.0,456.075012,438.05691500000006,40712108.0,471.1725036,461.08409527272727,-28.59997599999997,40.77756684045336,-14.087215157894734,-9.487359182031184,-65.82507816330106,9329041.478194857,-5487419.439563286,76.0,88.0,24.0,66.85000600000006,467.35000599999995,465.7000119999999,475.3250119999999,473.67501799999985,457.72500599999995,459.375,449.75,-1.6206869311446368,559260762.0,+1
2017-08-29,470.72500599999995,471.0,462.77499400000005,470.5,431.749054,13369392.0,469.16000360000004,460.9618218909091,-20.125,50.375206598454525,-10.61654135338346,-9.884117589695734,-53.93679991085295,-2335360.0514314743,-5344144.012830021,72.0,84.0,-4.0,75.42498799999998,468.0916646666667,473.40833533333335,476.31667066666665,481.6333413333333,465.1833293333334,459.86665866666675,456.95832333333345,0.9392097707892246,572630154.0,+1
2017-08-30,468.60000599999995,469.5,462.049988,463.72500599999995,431.37664800000005,16149664.0,466.14750360000005,459.97364050909096,-30.125,46.30817776516118,-12.246615097744373,-11.245163689727804,-56.700451469986774,10139356.390958777,-4640348.53993053,68.0,80.0,-8.0,31.625,465.09166466666665,468.1333413333333,472.5416766666667,475.5833533333333,460.6833293333333,457.64165266666663,453.2333173333333,0.22483426872332052,556480490.0,-1
2017-08-31,464.39999400000005,464.47500599999995,456.450012,463.325012,425.93002300000006,15022452.0,463.40750420000006,459.4604602181819,-27.399993999999936,46.05488163760968,-12.342854255639093,-13.283418274977748,-61.87126848189595,-1263568.8666202887,-4486858.554780064,64.0,76.0,-12.0,15.149993999999936,461.41667666666666,466.3833413333333,469.4416706666666,474.40833533333324,458.35834733333337,453.3916826666667,450.33335333333343,0.8566984598368615,541458038.0,-1
2017-09-01,457.97500599999995,462.950012,455.0,457.47500599999995,428.257629,8433922.0,460.3950042,458.38182418181816,-30.125,42.16305348600902,-13.750374496240614,-15.83949442459675,-63.26675711917206,5295107.469019459,-4042223.735516449,60.0,72.0,-12.0,21.424987999999985,458.47500599999995,461.9500119999999,466.4250179999999,469.9000239999999,453.9999999999999,450.52499399999994,446.04998799999987,0.31132103951540524,533024116.0,-1
2017-09-04,460.5,460.549988,446.75,459.97500599999995,419.06356800000003,10177108.0,455.350006,458.3054608727273,-50.449982000000034,44.47663787324351,-13.148870736842117,-18.089328379680182,-63.05750841086924,2392873.94426175,-3749719.2955265306,56.00000000000001,68.0,-12.0,30.5750119999999,455.7583313333333,464.76666266666655,469.5583193333332,478.56665066666653,450.96667466666656,441.9583433333333,437.1666866666666,0.9583346014503755,543201224.0,+1
2017-09-05,451.0,452.5,448.625,450.10000599999995,419.85495,9783392.0,454.1975066,457.3509154181817,-11.52499400000005,37.618229479578204,-15.52481058646618,-20.426603855715825,-70.73867633646964,-17626542.669581093,-4380483.994347192,52.0,64.0,-12.0,14.924987999999985,450.4083353333333,452.1916706666666,454.2833353333333,456.0666706666666,448.3166706666666,446.5333353333333,444.4416706666666,0.38064670967740666,533417832.0,-1
2017-09-06,450.0,450.14999400000005,445.0,450.950012,416.92215,7735910.0,455.6225066,456.7604618545455,14.25,38.55921073406946,-15.32029786466165,-27.04896280654532,-64.81560274786727,-869565.8893301153,-4220896.807755507,48.0,60.0,-12.0,8.450012000000015,448.70000200000004,452.4000040000001,453.84999600000015,457.54999800000013,447.25001000000003,443.550008,442.100016,1.155343481953563,541153742.0,+1
2017-09-07,450.0,450.25,446.174988,447.799988,416.991974,6241192.0,456.63250419999997,455.33818574545455,10.09997599999997,36.222820829971724,-16.078198375939852,-26.610228639652064,-57.850395078557156,-9771200.446380744,-4473183.336783927,44.0,56.00000000000001,-12.0,8.024993999999936,448.074992,449.97499600000003,452.1500040000001,454.05000800000005,445.899984,443.99998,441.824972,0.39877183183754894,534912550.0,-1
2017-09-08,449.5,449.5,441.049988,447.875,411.66171299999996,8604542.0,456.78000480000003,453.74591225454543,1.4750059999999507,36.32882546021568,-14.8981608030786,-22.220530041686686,-55.96074609606666,-13203682.798272215,-4870024.221397031,40.0,52.0,-12.0,8.325012000000015,446.14166266666666,451.23333733333334,454.5916746666667,459.68334933333335,442.7833253333333,437.69165066666665,434.3333133333333,0.8076925807916016,543517092.0,+1
2017-09-11,445.200012,445.89999400000005,436.825012,442.14999400000005,409.05484,13787642.0,455.38750300000004,451.0859102909091,-13.925017999999966,31.69030892056493,-9.213575354768274,-18.01218447053253,-59.91157415688857,-5588871.111198956,-4902699.080024391,36.0,48.0,-11.999999999999993,13.799987999999985,441.62500000000006,446.4249880000001,450.6999820000001,455.49997000000013,437.35000600000006,432.550018,428.27502400000003,0.5867760398863616,529729450.0,-1
2017-09-12,441.27499400000005,443.875,439.39999400000005,439.35000599999995,411.54534900000004,17241354.0,452.27250360000005,448.17000174545456,-31.14999400000005,29.56037640757222,-9.954361902966676,-15.239635822984042,-57.855045228639355,-627489.4879872293,-4708371.37129543,32.0,44.0,-12.0,11.35000599999995,440.875,442.35000599999995,445.35000599999995,446.8250119999999,437.875,436.39999400000005,433.39999400000005,-0.011170487816127858,512488096.0,-1
2017-09-13,442.75,443.799988,440.5,442.02499400000005,411.405731,11478228.0,450.1025024,446.30681818181813,-21.7000119999999,34.41918462227311,-9.246646324545573,-13.935759688294468,-51.72423972704321,30190.853228356435,-4492982.179271621,28.000000000000004,40.0,-12.0,5.149994000000049,442.10832733333336,443.7166546666667,445.40831533333335,447.0166426666667,440.41666666666674,438.8083393333334,437.11667866666676,0.4621210743796815,523966324.0,+1
2017-09-14,442.25,448.299988,440.799988,441.875,415.432526,13698006.0,447.9575012000001,444.8109086545454,-21.450012000000015,34.26625930749245,-9.286329900871793,-14.692415449996815,-43.32094878601271,2311036.544348629,-4183708.600925246,24.0,36.0,-12.000000000000007,4.77502400000003,443.6583253333333,446.51666266666666,451.1583253333333,454.01666266666666,439.01666266666666,436.1583253333333,431.51666266666666,0.14333493333333536,510268318.0,-1
2017-09-15,446.14999400000005,456.625,446.10000599999995,446.200012,422.81103499999995,13459460.0,446.8300018,444.4913651636364,-11.274993999999936,42.731782563223916,-8.142071171764183,-15.037352462370507,-13.271682027725129,16496396.058511976,-3243703.8436780986,20.0,32.0,-12.0,8.450012000000015,449.64167266666664,453.1833393333333,460.1666666666667,463.70833333333337,442.6583453333333,439.1166786666666,432.1333513333332,0.009501763136403114,523727778.0,+1
2017-09-18,455.0,458.875,453.14999400000005,454.125,423.206726,8475860.0,446.24500120000005,445.8177284727272,-5.850005999999951,54.987922723789794,-4.536290322580645,-15.374314180894032,16.360424266040457,3925450.164933641,-2917833.2069230196,16.0,28.000000000000004,-12.0,11.049987999999985,455.3833313333334,457.6166686666667,461.1083373333334,463.3416746666667,451.8916626666668,449.65832533333344,446.1666566666668,0.17030654640361234,532203638.0,+1
2017-09-19,454.0,458.0,451.75,454.549988,424.673096,6033330.0,446.68999940000003,447.3277260727273,4.449982000000034,55.57619952793743,-4.035090958164647,-14.788971563956352,13.96707578936173,-6269358.318566124,-3070175.257452252,12.0,24.0,-12.0,4.475005999999951,454.76666266666666,457.7833253333333,461.01666266666666,464.0333253333333,451.5333253333333,448.51666266666666,445.2833253333333,0.4479980799999976,538236968.0,+1
2017-09-20,458.5,458.5,453.72500599999995,456.125,424.882599,5767830.0,447.20749820000003,449.0431807272727,5.174987999999985,57.92748955533458,-2.284699599950195,-14.170199775179356,16.796344133005086,4125101.9063853603,-2743117.204550542,8.0,20.0,-11.999999999999996,4.449982000000034,456.1166686666666,458.5083313333333,460.8916626666666,463.2833253333333,453.7333373333332,451.34167466666656,448.9583433333332,0.5026171760634724,544004798.0,+1
2017-09-21,457.5,457.625,454.075012,456.35000599999995,423.416199,8204152.0,448.06250000000006,450.7054548727273,8.550017999999966,58.291383156397906,-1.8134375003125605,-11.970032882356122,14.01259560031214,2557442.6031762143,-2502182.667835689,4.0,16.0,-12.0,7.5,456.01667266666664,457.95833333333326,459.5666606666666,461.50832133333324,454.4083453333333,452.46668466666665,450.8583573333333,0.6408455465201418,552208950.0,+1
2017-09-22,454.075012,455.125,444.0,454.77499400000005,418.179077,17604088.0,448.75249940000003,451.92590832727274,6.899994000000049,54.485179251446894,-1.5972878417022478,-10.037221355343604,-9.020108623908351,-4163720.2446867805,-2577707.1031471025,0.0,12.0,-12.0,14.75,451.299998,458.59999600000003,462.42499799999996,469.72499600000003,447.47499600000003,440.174998,436.34999600000003,0.9685387865168583,534604862.0,-1
2017-09-25,450.5,450.97500599999995,444.549988,449.14999400000005,416.805786,9088700.0,449.4524994,451.99818007272734,7.0,42.93296701244612,-2.702328864188941,-7.9245386482014055,-21.783901872320666,-6564931.713466752,-2758944.58543436,0.0,8.0,-12.000000000000004,12.674987999999985,448.224996,451.90000399999997,454.65001399999994,458.32502199999993,445.474986,441.799978,439.04996800000004,0.7159522354645682,525516162.0,-1
2017-09-26,448.5,454.200012,447.14999400000005,447.674988,421.717041,7366478.0,450.2849976,451.6749961818182,8.324982000000034,40.34479321591846,-3.1121950677318555,-4.332566519937757,-9.366534003537085,2752839.9045547494,-2508408.9267984913,16.0,4.0,-12.0,6.25,449.674998,452.200002,456.7250159999999,459.25001999999995,445.149984,442.62498000000005,438.09996600000005,0.07446704391392166,518149684.0,-1
2017-09-27,453.049988,453.950012,447.549988,452.950012,418.87737999999996,6000138.0,451.37749940000003,452.1595442545455,10.925017999999966,52.228457127902715,-1.6464016672455672,-2.720794597332315,7.075942531847639,-6874640.198708902,-2706873.984612601,12.0,0.0,-12.0,4.774994000000049,451.48333733333334,455.4166866666667,457.88336133333337,461.8167106666667,449.01666266666666,445.0833133333333,442.61663866666663,0.8437505859353035,524149822.0,+1
2017-09-28,448.049988,451.950012,447.14999400000005,449.89999400000005,417.10836800000004,17537266.0,452.1799988,451.8909069090909,8.02499400000005,46.101523793038346,-2.493923167766572,-2.2391156037672886,-1.9737030459339056,-9429387.015386634,-3012442.758738694,8.0,48.0,-12.0,3.549987999999985,449.66666666666674,452.18333933333344,454.4666846666667,456.9833573333334,447.38332133333347,444.8666486666668,442.5833033333335,0.5729145182372274,506612556.0,-1
2017-09-29,449.0,451.200012,447.5,448.0,418.92392,5705832.0,452.3599976,451.13090712727274,1.7999879999999848,42.51650642807193,-3.021882598124349,-2.0330772552617304,-5.230321570465154,-630858.5445375858,-2904188.930820462,4.0,44.0,-12.0,12.35000599999995,448.900004,450.30000800000005,452.6000160000001,454.00002000000006,446.59999600000003,445.199992,442.899984,0.13513469686044205,500906724.0,-1
2017-10-03,455.049988,456.0,450.799988,449.950012,420.62307699999997,4947522.0,451.9424988,450.6927279272728,-4.174987999999985,47.363740209719914,-2.4800244529350426,-1.1423808974294616,38.2487960039645,-14904535.905440459,-3449659.2478486444,0.0,40.0,-8.0,10.225006000000064,452.25,453.700012,457.450012,458.90002400000003,448.5,447.049988,443.299988,-0.16345654586950323,505854246.0,+1
2017-10-04,451.5,452.700012,448.575012,451.77499400000005,418.784241,4991492.0,451.66499939999994,450.662272509091,-2.7749939999999356,51.75669813617745,-1.9729089267106499,-0.1105463901984649,28.56305948988623,2931441.318009482,-3159609.22212782,0.0,36.0,12.0,7.050017999999966,451.0166726666667,453.45833333333337,455.14167266666664,457.58333333333337,449.33333333333337,446.8916726666667,445.20833333333337,0.7757532121212204,510845738.0,+1
2017-10-05,450.0,452.47500599999995,449.5,449.799988,420.39028899999994,8611300.0,451.03249819999996,450.3231795272727,-6.325012000000015,46.871943799645045,-2.5217122612018104,0.7313941618810418,26.568812022251247,5209997.9309657505,-2779172.5333508393,0.0,32.0,12.0,6.40002400000003,450.59166466666665,451.6833293333333,453.5666706666666,454.65833533333324,448.70832333333334,447.6166586666667,445.7333173333334,0.1008360991540823,502234438.0,-1
2017-10-06,452.0,461.0,451.97500599999995,451.52499400000005,428.350769,8574308.0,450.54999699999996,450.41272421818184,-4.8250119999999015,51.48629557654398,-2.617404972375677,1.1452000978679848,149.16577100265124,-7784149.30402427,-3006671.4774723593,0.0,28.000000000000004,-40.0,5.800017999999966,454.8333333333333,457.6916606666667,463.8583273333333,466.7166546666667,448.66666666666663,445.80833933333327,439.6416726666666,-0.04986285863457627,510808746.0,+1
2017-10-09,460.0,464.5,457.0,460.075012,430.096466,3504832.0,451.0799988,452.14454512727275,5.300017999999966,67.58663963484092,-1.210667031463744,1.526710460551726,278.8280884720738,-9469975.157777816,-3300458.0083953347,0.0,24.0,-40.0,3.700012000000015,460.525004,464.05000800000005,468.0250040000001,471.55000800000005,456.55000800000005,453.025004,449.05000800000005,0.410001600000002,514313578.0,+1
2017-10-10,469.97500599999995,469.97500599999995,464.77499400000005,461.950012,435.47323600000004,7143220.0,452.36000060000003,454.1209111636364,12.800017999999966,70.09770165302196,-2.1632168933774305,1.559948537901107,325.88471192512503,9015598.505260907,-2740637.257774596,96.0,20.0,-40.0,8.0,465.56667066666665,466.35834733333326,470.76668266666655,471.55835933333316,461.15833533333335,460.36665866666675,455.95832333333345,-0.5432645155434425,521456798.0,+1
2017-10-11,467.72500599999995,469.0,464.0,467.72500599999995,433.262054,5982504.0,454.36500240000004,456.9145485090909,20.050017999999966,76.55302934580358,-0.606509862823481,2.1185810072487357,257.78703461276757,8257648.355965414,-2240715.184422777,96.0,16.0,-36.0,4.125,466.9083353333333,469.8166706666666,471.9083353333333,474.8166706666666,464.8166706666666,461.9083353333333,459.8166706666666,0.7450011999999901,527439302.0,+1
2017-10-12,465.0,467.174988,459.77499400000005,465.35000599999995,431.67922999999996,10280972.0,455.6050018,458.91182189090904,12.399993999999936,69.43957185117148,-1.246714718026044,2.839379212228323,154.3926000752785,-1364304.5378962175,-2200878.3368533878,92.0,12.0,-32.0,2.9750059999999507,464.099996,468.4249979999999,471.49998999999985,475.82499199999984,461.02500399999997,456.70000200000004,453.62501000000003,0.7533806108491372,517158330.0,-1
2017-10-13,466.39999400000005,466.75,463.77499400000005,463.64999400000005,432.982666,7180728.0,456.9800018,460.37454774545455,13.75,64.49021821378214,-1.704969849100805,3.8679528254836555,132.28773476307865,-10668752.500239799,-2585781.707916407,88.0,8.0,-28.000000000000004,11.200012000000015,464.7249960000001,465.67499800000013,467.7000020000001,468.6500040000001,462.6999920000002,461.74999000000014,459.72498600000023,-0.04201672198308241,509977602.0,-1
2017-10-16,467.97500599999995,471.0,466.5,465.049988,437.125854,5758750.0,458.6850006,461.8418179636363,17.049987999999985,66.74264776109183,-1.5994655913978535,4.089596920298561,141.87299033771959,6235128.810930806,-2184831.229786988,84.0,4.0,-24.0,12.97500599999995,467.51666266666666,468.5333253333333,472.01666266666666,473.0333253333333,464.0333253333333,463.01666266666666,459.5333253333333,-0.3222248888888923,515736352.0,+1
2017-10-17,468.39999400000005,468.39999400000005,464.75,469.5,433.168915,5625102.0,460.6399994,463.8081814909091,19.549987999999985,73.01943217278139,-0.4032258064516129,4.915978751030991,122.43241497147649,-3300165.0087479404,-2235528.2197397584,96.0,0.0,76.0,9.899993999999936,467.549998,470.34999600000003,471.19999200000007,473.9999900000001,466.700002,463.90000399999997,463.05000799999993,1.3013720022553286,521361454.0,+1
2017-10-18,464.450012,465.0,461.47500599999995,465.25,430.305908,7231852.0,461.98750000000007,464.64636341818186,13.47500599999995,60.447463781913356,-1.5456989247311828,5.655268240248404,68.86104019062454,-61277013.34741296,-4919232.089179452,92.0,0.0,80.0,7.049987999999985,463.9083353333333,466.34166466666665,467.43332933333335,469.8666586666667,462.8166706666666,460.38334133333325,459.29167666666655,1.070922106534081,514129602.0,-1
2017-10-19,465.0,466.0,462.60000599999995,462.174988,431.51632699999993,1091434.0,463.22499999999997,464.6804521454545,12.375,52.85081100082553,-2.3723150537634448,5.978258880934391,58.25738643945695,-4355850.454536836,-4893623.833059333,88.0,0.0,80.0,7.9500119999999015,463.59166466666665,464.58332333333334,466.99165866666675,467.9833173333334,461.1833293333333,460.1916706666666,457.78333533333324,-0.12500551471560237,513038168.0,-1
2017-10-23,465.0,471.0,464.049988,463.47500599999995,437.358612,9154096.0,464.42000119999994,464.7259077818182,11.950011999999901,55.574319525721975,-2.0228478494623787,6.329712713037907,73.43364779812335,-2860709.7877948745,-4801218.649183677,84.0,0.0,80.0,2.9750059999999507,466.17499799999996,468.30000799999993,473.12501,475.25001999999995,461.3499959999999,459.22498599999994,454.3999839999999,-0.08273108017655693,522192264.0,+1
2017-10-24,473.0,473.325012,460.799988,469.75,431.306824,14529328.0,465.3875,465.6949984727272,9.674987999999985,66.38775868297222,-0.9550556028567001,7.20180454366124,76.2753601533672,38028006.37605754,-2854435.6934908926,80.0,20.0,80.0,7.350005999999951,467.9583333333333,475.11667866666664,480.4833573333333,487.6417026666667,462.5916546666666,455.4333093333333,450.0666306666666,0.71457044713048,536721592.0,+1
2017-10-25,459.5,472.35000599999995,457.625,463.25,435.40338099999997,13984134.0,465.5174988,465.3063621090909,1.2999879999999848,51.42659241960748,-2.6915145066501767,8.076581293923311,38.03912426927802,-8311187.669718939,-3102469.8742285315,96.0,16.0,96.0,3.6499940000000493,464.4083353333333,471.1916706666666,479.1333413333332,485.91667666666655,456.46666466666665,449.68332933333335,441.7416586666667,0.3820032399307694,522737458.0,-1
2017-10-26,471.0,475.89999400000005,470.049988,467.64999400000005,441.01297,33659258.0,465.5099976000001,465.69408850909093,-0.07501199999990149,58.696813753006886,-2.1889095599189634,8.464779713069277,80.83710082141775,6326267.555448154,-2673890.900152318,92.0,12.0,92.0,8.02499400000005,471.19999200000007,472.34999600000015,477.0499980000002,478.2000020000002,466.4999900000001,465.349986,460.649984,-0.4102549638410472,556396716.0,+1
2017-10-27,477.5,478.85000599999995,472.0,473.674988,440.54742400000003,8524956.0,466.34249580000005,467.17863221818175,8.324982000000034,66.59625924458408,-1.3623846039902303,8.82507980752348,92.67807726344333,-299922.1862472007,-2565983.2313384493,96.0,8.0,88.0,3.3999940000000493,474.84166466666665,477.6833293333333,481.6916706666666,484.53333533333324,470.83332333333334,467.9916586666667,463.9833173333334,0.24452358143919828,564921672.0,+1
2017-10-30,477.325012,477.325012,470.52499400000005,473.174988,439.5,12968326.0,467.2949952000001,468.42090352727274,9.524993999999936,65.3985742086038,-1.4940155088479758,8.506709486464217,71.52976402722501,-1784562.2779496817,-2530464.0970935053,96.0,4.0,84.0,8.825012000000015,473.674998,476.825002,480.4750159999999,483.62501999999995,470.024984,466.87498000000005,463.22496600000005,0.3897039684306643,551953346.0,-1
2017-10-31,462.5,465.0,460.0,472.049988,441.29513499999996,9954988.0,467.99499520000006,469.2854476727273,7.0,62.48132555745939,-1.7901850447779029,8.506822630526074,12.239879274880762,-11199042.898026716,-2924490.406226833,92.0,0.0,60.0,12.52502400000003,465.68332933333335,471.3666586666667,470.6833293333334,476.3666586666667,466.3666586666667,460.68332933333335,461.3666586666667,2.409997599999997,541998358.0,-1
2017-11-01,462.5,464.700012,461.64999400000005,460.924988,443.784424,5633134.0,467.13749400000006,467.99999181818185,-8.575012000000015,41.406335826252096,-4.718972677862737,8.385908958118648,-14.153847424665571,617465.7699675722,-2763492.398217996,88.0,0.0,80.0,14.72500599999995,462.424998,463.200002,465.4750159999999,466.25001999999995,460.149984,459.37498000000005,457.09996600000005,-0.2377054823938982,536365224.0,-1
2017-11-02,461.52499400000005,463.0,460.0,463.52499400000005,441.797821,4686138.0,466.9649934,467.3431736363636,-1.7250059999999507,46.29153334697712,-4.034490393031586,7.779860836896717,-22.154205190243463,-2129464.824241835,-2734672.9630372613,84.0,0.0,80.0,12.64999400000005,462.174998,464.34999600000003,465.17499799999996,467.34999600000003,461.34999600000003,459.174998,458.34999600000003,1.1749980000000164,541051362.0,+1
2017-11-03,458.5,464.950012,458.47500599999995,461.450012,443.592957,3699086.0,466.8924958,466.3404497454545,-0.7249759999999696,42.99090977874374,-4.580753909478664,6.3696835158092995,-33.15397578465467,-2456678.7884333655,-2722036.8641916295,80.0,4.0,88.0,11.200011999999901,461.62501,464.775014,468.10001600000004,471.25002000000006,458.30000799999993,455.1500039999999,451.82500199999987,0.45945996034598807,537352276.0,-1
2017-11-06,461.575012,467.5,461.325012,463.325012,444.57428,5066534.0,466.87749640000004,465.6918163272727,-0.14999399999993557,46.9357659621065,-4.087138016262118,5.857818047795831,-17.133357499832012,1339816.4977369087,-2537407.1659221505,76.0,0.0,92.0,6.800017999999966,464.050008,466.77500399999997,470.2249959999999,472.94999199999995,460.600016,457.87502,454.425028,0.32388726909266946,542418810.0,+1
2017-11-07,463.125,480.0,462.924988,464.35000599999995,457.403595,13442820.0,466.3374970000001,465.2322726181818,-5.399994000000049,49.15500082830598,-4.107609973753293,5.5998201574701625,27.49313988861474,2866884.6571819745,-2291757.537599236,72.0,0.0,92.0,13.174987999999985,469.09166466666665,475.2583413333333,486.1666766666667,492.3333533333333,458.1833293333333,452.01665266666663,441.1083173333333,0.08345633959144302,555861630.0,+1
2017-11-08,480.125,480.924988,473.75,477.75,455.87176500000004,5369994.0,467.78749700000003,467.30727316363635,14.5,68.82318595155814,-0.8313119329076172,5.397937690501465,116.14288753098823,156040.67458128594,-2180493.982500121,96.0,4.0,88.0,10.399993999999936,477.474996,481.19999199999995,484.6499839999999,488.37497999999994,474.02500399999997,470.300008,466.850016,0.5574922215897794,561231624.0,+1
2017-11-09,476.5,481.5,474.125,476.14999400000005,456.924896,4723232.0,468.63749700000005,468.82772716363644,8.5,65.34088752919584,-1.3986943790849544,4.424584352721922,103.55971171974056,-13503175.327508125,-2695161.3163641216,96.0,0.0,84.0,3.0,477.2583313333334,480.3916626666668,484.63333133333344,487.7666626666668,473.0166626666668,469.8833313333334,465.6416626666668,0.2745754576271253,556508392.0,-1
2017-11-10,479.39999400000005,482.174988,475.0,477.25,460.539124,6589428.0,468.99499819999994,470.39363679999997,3.575012000000015,66.67834246895761,-1.2853104075780606,4.492977635893624,101.32756123518054,10354226.652851116,-2102007.3177634287,96.0,0.0,76.0,6.475006000000064,478.14166266666666,481.2833253333333,485.31665066666665,488.4583133333333,474.10833733333334,470.9666746666667,466.93334933333335,0.31358937464425096,563097820.0,+1
2017-11-13,481.02499400000005,484.700012,474.674988,481.02499400000005,455.704193,5021216.0,469.7799988,472.58090876363644,7.850006000000064,71.09508900026697,-0.9528177043458236,3.9669221423251884,111.65244787970735,5620027.590440646,-1751005.7310268795,96.0,0.0,76.0,6.174987999999985,480.1333313333334,485.5916746666668,490.1583553333335,495.6166986666668,475.56665066666676,470.10830733333336,465.54162666666673,0.6334155409503304,568119036.0,+1
2017-11-14,475.97500599999995,477.424988,471.625,475.97500599999995,454.339874,5733710.0,470.1725006,473.70727370909094,3.925017999999966,59.01984461357242,-2.2621223045230456,2.5762551031995145,55.59191820743801,-4896127.582737202,-1893965.8151955304,96.0,0.0,72.0,17.075012000000015,475.0083313333333,478.39166266666655,480.8083193333332,484.19165066666653,472.59167466666656,469.2083433333333,466.7916866666666,0.7500025862122408,562385326.0,-1
2017-11-15,472.575012,476.75,472.25,474.549988,455.63238499999994,7023516.0,471.53500060000005,474.5031805090909,13.625,55.92701579069254,-2.6315850879465437,1.6890389184630976,46.96708847236053,-1452510.4466995096,-1873899.662082075,92.0,40.0,92.0,16.574982000000034,474.51666266666666,476.7833253333333,479.01666266666666,481.2833253333333,472.2833253333333,470.01666266666666,467.7833253333333,0.511108444444441,555361810.0,-1
2017-11-16,475.89999400000005,497.950012,474.25,475.89999400000005,473.153046,15687502.0,472.77250060000006,475.2968156727273,12.375,58.31484103637222,-5.5270127426390365,1.0645280570255409,124.4931387038567,-14418436.954224065,-2444105.902633984,88.0,36.0,96.0,7.375,482.70000200000004,491.1500040000001,506.40001400000006,514.8500160000001,467.44999200000007,458.99999,443.74998000000005,0.06961996474938698,571049312.0,+1
2017-11-17,492.75,492.75,482.575012,494.200012,464.799622,8057670.0,476.04750060000003,479.1927268363636,32.75,77.43589718038879,-0.9399673861897264,2.8413075107555983,186.4267133851152,-17276221.258739065,-3118292.964275125,96.0,32.0,96.0,7.174987999999985,489.8416746666667,497.10833733333334,500.01666266666666,507.2833253333333,486.93334933333335,479.6666866666667,476.75836133333337,1.142507489935125,579106982.0,+1
2017-11-20,484.5,485.5,478.625,485.47500599999995,459.821045,5661190.0,478.2625,480.90681872727276,22.149993999999936,61.83278167690073,-3.1269596753389903,4.072123225018515,100.3663583003425,8577484.530959263,-2586666.714491743,92.0,28.000000000000004,96.0,10.02502400000003,483.200002,487.77500399999997,490.07500200000004,494.65000399999997,480.90000399999997,476.325002,474.02500399999997,0.9963645090909019,573445792.0,-1
2017-11-21,480.64999400000005,485.75,480.02499400000005,480.27499400000005,462.549713,5364656.0,479.85499880000003,481.27272672727275,15.924988000000099,54.30761326397386,-4.430384125417689,5.5075378372192745,75.51996784781936,4045954.1582383863,-2285183.947549464,88.0,24.0,96.0,9.39999400000005,482.0166626666667,484.0083313333334,487.7416686666666,489.73333733333334,478.28332533333344,476.29165666666677,472.5583193333335,0.04366807650507303,568081136.0,-1
2017-11-22,483.299988,485.52499400000005,481.64999400000005,483.125,462.57360800000004,6084920.0,480.3924988,481.86727240000005,5.375,57.57296142181963,-3.7160074079656913,7.005373513667507,74.94353766279814,-938917.1547046547,-2223990.0024201544,84.0,20.0,52.0,4.5,483.4333293333334,485.21666466666676,487.30832933333346,489.09166466666676,481.34166466666676,479.5583293333334,477.46666466666676,0.38064670967740666,574166056.0,+1
2017-11-23,485.75,497.22500599999995,484.5,483.14999400000005,474.517334,11894618.0,481.09249880000004,482.3686351636364,7.0,57.603620022100024,-3.7097424626722324,8.812920101345128,102.52480487172346,6219392.043216573,-1840199.9094366666,80.0,16.0,52.0,23.700012000000015,488.2916666666667,492.08333333333337,501.01667266666664,504.8083393333333,479.3583273333334,475.56666066666673,466.63332133333347,-0.10609079477054517,586060674.0,+1
2017-11-24,495.450012,509.64999400000005,495.10000599999995,495.625,483.277649,18619912.0,482.9299988,485.0109081090909,18.375,70.0624805007541,-3.4153157688832323,8.944708139944282,172.45209712488804,1866749.8706693393,-1671702.1921591207,76.0,12.0,64.0,16.85000599999995,500.125,505.14999400000005,514.6749880000002,519.6999820000001,490.60000599999995,485.5750119999999,476.05001799999985,0.03608209161409932,604680586.0,+1
2017-11-27,503.35000599999995,503.35000599999995,496.64999400000005,504.77499400000005,478.10763499999996,6017730.0,485.3049988000001,488.9827254181819,23.75,76.0250692994676,-1.1871423526673666,9.409638989279188,147.83306902473709,-30106342.884955753,-2964185.860013514,96.0,8.0,64.0,15.575012000000015,501.5916646666667,506.53333533333335,508.29167666666655,513.2333473333333,499.83332333333345,494.8916526666668,493.13331133333355,1.2126843951921458,610698316.0,+1
2017-11-28,497.200012,499.950012,490.64999400000005,499.375,471.381836,4616868.0,487.6449982000001,491.54090745454556,23.39999400000005,66.94558168635697,-2.502129343754489,9.776490334074765,94.13169288404306,-4697400.761809358,-3042968.3555496885,92.0,4.0,64.0,5.725005999999951,496.65833533333335,502.66667666666666,505.95835333333326,511.9666946666666,493.3666586666667,487.3583173333334,484.06664066666673,0.9381708723574494,606081448.0,-1
2017-11-29,493.825012,495.97500599999995,490.14999400000005,492.35000599999995,470.424438,3838070.0,489.425,492.39636341818186,17.800017999999966,56.76871338563403,-4.2128304523974,9.916594535782394,62.34841935980989,-6971012.937283855,-3221515.8365376056,88.0,0.0,64.0,5.25,492.825002,495.5000099999999,498.6500139999999,501.3250219999998,489.674998,486.9999900000001,483.8499860000001,0.3776836854584915,602243378.0,-1
2017-11-30,494.72500599999995,494.72500599999995,484.174988,491.35000599999995,467.26492300000007,17266944.0,490.9700012,492.7463645090909,15.450011999999901,55.38580734191224,-4.4563468324317315,10.394895732570319,40.06082345711401,-3447480.5381496227,-3231786.9593381523,84.0,24.0,64.0,14.10000599999995,490.08333333333326,495.99167866666653,500.63335133333317,506.5416966666665,485.44166066666656,479.5333153333333,474.8916426666666,0.6800953325387681,584976434.0,-1
2017-12-01,489.700012,491.60000599999995,478.52499400000005,488.049988,458.983337,4085000.0,490.35499880000003,492.21545301818173,-6.15002400000003,50.6844567915115,-5.259955269839859,11.375319110657756,12.857267711653813,-1196660.7664879018,-3139281.2232995047,80.0,20.0,64.0,26.5,486.05832933333335,493.59166466666665,499.13334133333325,506.66667666666655,480.51665266666674,472.98331733333345,467.44164066666684,0.7284883562630771,580891434.0,-1
2017-12-04,490.0,498.39999400000005,484.27499400000005,479.39999400000005,471.69296299999996,17811606.0,489.7474976,490.22363396363636,-6.0750119999999015,40.330522640796026,-7.366370496038531,12.455703433880444,14.276019845695515,1130964.018857117,-2945179.16683784,76.0,16.0,88.0,7.725005999999951,487.35832733333336,490.4416606666667,501.4833273333334,504.5666606666667,476.3166606666667,473.23332733333336,462.1916606666667,-0.34513274336283184,563079828.0,-1
2017-12-05,492.674988,501.5,489.5,492.674988,471.21426399999996,9976738.0,490.9874970000001,490.7559049454545,12.399993999999936,56.18145972364129,-4.133692012181075,11.341505366626905,48.11941601904256,-4194213.940867847,-3001953.474748295,72.0,12.0,88.0,14.125,494.55832933333335,499.6166586666667,506.5583293333334,511.6166586666667,487.6166586666667,482.55832933333335,475.6166586666667,0.2645823333333321,573056566.0,+1
2017-12-06,492.5,497.049988,492.0,492.174988,474.062561,7490094.0,491.89249580000006,490.9718124,9.049987999999985,55.54025873335251,-4.25545020219824,11.3199209043633,38.04425805971239,1092568.0948047843,-2815838.857950427,68.0,8.0,88.0,9.22500599999995,493.74165866666664,495.4833173333333,498.79164666666657,500.53330533333326,490.4333293333333,488.69167066666665,485.3833413333333,0.034651171448325295,565566472.0,-1
2017-12-07,494.5,501.450012,492.799988,495.14999400000005,478.610291,7549544.0,493.09249580000005,491.5640848,12.0,58.77077605476077,-3.530987510497808,11.452881609961594,49.356236095992756,-2608929.045222185,-2806433.8664627797,64.0,4.0,60.0,10.550017999999966,496.4666646666667,500.1333413333334,505.11668866666673,508.78336533333345,491.4833173333334,487.8166406666667,482.83329333333336,0.2716762404358712,573116016.0,+1
2017-12-08,500.5,503.5,497.5,499.89999400000005,479.591614,5983244.0,493.5199952,492.8018117454546,4.274994000000049,63.63824955003367,-2.374284705334733,11.5569275523265,68.86690168008496,-8599924.422134697,-3069774.3462660485,60.0,0.0,60.0,13.075011999999901,500.299998,503.09999600000003,506.29999799999996,509.09999600000003,497.09999600000003,494.299998,491.09999600000003,0.3999990000000082,579099260.0,+1
2017-12-11,497.47500599999995,503.450012,496.97500599999995,500.924988,481.243164,5139098.0,493.13499459999997,494.14817407272733,-3.8500060000000644,64.67658281113341,-2.124681876897839,11.642959507438377,63.23543717942929,1507235.2003554837,-2861728.457783251,56.00000000000001,0.0,60.0,14.125,500.450002,503.924998,506.9250080000001,510.4000040000001,497.44999199999995,493.9749959999999,490.9749859999999,0.6100352648321862,584238358.0,+1
2017-12-12,501.0,507.0,501.0,502.64999400000005,483.73245199999997,9320434.0,493.462494,495.8781739636364,3.2749940000000493,66.53239414770161,-1.7046146602403212,10.204116088753949,72.41127182309518,6074250.603852297,-2455547.5913452716,52.0,0.0,60.0,22.10000599999995,503.549998,506.09999600000003,509.54999799999996,512.099996,500.09999600000003,497.549998,494.09999600000003,0.2749990000000082,593558792.0,+1
2017-12-13,505.450012,509.5,498.825012,505.25,480.50119000000007,5362398.0,494.75249340000005,498.02135687272727,12.89999400000005,69.33431243816887,-1.0714706110527907,7.540128791162658,67.9168924134004,-2782947.729948767,-2470429.4158272487,48.0,16.0,60.0,5.049987999999985,504.525004,510.22499600000003,515.1999920000001,520.899984,499.55000800000005,493.85001600000004,488.87502000000006,0.6018730887566331,598921190.0,+1
2017-12-14,502.625,507.5,499.64999400000005,501.875,484.97708099999994,6023572.0,495.80499280000004,499.31635807272727,10.52499400000005,61.60890103457118,-1.8933383936686599,6.249694969198458,53.59924154707874,1574703.8513515254,-2286559.7218645774,44.0,12.0,60.0,9.27502400000003,503.0083313333334,506.3666686666667,510.8583373333334,514.2166746666667,498.5166626666668,495.15832533333344,490.6666566666668,0.2834400381349982,592897618.0,-1
2017-12-15,506.5,513.200012,505.924988,506.549988,489.66842699999995,10384134.0,497.6549928000001,501.2699935636364,18.5,67.4122922275717,-1.6055103349441793,5.91129731605605,88.88116652921218,-7484252.363040429,-2522818.478281662,40.0,8.0,60.0,8.35000599999995,508.55832933333335,511.1916706666667,515.8333533333334,518.4666946666667,503.9166466666667,501.2833053333333,496.64162266666665,0.08591036950530986,603281752.0,+1
2017-12-18,505.950012,515.349976,502.89999400000005,511.450012,486.65252699999996,4035448.0,500.8599946000001,503.77817887272727,32.050017999999966,72.44907381576189,-0.9367033084685358,5.941482692661111,95.51086881073346,8296537.64175737,-2031029.5637344327,96.0,4.0,56.00000000000001,6.475006000000064,509.89999400000005,516.8999940000001,522.349976,529.349976,504.45001200000013,497.45001200000013,492.0000300000002,0.6867494266256787,607317200.0,+1
2017-12-19,508.72500599999995,508.97500599999995,499.77499400000005,508.299988,480.596924,7118898.0,502.4224946000001,505.1309049454546,15.625,64.9973227825813,-1.6932841134593906,6.670547728089446,59.46029749363255,2799966.515396281,-1811438.8328648545,96.0,0.0,52.0,6.075012000000015,505.68332933333335,511.59166466666665,514.8833413333332,520.7916766666665,502.39165266666674,496.48331733333345,493.19164066666684,0.9266285739627326,600198302.0,-1
2017-12-20,502.549988,509.299988,500.5,501.97500599999995,486.29351799999995,4186326.0,503.4024964000001,505.0495433818181,9.800017999999966,52.489277811310856,-3.212434435206986,8.278579374379888,40.670516617941765,2446752.4839897286,-1617884.6820987368,92.0,0.0,32.0,10.674987999999985,503.92499799999996,507.3499959999999,512.724986,516.1499839999999,498.55000799999993,495.12501,489.75001999999995,0.16761454674710388,596011976.0,-1
2017-12-21,507.39999400000005,514.474976,499.200012,507.924988,489.261505,11059162.0,504.67999580000003,505.87181458181817,12.774993999999936,60.698583593028296,-1.7833525706748172,8.264833447026206,58.75373118573746,-4319247.657498755,-1740673.908253283,88.0,0.0,32.0,7.850005999999951,507.199992,515.199972,522.474956,530.474936,499.92500800000005,491.92502800000005,484.6500440000001,0.5711945376761606,607071138.0,+1
2017-12-22,508.0,522.400024,508.0,511.02499400000005,497.543091,12906940.0,505.79249580000004,507.0254506181819,11.125,64.39684862154184,-2.686591723008495,8.565301940276129,98.67988050069874,3595957.6143890107,-1498099.7481331786,84.0,40.0,32.0,11.325012000000015,513.8083393333334,519.6166786666668,528.2083633333334,534.0167026666668,505.2166546666667,499.40831533333335,490.8166306666667,0.210068677663318,619978078.0,+1
2017-12-26,515.0,520.75,511.5,519.674988,495.747955,10808906.0,507.6674958,509.54954010909086,18.75,72.67526060203028,-0.6436078992758973,9.927479434301858,108.73722003594182,675595.1355688812,-1399295.4352376305,96.0,36.0,92.0,12.44998199999992,517.3083293333333,523.1166586666666,526.5583293333334,532.3666586666666,513.8666586666666,508.0583293333333,504.6166586666666,0.8837824864864848,630786984.0,+1
2017-12-27,514.0,519.549988,513.700012,517.799988,495.101715,6970172.0,509.1824952,511.3918114181818,15.149993999999936,68.68106796310103,-1.0864515208435712,10.171341880004434,94.75276380552518,4845226.905038737,-1115453.5106796136,92.0,32.0,96.0,11.675017999999966,517.0166626666667,520.3333133333333,522.8666386666666,526.1832893333333,514.4833373333333,511.1666866666667,508.63336133333337,0.7008534735868986,623816812.0,-1
2017-12-28,515.0,520.0,511.89999400000005,517.125,494.623016,8433472.0,510.36999520000006,512.8359032,11.875,67.1481491912686,-1.245872390408752,10.006746429738655,78.82691460129513,9418521.224165997,-636636.4772775399,88.0,28.000000000000004,92.0,8.799987999999985,516.3416646666667,520.7833353333333,524.4416706666666,528.8833413333333,512.6833293333334,508.24165866666675,504.58332333333345,0.6450619913121031,615383340.0,-1
2017-12-29,515.049988,524.400024,515.0,516.625,498.83563200000003,6601768.0,511.8449952000001,513.9731767999999,14.75,65.89116121547153,-1.8276971230260273,9.826658589308636,81.72286833505392,-864768.4422614228,-647006.1120495346,84.0,24.0,88.0,15.274963999999954,518.675008,522.3500160000001,528.0750320000002,531.7500400000001,512.9499920000001,509.274984,503.54996800000004,0.17287189905046996,608781572.0,-1
2018-01-01,518.849976,522.25,515.0,521.025024,494.766632,5431340.0,513.2924988000001,515.6422729454545,14.475036000000046,71.33896960421193,-0.7933709002329533,9.445345931653833,75.11982081119433,-10347952.14713962,-1087958.2045536297,96.0,20.0,44.0,14.475036000000046,519.425008,523.8500160000001,526.6750080000002,531.1000160000001,516.6000160000001,512.175008,509.3500160000001,0.8310377931034525,614212912.0,+1
2018-01-02,518.625,521.0,511.5,516.775024,492.923553,6112248.0,513.825,516.2754593454546,5.325012000000015,60.559045513122115,-1.792430552378154,10.270612704212454,49.1879497315822,-1056970.2302919622,-1086549.6602690085,92.0,16.0,60.0,9.72500599999995,516.425008,521.3500160000001,525.9250080000002,530.8500160000001,511.8500160000001,506.92500800000005,502.3500160000001,0.5552656842105295,608100664.0,-1
2018-01-03,514.25,515.799988,509.299988,514.849976,488.902466,6846552.0,514.4799988000001,516.4618186181818,6.549987999999985,56.126460580717925,-2.2449570900823597,11.069198300655728,27.310662032815607,-2619906.7818906684,-1156247.7112518114,88.0,12.0,60.0,5.97497599999997,513.3166506666666,517.3333133333333,519.8166506666666,523.8333133333333,510.8333133333333,506.81665066666665,504.3333133333333,0.8538443076923053,601254112.0,-1
2018-01-04,510.5,510.5,504.799988,510.64999400000005,486.078125,8947614.0,515.3474976,515.7654541090909,8.674988000000099,47.393685077352224,-3.2322588679496596,10.796918379117301,-3.3968759471014898,-20350846.923155442,-2028729.4936110678,84.0,8.0,60.0,8.10000599999995,508.64999400000005,512.5000000000001,514.3500060000001,518.2000120000001,506.7999880000001,502.94998200000003,501.0999760000001,1.0263146814427844,592306498.0,-1
2018-01-05,507.64999400000005,513.200012,503.0,507.700012,484.4505,11025976.0,515.325,514.3750021818182,-0.22497599999996964,42.086683816457224,-3.925719571656633,10.448836699695505,-11.42381436225338,-5692499.350052901,-2195264.487085697,80.0,4.0,60.0,9.40002400000003,507.9666746666667,512.9333493333334,518.1666866666667,523.1333613333334,502.73333733333334,497.76666266666666,492.5333253333333,0.4607849480961403,581280522.0,-1
2018-01-08,512.450012,519.5,510.02499400000005,506.0,495.96337900000003,5594690.0,514.8225006,512.6795476363637,-5.024994000000049,39.17016588530307,-4.325346253389029,10.906600466890495,9.891486541518825,-439745.1933890477,-2115468.155554031,76.0,0.0,76.0,7.25,511.8416646666667,513.6583353333333,521.3166706666666,523.1333413333333,504.1833293333334,502.36665866666675,494.70832333333345,-0.4248012085691629,575685832.0,-1
2018-01-09,520.0,522.450012,514.450012,518.025024,498.50051900000005,9948236.0,514.6575042000001,513.2618246181819,-1.6499639999999545,61.14574734805536,-1.4985894782178009,10.700096861492568,52.216991565189495,-22731528.130469624,-3052561.7907774677,72.0,0.0,76.0,9.52502400000003,518.3083493333334,522.1666866666667,526.3083493333334,530.1666866666667,514.1666866666667,510.30834933333335,506.1666866666667,0.4468765000000019,585634068.0,+1
2018-07-03,665.950012,678.950012,665.875,667.349976,669.583374,8127452.0,636.5474916000001,643.6990780363635,33.649963999999954,78.67186260493963,-2.000178594702753,10.30429013328785,187.0554331053176,-3403933.520238426,-1587404.649974024,96.0,4.0,72.0,18.02502400000003,670.724996,675.5749920000001,683.8000080000002,688.6500040000001,662.49998,657.649984,649.424968,0.11280876835906292,884271996.0,+1
2018-07-04,676.025024,676.325012,669.424988,676.875,665.35437,5025722.0,642.1549928,651.0313522909091,56.075012000000015,82.01138536936841,-0.35779152634969086,9.200710946126492,176.76039804675327,-7186772.57962811,-1841921.3740492098,96.0,0.0,68.0,13.924987999999985,674.2083333333334,678.9916786666668,681.1083573333333,685.8917026666668,672.0916546666667,667.3083093333333,665.1916306666667,1.0797081285514343,889297718.0,+1
2018-07-09,648.5,651.5,639.525024,642.125,642.429016,6644998.0,650.949988,654.337262690909,18.200012000000015,46.93816545736019,-6.349687255459529,11.516695068445983,18.72062971480977,-13633433.687443744,-2892858.865059986,84.0,0.0,88.0,25.200012000000015,644.3833413333333,649.2416586666666,656.3583173333332,661.2166346666666,637.2666826666666,632.4083653333333,625.2917066666666,0.21711742887835234,867707458.0,+1
2018-07-10,654.25,657.724976,647.150024,649.424988,643.690308,5974488.0,652.2699891999999,654.0599899636363,13.200012000000015,52.67713342741776,-5.090960149855127,12.903314259236481,46.57071266211314,1061572.3925142689,-2713111.9897157014,80.0,0.0,92.0,25.350036000000046,651.4333293333333,655.7166346666666,662.0082813333333,666.2915866666665,645.1416826666666,640.8583773333334,634.5667306666667,0.215127595851023,873681946.0,+1
2018-07-11,658.775024,671.049988,645.674988,650.700012,653.112671,11899832.0,653.4474915999999,653.7745395636363,11.77502400000003,53.68662361878976,-4.871109477621668,15.042062665974072,59.30919534310255,-376539.1328801561,-2606904.132586813,76.0,0.0,96.0,8.975036000000046,655.8083293333333,665.9416706666666,681.1833293333332,691.3166706666666,640.5666706666666,630.4333293333333,615.1916706666666,0.1980305024630554,885581778.0,+1
2018-07-12,663.049988,663.549988,642.224976,660.224976,640.203308,13272240.0,655.9699891999999,655.0068094545454,25.22497599999997,60.87986024728118,-3.2287327549878633,15.34902465047378,48.278659119802775,920517.0888651009,-2446566.8043389986,72.0,20.0,92.0,42.825012000000015,655.3333133333333,668.4416506666666,676.6583253333333,689.7666626666667,647.1166386666666,634.0083013333333,625.7916266666666,0.8440792436599796,898854018.0,+1
2018-07-16,658.700012,692.200012,643.849976,658.700012,659.245911,35344680.0,656.7174928000001,653.860904290909,5.1000360000000455,57.42996418660805,-5.647336365866425,17.277463344142234,73.59569385286986,-1946134.4735022509,-2927473.99616046,64.0,12.0,84.0,11.97497599999997,664.9166666666666,685.9833573333333,713.2667026666668,734.3333933333333,637.6333213333332,616.5666306666666,589.2832853333332,0.30713598641374396,914702540.0,+1
2018-07-17,664.849976,674.75,656.349976,666.424988,656.7976070000001,11161690.0,656.6249940000001,655.6259034181819,-0.9249879999999848,62.306451540645334,-4.345081503471047,18.216146645655158,68.19449648136711,-6195648.142953232,-3076027.3664692226,96.0,8.0,80.0,15.59997599999997,665.8416546666666,675.3333333333333,684.2416786666668,693.7333573333333,656.9333093333332,647.4416306666666,638.5332853333332,0.5475542857987575,925864230.0,+1
2018-07-20,663.0,683.575012,660.650024,658.349976,666.788757,11705738.0,655.8349976,658.7927257454545,16.34997599999997,53.6296978984493,-5.706344456378744,12.421821728750388,52.253909613063364,-3387796.1299203304,-2760465.533289881,84.0,0.0,52.0,16.625,667.525004,674.3999839999999,690.4499919999998,697.3249719999999,651.4749959999999,644.600016,628.5500079999999,-0.10032930006332227,902120612.0,-1
2018-07-23,676.075012,684.0,668.125,674.049988,670.671448,7675702.0,659.0274964,662.1045421818181,31.924987999999985,65.78336194890251,-3.059680315717868,8.692174449010622,79.91059275804201,6640704.305715169,-2333139.6315169237,80.0,12.0,52.0,48.350036000000046,675.3916626666667,682.6583253333333,691.2666626666667,698.5333253333333,666.7833253333333,659.5166626666667,650.9083253333333,0.37322759055118016,909796314.0,+1
2018-07-24,687.200012,691.200012,678.0,677.974976,681.1573490000001,6172246.0,661.8824952000001,665.5495384727272,28.549987999999985,68.18848813928514,-2.398016809210726,10.522185500393107,109.11213852687231,-818624.2788323342,-2264298.0245767147,76.0,8.0,88.0,18.40002400000003,682.3916626666667,686.7833253333333,695.5916746666667,699.9833373333333,673.5833133333333,669.1916506666666,660.3833013333333,-0.001895755852345462,915968560.0,+1
2018-07-25,689.5,696.900024,682.724976,688.575012,684.4217530000001,6936922.0,665.6699952000001,670.4027233454544,37.875,73.90439145837634,-1.3923752577069666,12.400004240983094,139.70977377035038,2880457.1783349416,-2030445.5153534575,72.0,4.0,88.0,14.700012000000015,689.4000040000001,696.0750320000002,703.5750520000001,710.2500800000003,681.8999840000001,675.224956,667.7249360000001,0.41269955487981563,922905482.0,+1
2018-07-26,689.275024,695.200012,684.599976,691.875,679.228333,7362218.0,668.8349976000001,675.1672696727272,31.65002400000003,75.48657713587909,-0.8404455257222117,12.77510224179116,128.5010512176119,-3149287.7981616096,-2081301.9827538282,96.0,0.0,88.0,11.40002400000003,690.5583293333333,696.5166826666666,701.1583653333332,707.1167186666667,685.9166466666666,679.9582933333332,675.3166106666665,0.6863206879674747,930267700.0,+1
2018-07-27,686.599976,694.5,684.150024,686.625,679.327209,6493232.0,672.7799988,678.4018155636364,39.450012000000015,67.92653320278748,-1.7185187468733116,13.062339047955902,96.66378765094323,-5799873.356517743,-2250327.9542885516,92.0,0.0,84.0,22.924987999999985,688.425008,692.6999920000001,698.7749840000001,703.049968,682.3500160000001,678.0750320000001,672.0000400000001,0.23912867044329156,923774468.0,-1
2018-07-30,685.0,686.5,674.0,686.724976,668.223145,6409970.0,675.5824952000002,680.9372659636363,28.024963999999954,67.99695874472611,-1.7017975567099257,12.264561234011126,60.94822959271058,1280712.8876858044,-2089826.0978351717,88.0,0.0,68.0,25.65002400000003,682.4083253333333,690.8166506666666,694.9083253333333,703.3166506666666,678.3166506666666,669.9083253333333,665.8166506666666,1.0179980799999975,930184438.0,+1
2018-07-31,674.275024,685.0,667.775024,675.5,675.1972049999999,7943996.0,676.4899964,680.9222668363636,9.075012000000015,52.93814982969541,-3.5791977155030232,13.15501550694421,34.13685397795204,-7351528.0,-2328994.3661153913,84.0,4.0,68.0,17.15002400000003,676.0916746666667,684.4083253333333,693.3166506666666,701.6333013333333,667.1833493333334,658.8666986666667,649.9583733333334,0.4484752837972014,922240442.0,-1
2018-08-01,681.900024,684.224976,675.5,682.549988,669.73175,4675706.0,678.3499939999999,682.0240834909091,18.59997599999997,59.44662175063008,-2.400072825553197,13.569931262966861,51.962640338168555,2100121.963869878,-2127670.896570606,80.0,0.0,68.0,18.92504800000006,680.7583213333334,686.0166426666667,689.4832973333332,694.7416186666667,677.2916666666667,672.0333453333334,668.5666906666668,0.8080237699221189,926916148.0,+1
2018-08-02,679.799988,683.375,675.075012,677.025024,669.533875,5940742.0,679.9249939999999,681.7831798545454,15.75,52.838885915776835,-3.324134337214878,13.049646385640017,39.12651502909681,-15253104.227527188,-2724281.5025231787,76.0,20.0,96.0,10.600036000000046,678.4916786666666,681.9083453333333,686.7916666666667,690.2083333333333,673.6083573333333,670.1916906666667,665.3083693333333,0.23494154449380153,920975406.0,-1
2018-08-03,683.099976,683.099976,678.0,676.825012,674.702576,3970390.0,681.7724976,681.2195467636363,18.475036000000046,52.59468803924586,-3.3575867526641905,12.674557184270952,34.969023035277154,-644306.4061183952,-2629737.1799593247,72.0,16.0,92.0,10.34997599999997,679.3083293333333,680.6166586666666,684.4083053333334,685.7166346666666,675.5166826666666,674.2083533333333,670.4167066666666,-0.23039088811398167,917005016.0,-1
2018-08-06,683.025024,687.5,673.75,682.049988,672.996216,6178930.0,682.5724976,681.2699995636364,8.0,58.39099897071082,-2.483698846615207,13.510619502723898,36.2694364547135,-5654658.770532701,-2767233.6158944783,68.0,12.0,88.0,12.625,681.099996,688.4499920000001,694.8499959999999,702.1999920000001,674.6999920000001,667.349996,660.9499920000001,0.6036354909090899,923183946.0,+1
2018-08-07,687.0,689.974976,680.325012,680.325012,676.606812,7351528.0,682.8075012,680.8613658181818,2.3500360000000455,55.792359345691416,-2.7722046052301237,15.44350552352978,41.25989122575826,-3307650.7297384497,-2791798.0301601132,64.0,8.0,80.0,18.94995199999994,683.5416666666666,686.7583213333332,693.1916306666665,696.4082853333332,677.1083573333333,673.8917026666667,667.4583933333333,0.0,915832418.0,-1
2018-08-08,685.900024,686.25,676.650024,683.974976,674.034851,3992358.0,682.3474975999999,681.0736339636364,-4.6000360000000455,60.12501446410927,-2.1617406725509785,16.331021782835933,30.939764582149014,-8279936.399737741,-3041258.8651409145,60.0,4.0,80.0,8.72497599999997,682.2916666666666,687.9333093333332,691.8916426666665,697.5332853333332,678.3333333333333,672.6916906666667,668.7333573333333,0.7630177408776816,919824776.0,+1
2018-08-09,686.825012,694.724976,686.825012,681.375,682.542175,6409524.0,681.2974976,680.8968162181818,-10.5,55.64278289298424,-2.5965919680244114,17.292660204911954,47.35284302043458,-676085.7381956097,-2933750.99573431,56.00000000000001,0.0,56.0,8.299987999999985,687.6416626666665,688.4583133333331,695.5416266666664,696.358277333333,680.5583493333331,679.7416986666666,672.6583853333332,-0.6898780804570814,913415252.0,-1
2018-08-10,692.900024,694.5,686.525024,689.974976,685.2625730000001,4779520.0,681.6324952,682.4745395636363,3.3499759999999696,65.46790277815515,-1.158228419806864,16.761986174007575,51.71395836183496,37041377.38711515,-1116699.7056047875,52.0,0.0,56.0,6.074951999999939,690.3333333333334,694.1416426666667,698.3083093333335,702.1166186666667,686.1666666666667,682.3583573333334,678.1916906666668,0.43259716392876324,918194772.0,+1
2018-08-13,695.0,704.924988,689.349976,692.724976,696.787109,9979746.0,682.2324951999999,684.4913542545454,6.0,68.07683541205508,-2.0134525298699213,13.85477739347084,70.71753134792303,-469746.1797752809,-1087292.7271579916,48.0,0.0,56.0,13.75,695.6666466666666,701.9833173333332,711.2416586666666,717.5583293333332,686.4083053333331,680.0916346666666,670.8332933333331,0.21669325198593725,928174518.0,+1
2018-08-14,706.974976,712.275024,702.0,704.375,696.564575,6151320.0,685.1199952,688.5172642181817,28.875,76.68654616260102,-1.288169857052589,11.848046940561744,113.86933823297761,-9055166.390904708,-1449468.8027828424,96.0,8.0,56.0,9.649963999999954,706.2166746666667,710.4333493333334,716.4916986666667,720.7083733333334,700.1583253333333,695.9416506666666,689.8833013333333,0.23114301241534746,934325838.0,+1
2018-08-16,707.474976,717.450012,705.625,704.150024,707.0750730000001,6626774.0,687.2799988,691.9772694545455,21.600036000000046,76.22844964651041,-2.1505356523463024,10.225414328484021,119.14005995083906,4592655.740175373,-1174826.7781029232,96.0,4.0,56.0,9.59997599999997,709.0750119999999,712.5250239999998,720.900024,724.3500359999998,700.7000119999998,697.2499999999999,688.8749999999998,-0.12473357320905618,927699064.0,-1
2018-08-17,715.450012,718.825012,711.5,714.775024,707.4707639999999,6390408.0,691.0549988,696.9763649454545,37.75,82.06625342759317,-0.6534082880798596,10.526491765922742,136.12443143501415,-8140836.759695107,-1491463.5954480227,96.0,0.0,56.00000000000001,10.75,715.0333453333333,718.5666906666665,722.3583573333333,725.8917026666666,711.2416786666665,707.7083333333333,703.9166666666665,0.44710152010672793,934089472.0,+1
2018-08-20,694.0,703.974976,686.75,715.174988,684.669067,16101876.0,694.8899964000001,701.3618175272727,38.34997599999997,82.25552914926061,-0.5888797530487573,10.585243555771626,62.3367497263271,-4613023.507883847,-1633352.6823769237,96.0,4.0,52.0,13.125,701.9666546666667,717.1833093333335,719.1916306666667,734.4082853333334,699.9583333333335,684.7416786666668,682.7333573333335,1.6502193094492577,950191348.0,+1
2018-08-21,695.0,698.0,686.875,692.125,684.52063,8361482.0,695.8974976000001,700.8590909090909,10.075012000000015,48.334050216173345,-4.307669339423175,10.123087713508085,12.84647337580763,2113699.184321416,-1463032.1429815444,92.0,0.0,48.0,15.575012000000015,692.3333333333334,697.7916666666667,703.4583333333335,708.9166666666667,686.6666666666667,681.2083333333334,675.5416666666667,0.47191011235955055,941829866.0,-1
2018-08-23,696.5,700.75,692.674988,691.974976,691.173218,7717182.0,697.062494,700.1459051636363,11.649963999999954,48.18481962498549,-4.331873590154514,10.490950253068604,23.962111981559378,1132617.9866821473,-1345048.0461786492,88.0,8.0,88.0,19.55004800000006,695.1333213333334,697.5916546666667,703.2083333333333,705.6666666666667,689.5166426666667,687.0583093333333,681.4416306666667,-0.08668866374440234,934112684.0,-1
2018-08-24,698.25,700.950012,688.049988,698.700012,681.726135,7053000.0,698.5349976000001,700.4436357090909,14.725036000000046,55.31992432342962,-3.2468841383251568,10.893326945464082,27.351139180592977,-14086218.159517257,-1924192.1422394952,84.0,4.0,92.0,13.075012000000015,695.9000040000001,703.7500200000002,708.8000280000001,716.6500440000002,690.8499960000001,682.99998,677.9499720000001,0.8255817198479635,941165684.0,+1
2018-08-27,691.5,709.974976,690.700012,689.150024,700.0762940000001,7012950.0,699.3125000000001,698.7372768727273,7.77502400000003,45.13585917663352,-4.787639644332389,11.250497438309594,30.235492927927915,-4546940.125832555,-2043407.9596755437,80.0,0.0,96.0,14.674987999999985,696.6083373333335,702.5166626666669,715.8833013333335,721.7916266666668,683.2416986666669,677.3333733333335,663.966734666667,-0.08041457301813837,934152734.0,-1
2018-08-28,708.599976,719.200012,705.75,707.700012,704.676147,6496890.0,701.0850036000002,700.2622790545455,17.725036000000046,61.16085607609292,-1.8542405316818986,11.500891751809604,101.98370252645861,-14306038.492307693,-2600800.256613369,76.0,0.0,92.0,28.02502400000003,710.8833413333333,716.0166826666666,724.3333533333334,729.4666946666666,702.5666706666666,697.4333293333333,689.1166586666666,0.1449821754805879,940649624.0,+1
2018-08-29,716.799988,716.799988,702.575012,712.349976,697.454834,5646496.0,703.0475036,702.3104558545455,19.625,64.18644980103,-1.1044882082330636,12.189833042504688,87.63867118122491,2251819.629421724,-2380226.625429956,96.0,24.0,92.0,28.299987999999985,710.574992,718.5749719999999,724.799968,732.7999479999999,704.3499959999999,696.350016,690.12502,0.6871691031324042,946296120.0,+1
2018-08-30,706.400024,710.775024,698.075012,705.049988,700.4719240000001,11507962.0,703.1150024,702.6745439272727,0.6749879999999848,56.249076261248725,-2.2815259152236247,12.641031060924206,47.9889067340835,98257.24081357257,-2267568.2678734316,92.0,20.0,80.0,8.625,704.6333413333333,711.1916706666666,717.3333533333332,723.8916826666666,698.4916586666666,691.9333293333333,685.7916466666666,0.5492101897226523,934788158.0,-1
2018-08-31,712.549988,727.150024,710.549988,708.099976,712.787842,10875864.0,703.5099975999999,703.5809027636362,3.9499519999999393,58.71055666584075,-3.0327226414306496,13.136724355728461,90.55383308845384,-2667311.263877893,-2285738.4040554524,88.0,16.0,80.0,12.90002400000003,715.2666626666665,719.9833373333331,731.8666986666665,736.5833733333332,703.3833013333331,698.6666266666665,686.783265333333,-0.14759076426099368,945664022.0,+1
2018-09-03,724.5,733.950012,715.0,720.549988,709.39978,10976328.0,704.087494,706.6790828363636,5.7749639999999545,67.35985349104322,-2.110406133829639,13.062877544712364,113.45811681929469,-3454713.6333486163,-2338873.6417505965,96.0,12.0,80.0,19.274963999999954,723.1666666666666,731.3333333333333,742.1166786666668,750.2833453333333,712.3833213333332,704.2166546666666,693.4333093333332,0.29287517073867714,956640350.0,+1
2018-09-04,722.0,748.5,716.0,717.125,729.2090450000001,15370124.0,704.2824952,709.0495384727274,1.9500120000000152,63.160118372479396,-4.8306389530408005,13.177526478912455,113.98348040604225,-8219759.003994386,-2606186.6127616777,96.0,8.0,76.0,30.049987999999985,727.2083333333334,738.4166666666667,759.7083333333335,770.9166666666667,705.9166666666667,694.7083333333334,673.4166666666667,0.03461538461538462,941270226.0,-1
2018-09-05,741.950012,744.049988,725.400024,737.150024,722.0371700000001,8658978.0,708.7849976,715.0254528,45.02502400000003,74.06761565501134,-1.7474943802925282,11.996003181252263,132.10220624454666,-6400804.0808593305,-2778669.224947935,96.0,4.0,72.0,14.22497599999997,735.5333453333333,745.6666666666665,754.1833093333332,764.3166306666665,727.0167026666666,716.8833813333333,708.3667386666666,0.630028025791365,949929204.0,+1
2018-09-06,732.549988,735.5,724.099976,729.900024,719.316772,5598659.0,712.5775024,718.8645485090909,37.92504800000006,65.9148823343478,-2.863737644341797,10.537026837021585,95.38058645768744,5817206.488047815,-2387947.601629946,92.0,0.0,72.0,14.274963999999954,729.8333333333334,735.5666906666668,741.2333573333335,746.9667146666668,724.1666666666667,718.4333093333333,712.7666426666667,0.5087750692454722,944330545.0,-1
2018-09-07,734.349976,735.150024,723.799988,727.150024,724.905884,6510605.0,715.4225036,721.514097890909,28.450012000000015,62.885407522464796,-3.287140261739795,11.529999890186332,81.80998955219833,986752.4686060423,-2234552.1438919464,88.0,12.0,72.0,22.100036000000046,728.7000119999999,733.6000359999998,740.0500479999998,744.9500719999999,722.2499999999998,717.3499759999999,710.8999639999997,0.2951564206492413,937819940.0,-1
2018-09-10,737.75,747.0,729.400024,732.799988,722.976868,5629871.0,719.7875,724.6736405090909,43.649963999999954,66.53190374283795,-2.4172458814472697,13.334933811151927,106.8609774537998,2913528.639505249,-2000548.4719193461,84.0,8.0,84.0,25.850036000000046,736.4000040000001,743.3999840000001,753.99998,760.9999600000001,725.8000080000002,718.8000280000001,708.2000320000002,0.1931800361545925,943449811.0,+1
2018-09-11,735.900024,744.75,732.0,730.849976,726.389709,6963561.0,722.1024964,726.6849997818182,23.149963999999954,64.02676301662046,-2.7174786759045464,14.040756438854032,90.06461724841058,-702847.4930471228,-1941562.0637887905,80.0,4.0,88.0,32.5,735.8666586666667,739.7333173333334,748.6166586666668,752.4833173333334,726.9833173333334,723.1166586666667,714.2333173333334,-0.0901979607843161,936486250.0,-1
2018-09-12,744.400024,746.5,736.25,734.299988,734.897095,4636617.0,724.2974976,728.9027255272727,21.950012000000015,66.59450464201846,-2.1862989992301793,16.371148458769653,86.62044103837871,17006196.627276532,-1080300.3051040026,76.0,0.0,92.0,26.924987999999985,739.0166626666665,741.7833253333331,749.2666626666664,752.0333253333331,731.5333253333331,728.7666626666665,721.2833253333331,-0.1902450731707332,941122867.0,+1
2018-09-14,741.900024,745.0,729.049988,742.900024,725.796204,7896514.0,728.0825012,732.2850030545454,37.850036000000046,72.28461064512626,-0.8621979984603494,16.938663536401464,74.94689442908114,-9521936.910467947,-1464011.059893273,72.0,4.0,92.0,13.05004800000006,738.9833373333335,748.9166866666669,754.9333493333336,764.8666986666669,732.9666746666669,723.0333253333334,717.0166626666669,0.8683401617503506,949019381.0,+1
2018-09-17,735.0,740.0,724.599976,733.700012,718.1297,5427054.0,730.6425048000001,733.3063686545455,25.600036000000046,59.726948388544386,-2.2786740569668953,16.666554678004445,46.74535695722306,-8338816.02631579,-1776502.1947306606,68.0,0.0,76.0,11.350036000000046,732.7666626666665,740.9333493333331,748.1666866666665,756.3333733333332,725.5333253333331,717.3666386666665,710.1333013333331,0.5909105076719379,943592327.0,-1
2018-09-18,730.0,730.0,717.0,725.950012,711.3534549999999,7729732.0,731.1825072,732.4531881454545,5.40002400000003,51.09850656782076,-3.4718996150885273,17.56379443848914,17.430836900938292,2842670.846609008,-1566539.7837606752,64.0,4.0,76.0,19.84997599999997,724.3166706666667,731.6333413333334,737.3166706666666,744.6333413333334,718.6333413333334,711.3166706666667,705.6333413333334,0.6884624615384627,935862595.0,-1
2018-09-19,727.0,727.0,713.200012,719.099976,711.99646,4849498.0,731.3800048,730.256364290909,1.9749759999999696,44.536756393337065,-4.526562586605086,17.87010103350508,0.4004362398568753,-13718229.249668263,-2118889.3049382935,60.0,0.0,76.0,12.75,719.7666626666665,726.3333133333331,733.5666506666664,740.1333013333331,712.5333253333331,705.9666746666666,698.7333373333331,0.4275339949570942,931013097.0,-1
2018-09-21,713.849976,717.400024,692.0,719.75,697.7021480000001,14350769.0,729.6400024000001,728.1418179636363,-17.40002400000003,45.30577596705819,-4.426481909160893,17.087572052607356,-37.66722999232299,-58071.617801708344,-2025215.7737048126,56.00000000000001,16.0,76.0,15.65002400000003,709.7166746666667,727.4333493333334,735.1166986666667,752.8333733333334,702.0333253333333,684.3166506666666,676.6333013333333,1.0925186527382795,945363866.0,+1
2018-09-24,706.5,729.950012,706.5,705.299988,710.5126339999999,8637881.0,727.1799988,723.7163608,-24.600036000000046,33.4200452679152,-6.651272055427254,16.603965372961056,-26.189707071194558,-10475653.383535296,-2409326.574151653,52.0,12.0,68.0,15.950012000000015,713.9166666666666,721.3333333333333,737.3666786666668,744.7833453333333,697.8833213333332,690.4666546666666,674.4333093333332,-0.051173193429496514,936725985.0,-1
2018-09-25,718.25,736.0,717.0,718.25,718.3770139999999,9602273.0,726.2899964000001,722.0927246545455,-8.90002400000003,47.62773693143691,-4.657428791377983,14.33302040889896,3.2794804394140797,4572196.783842087,-2091984.6033337554,48.0,8.0,68.0,18.30004800000006,723.75,730.5,742.75,749.5,711.5,704.75,692.5,0.06578947368421052,946328258.0,+1
2018-09-26,731.200012,731.849976,712.0,726.200012,710.116943,6599606.0,725.6299988000002,722.0763638545454,-6.59997599999997,54.50463657472755,-3.433408468052346,13.112789813888185,-3.3203384530579063,5606703.330275229,-1742044.2427151648,44.0,4.0,60.0,16.700012000000015,723.3499959999999,734.6999919999998,743.1999719999999,754.5499679999998,714.8500159999999,703.50002,695.0000399999999,0.7153667087557203,952927864.0,+1
2018-09-27,722.0,730.799988,717.450012,717.849976,716.992065,14592616.0,724.3299988000001,720.6618142545454,-13.0,47.02190693447034,-4.4984604938271655,12.674156265256215,-12.094940959531677,-10159911.24829984,-2124674.561150832,40.0,0.0,60.0,13.799987999999985,722.0333253333333,726.6166386666666,735.3833013333333,739.9666146666666,713.2666626666667,708.6833493333334,699.9166866666667,0.029959904047764233,938335248.0,-1
2018-09-28,721.0,734.549988,715.200012,724.799988,722.1854860000001,7490031.0,723.3799988,720.7472668363637,-9.5,53.19325648672772,-3.4259277777777797,11.59287815318578,-3.130746059339231,4198802.393625227,-1837243.7904791927,36.0,0.0,40.00000000000001,27.09997599999997,724.8499959999999,734.4999799999998,744.1999719999999,753.8499559999998,715.1500039999999,705.50002,695.8000279999999,0.49612340604453387,945825279.0,+1
2018-10-01,737.5,754.900024,733.0,730.049988,738.606689,8252398.0,722.0949952,721.9599921454545,-12.850036000000046,57.50761821441857,-3.788692649903005,9.380056047711378,72.09112854963632,1321119.1669322427,-1693681.8378695822,32.0,4.0,40.0,23.450012000000015,739.3166706666667,745.6333413333334,761.2166946666666,767.5333653333334,723.7333173333334,717.4166466666667,701.8332933333334,-0.13470359667185802,954077677.0,+1
2018-10-03,743.799988,751.950012,726.299988,746.650024,720.6522219999999,7792464.0,723.3899964,726.4245428363636,12.950012000000015,68.20107648580019,-1.2578136450868616,6.9786761282611,82.20579057367964,7310116.106936795,-1284418.2949238373,96.0,0.0,40.0,30.700012000000015,741.6333413333333,756.9666946666666,767.2833653333334,782.6167186666667,731.3166706666666,715.9833173333333,705.6666466666666,0.7933729808595898,961870141.0,+1
2018-10-04,728.5,729.75,702.5,728.5,699.581665,6173037.0,723.6449952,727.3536344,2.549987999999985,51.76611308124403,-4.0250073233722015,3.1937924408607614,-55.33810869014874,16590173.327179851,-471936.85755548725,92.0,0.0,40.0,19.84997599999997,720.25,738.0,747.5,765.25,710.75,693.0,683.5,0.9541284403669725,955697104.0,-1
2018-10-05,713.0,731.5,709.299988,707.200012,716.794189,8543578.0,722.4549988,724.3636374545456,-11.899963999999954,39.03023838672581,-7.27245163204934,-0.7041438245084919,-90.02663216980167,454336.5352586264,-429833.52151848207,88.0,64.0,40.0,13.34997599999997,716.0,722.700012,738.200012,744.900024,700.5,693.799988,678.299988,-0.0945934623819108,947153526.0,-1
2018-10-08,725.049988,728.700012,709.25,724.599976,706.753601,7259306.0,722.9399963999999,724.7536333090909,4.84997599999997,50.50752636907618,-4.619613796507509,-2.150161097886098,-52.46143042672134,-7651958.967328688,-758111.9508734917,84.0,60.0,36.0,19.34997599999997,720.8499959999999,732.4499919999998,740.3000079999999,751.9000039999999,712.9999799999998,701.3999839999999,693.5499679999998,0.7892013639888735,954412832.0,+1
2018-10-09,717.099976,722.400024,702.650024,714.450012,710.018005,6777212.0,723.8549988,723.2099997818183,9.15002400000003,44.8276972372087,-6.167100246973007,-2.6676336713950377,-128.46954405372728,-2696241.775728043,-846208.7610941533,80.0,56.00000000000001,28.0,30.100036000000046,713.1666866666668,723.6833493333336,732.9166866666669,743.4333493333336,703.9333493333336,693.4166866666668,684.1833493333336,0.5974677468354422,947635620.0,-1
2018-10-10,719.900024,719.900024,695.400024,717.75,692.9044190000001,8866251.0,723.8049987999999,722.1,-0.5,47.06101513474933,-5.663976618485385,-3.676015773228528,-143.04128104237358,-32507365.96462176,-2285352.2703454094,76.0,52.0,96.0,25.65002400000003,711.0166826666667,726.6333413333334,735.5166826666668,751.1333413333334,702.1333413333334,686.5166826666667,677.6333413333334,0.9122439183673458,956501871.0,+1
2018-10-11,685.0,692.900024,663.299988,700.450012,666.096313,10985897.0,721.2299988,717.8536387636365,-25.75,37.80438414606738,-8.301571887120408,-2.906672287563424,-339.9614642719929,48344725.73229172,16014.91159264372,72.0,48.0,92.0,44.15002400000003,685.550008,707.8000280000001,715.1500440000002,737.4000640000002,678.1999920000001,655.949972,648.599956,1.2550668519457198,945515974.0,-1
2018-10-12,676.400024,684.049988,661.5,673.349976,671.48761,8909221.0,716.7799987999999,709.1481800727273,-44.5,27.889218439409476,-12.433304622047103,-3.8059564558764123,-312.59798117153423,-549528.0,-9691.584388840105,68.0,96.0,24.0,22.200012000000015,672.9666546666666,684.4333093333332,695.5166426666665,706.9832973333332,661.8833213333332,650.4166666666666,639.3333333333333,0.5254981066952221,936606753.0,-1
2018-10-15,688.599976,705.0,681.5,678.799988,691.272156,6222176.0,712.1799987999999,702.2427235636364,-46.0,32.02612161919886,-11.602383475442599,-6.051905629703242,-152.78424234671127,7750037.529644109,343023.3753399306,64.0,96.0,24.0,21.5,688.4333293333333,695.3666586666666,711.9333293333334,718.8666586666666,671.8666586666666,664.9333293333333,648.3666586666666,-0.11489412765957512,942828929.0,+1
2018-10-16,710.0,713.900024,689.400024,698.799988,687.760376,11588963.0,709.0549987999999,699.8099943272728,-31.25,45.31095071402372,-8.553138275232024,-5.564283529977615,-68.96362161433028,565357.0842770748,353129.4530188917,60.0,92.0,23.999999999999993,21.94995199999994,700.7000119999999,711.9999999999998,725.2000119999998,736.4999999999998,687.4999999999998,676.2000119999999,662.9999999999998,0.3836719999999981,954417892.0,+1
2018-10-17,710.0,721.799988,701.349976,695.25,697.751587,20360697.0,703.9149964,697.2999945454545,-51.40002400000003,43.56706885558509,-9.09437746872228,-6.651125625375016,-34.441127347022984,2880266.27494481,467999.30856097897,56.00000000000001,88.0,24.0,24.5,706.1333213333334,710.9166666666667,726.5833333333335,731.3666786666668,690.4666546666667,685.6833093333333,670.0166426666667,-0.2982871599292932,934057195.0,-1
2018-10-19,687.0,687.700012,678.0,705.349976,676.1864009999999,10421001.0,701.5999939999999,697.5608999272727,-23.15002400000003,49.89725872732971,-7.554512301710186,-8.564558589175249,-93.92114069173901,5493198.6228354955,696417.4592098208,52.0,84.0,24.0,54.450012000000015,690.3499959999999,702.6999919999998,700.0500079999999,712.4000039999999,692.9999799999998,680.6499839999999,683.2999679999998,2.8195816664969,944478196.0,+1
2018-10-22,688.700012,695.049988,673.799988,683.549988,672.6252440000001,6672840.0,699.2349916000001,694.2790806545454,-23.65002400000003,39.00166118307961,-10.878187740392589,-13.284193000387518,-103.8413542873983,-5563852.851143865,411859.7178301076,48.0,80.0,-28.0,38.950012000000015,684.1333213333334,694.4666546666667,705.3833213333335,715.7166546666667,673.2166546666667,662.8833213333334,651.9666546666667,0.4588235294117647,937805356.0,-1
2018-10-23,675.950012,682.0,653.299988,679.950012,650.515991,9041701.0,694.7699952,690.7727207272727,-44.649963999999954,37.44374219579751,-11.427048217336248,-16.154173916762602,-131.0388106219952,-3921164.0743050436,214904.0909148733,44.0,76.0,-32.0,31.65002400000003,671.75,690.200012,700.450012,718.900024,661.5,643.049988,632.799988,0.9285718765553135,928763655.0,-1
2018-10-24,663.0,666.5,647.150024,657.599976,642.799988,7058164.0,689.0849916000001,684.0145354181818,-56.850036000000046,29.113125893455617,-14.449809980247007,-16.691672126073172,-158.30258497075263,-14705231.992581688,-463283.91288042546,40.0,96.0,-32.0,35.100036000000046,657.0833333333334,667.0166426666667,676.4333093333335,686.3666186666667,647.6666666666667,637.7333573333334,628.3166906666668,0.5400498687957006,921705491.0,-1
2018-10-25,643.0,656.349976,636.25,649.799988,648.75,8270469.0,682.2899904000001,676.871807490909,-67.95001200000002,26.719330273503147,-12.916997944664036,-19.562358063846546,-157.69056083997256,4575279.764271386,-234258.29119170655,36.0,96.0,-31.999999999999993,23.0,647.4666546666666,658.6833093333332,667.5666306666667,678.7832853333332,638.5833333333333,627.3666786666666,618.4833573333333,0.674129561149725,913435022.0,-1
2018-10-26,645.299988,648.700012,629.900024,648.75,633.599976,5464141.0,677.1199891999998,670.7736274181818,-51.700012000000015,26.382391724015264,-13.08300395256917,-22.033636333930986,-140.333750140014,-1059538.5695233534,-271771.0311158723,32.0,96.0,-32.0,17.25,642.450012,655.0,661.25,673.799988,636.200012,623.650024,617.400024,1.0026589378674065,907970881.0,-1
2018-10-29,633.700012,650.549988,631.5,633.599976,644.75,7137446.0,673.1449892,662.8608977454545,-39.75,21.80465122535685,-15.102435157647742,-26.244450799964852,-124.86623906973585,-549934.7079490372,-284414.8346082889,28.000000000000004,96.0,-32.0,31.549987999999985,638.549988,645.599976,657.599976,664.649964,626.549988,619.5,607.5,0.11023503006930878,900833435.0,-1
2018-10-30,641.099976,663.799988,637.450012,644.75,659.599976,8793411.0,669.7399904000001,657.6981724363636,-34.049987999999985,31.846940963830974,-12.455890441223342,-28.670054819874622,-83.39931007636021,-1774277.090261354,-352135.84622888285,24.0,92.0,-32.0,30.25,648.6666666666666,659.8833213333332,675.0166426666667,686.2332973333332,633.5333453333333,622.3166906666667,607.1833693333333,0.27703964512149815,909626846.0,+1
2018-10-31,663.900024,692.950012,663.049988,659.599976,686.400024,11947995.0,665.8199892,655.8545334545454,-39.200012000000015,43.08035714381956,-9.987156904055691,-27.136196025779782,-27.854367022833692,-2290663.8881919957,-440250.7572272062,20.0,88.0,-56.0,32.799987999999985,671.8666586666667,680.6833293333334,701.7666826666666,710.5833533333334,650.7833053333334,641.9666346666667,620.8832813333333,-0.11538492410574692,921574841.0,+1
2018-11-01,689.700012,689.700012,659.599976,686.400024,666.700012,5860244.0,664.9349915999999,659.5963579636364,-8.84997599999997,57.62477241015047,-5.68400203630061,-26.564262563415014,-9.03076053337202,6806525.936170213,-110851.81661823232,16.0,84.0,-60.0,21.34997599999997,678.5666706666667,697.5333653333334,708.6667066666669,727.6334013333335,667.4333293333334,648.4666346666667,637.3332933333334,0.8903659782998273,927435085.0,+1
2018-11-02,665.950012,675.799988,660.099976,666.700012,662.25,6654067.0,661.0699952,659.9172707636365,-38.649963999999954,47.36047991113538,-8.847138256528028,-28.524708863989417,-26.846828668090414,-9945099.531445144,-557863.0763830923,12.0,80.0,-64.0,19.899963999999954,667.5333253333333,674.9666746666667,683.2333373333333,690.6666866666667,659.2666626666667,651.8333133333333,643.5666506666666,0.4203841372860122,920781018.0,-1
2018-11-05,663.5,668.599976,657.0,662.25,666.0,5799426.0,658.9399964,660.1318170909091,-21.299987999999985,45.25926769424801,-9.561655290205302,-29.87487638359562,-33.93883640904201,1572014.3621540454,-461050.46554049506,8.0,76.0,-68.0,19.049987999999985,662.6166586666667,668.2333173333334,674.2166346666668,679.8332933333334,656.6333413333334,651.0166826666667,645.0333653333334,0.4525871432837459,914981592.0,-1
2018-11-06,667.900024,675.0,660.650024,666.0,666.450012,6975525.0,657.5449952000001,661.415454109091,-13.950012000000015,47.52307868088083,-8.959535818102808,-33.36663107885272,-18.44732023927047,7323026.0,-107228.80801592683,4.0,72.0,-68.0,30.200012000000015,667.2166746666667,673.7833253333333,681.5666506666666,688.1333013333333,659.4333493333334,652.8666986666667,645.0833733333334,0.37282125071149813,921957117.0,+1
2018-11-07,673.0,677.5,672.0,666.450012,675.5,758956.0,658.4299988000001,663.0345480727273,8.850036000000046,47.8218637263935,-8.887279554668195,-33.72406302930631,-2.936696531155181,-1799705.3075535563,-184159.55799491005,0.0,68.0,-68.0,48.200012000000015,671.9833373333333,671.9666746666667,677.4833373333333,677.4666746666667,666.4666746666667,666.4833373333333,660.9666746666667,-1.0090887272727245,922716073.0,+1
2018-11-09,679.0,679.0,655.5,675.5,659.5,9694143.0,661.0,666.1381846545455,25.700012000000015,53.91104849282408,-3.279924233468819,-33.16997727500427,-2.825870663090288,2861280.4290505783,-45730.46767466047,0.0,64.0,-68.0,30.100036000000046,670.0,684.5,693.5,708.0,661.0,646.5,637.5,0.851063829787234,932410216.0,+1
2018-11-12,666.0,676.400024,662.299988,659.5,664.200012,7118080.0,662.075,665.8654573818181,10.75,43.544700507021666,-5.9642628497125285,-28.873724749591247,-10.32688825276286,-4508319.2477365,-248575.41222292604,4.0,60.0,-68.0,26.30004800000006,666.0666706666667,669.8333533333334,680.1667066666666,683.9333893333335,655.7333173333334,651.9666346666667,641.6332813333333,-0.1985802022065742,925292136.0,-1
2018-11-13,663.5,667.75,656.299988,664.200012,665.700012,4137801.0,665.1350036000001,666.2518232,30.600036000000046,46.998992315898356,-4.840474689644421,-24.305535140089205,-18.372750179834973,2472292.9645791887,-124899.57691373891,0.0,56.00000000000001,-68.0,11.59997599999997,662.75,669.200012,674.200012,680.650024,657.75,651.299988,646.299988,0.6899577048478219,929429937.0,+1
2018-11-14,665.700012,665.700012,640.5,665.700012,653.200012,7323026.0,667.2300048000001,666.354552,20.950012000000015,48.166882047885714,-4.5879281840977555,-20.62976953521286,-31.274605269913142,15746225.513721613,596515.1999333232,0.0,52.0,-68.0,14.34997599999997,657.300008,674.1000160000001,682.50002,699.3000280000001,648.9000040000001,632.099996,623.6999920000001,1.0,936752963.0,+1
2018-11-15,654.0,666.0,646.700012,653.200012,656.400024,5513390.0,666.5900084,663.8036442181818,-6.3999639999999545,39.74567650596695,-6.692482396986634,-13.761625443963567,-34.51465373691124,-3898361.0976784336,392202.6409509704,0.0,48.0,-68.0,11.5,655.300008,663.9000040000001,674.5999960000001,683.1999920000001,644.6000160000001,636.0000200000001,625.3000280000001,0.33678777416856454,931239573.0,-1
2018-11-16,659.900024,662.5,644.200012,656.400024,650.849976,8583785.0,663.5900084,661.9509197818181,-30.0,42.70460812069795,-6.153714498115034,-8.57888969163264,-34.37830991061846,7310010.274059313,706648.4424558954,20.0,44.0,-64.0,23.5,654.3666786666666,664.5333453333333,672.6666666666667,682.8333333333333,646.2333573333333,636.0666906666667,627.9333693333333,0.6666677595635596,939823358.0,+1
2018-11-19,659.0,662.0,649.25,650.849976,651.700012,6018930.0,662.0050047999999,659.6345502545454,-15.850036000000046,38.88337361600975,-7.0881446501258845,-5.117982440601054,-35.46064791633397,-18311353.59064459,-157806.1954123092,16.0,40.0,-56.0,14.100036000000046,654.0333253333333,658.8166506666666,666.7833253333333,671.5666506666666,646.0666506666666,641.2833253333333,633.3166506666666,0.12548831372548783,933804428.0,-1
2018-11-20,651.700012,656.0,640.099976,651.700012,641.400024,5384830.0,660.9500059999999,657.7609152,-10.549987999999985,39.83477328038446,-6.945028902533299,-6.41455959006953,-65.83654697453359,-19078178.890097987,-1017823.1360798407,12.0,36.0,-56.00000000000001,11.450012000000015,649.2666626666667,658.4333493333334,665.1666866666667,674.3333733333334,642.5333253333333,633.3666386666666,626.6333013333333,0.7295609113546007,939189258.0,+1
2018-11-21,640.0,640.049988,612.099976,641.400024,619.099976,14359086.0,658.4900084,654.2063730181817,-24.59997599999997,32.71457335896315,-8.679179553581688,-7.110921801069935,-210.16693094297264,-748984.700001873,-1005603.2071672058,8.0,32.0,-52.0,25.200012000000015,631.1833293333333,650.2666826666666,659.1333413333332,678.2166946666666,622.3166706666666,603.2333173333333,594.3666586666666,1.0483018039491376,924830172.0,-1
2018-11-22,622.25,628.150024,616.75,619.099976,620.75,6632975.0,653.7550047999999,647.0445489454546,-47.350036000000046,22.615958286671926,-11.951927300790379,-7.515261674203089,-248.80942737325296,-10256754.405328643,-1426110.0798109076,4.0,96.0,-48.0,19.299987999999985,621.3333333333334,625.9166666666667,632.7333573333335,637.3166906666668,614.5166426666667,609.9333093333333,603.1166186666667,0.20613781163969158,918197197.0,-1
2018-11-26,621.0,628.0,599.849976,620.75,621.450012,15075209.0,648.2800048,641.0436389818182,-54.75,24.60300004205935,-10.043103448275863,-7.285595397519614,-223.13764511560666,-6361833.081326969,-1650461.125334365,0.0,92.0,-24.0,18.299987999999985,616.199992,632.5500079999999,644.3500159999999,660.700032,604.3999839999999,588.0499679999999,576.2499599999999,0.7424513741089531,933272406.0,+1
2018-11-27,625.5,641.0,625.299988,621.450012,638.900024,12285851.0,644.4750060000001,636.1654584727273,-38.049987999999985,25.53893987345934,-9.922411724137929,-7.470218074169566,-123.59167594989114,-8705399.75754756,-1971140.1540713285,4.0,96.0,-24.0,12.75,629.25,633.200012,644.950012,648.900024,617.5,613.549988,601.799988,-0.24522121384365603,945558257.0,+1
2018-11-28,640.950012,668.700012,640.0,638.900024,666.400024,17719890.0,641.9450072000001,635.1518253818183,-25.299987999999985,45.13030046881438,-6.913788965517235,-8.040508453906796,-24.256346403428566,6663120.953379799,-1578673.740096277,0.0,92.0,-24.0,15.90002400000003,649.200012,658.400024,677.900024,687.100036,629.700012,620.5,601.0,-0.038326673870379184,963278147.0,+1
2018-11-29,671.0,674.900024,658.799988,666.400024,661.049988,13399070.0,642.0150083999999,639.5981920727273,0.7000120000000152,62.886559447357435,-2.1724096551724084,-7.217289715291713,56.60082440490962,4923891.700268303,-1283102.5837160689,24.0,88.0,-24.0,39.600036000000046,666.700012,674.600036,682.8000480000001,690.7000720000001,658.5,650.599976,642.399964,0.4720508699483668,976677217.0,+1
2018-11-30,661.0,672.0,660.950012,661.049988,667.450012,10445773.0,642.8000059999999,643.0590974545455,7.84997599999997,58.62769675166859,-3.094829655172416,-7.433247180015314,45.93018612172243,-3955281.6664261892,-1404565.2692938019,20.0,84.0,-92.0,24.65002400000003,664.6666666666666,668.3833213333332,675.7166546666665,679.4333093333332,657.3333333333333,653.6166786666666,646.2833453333333,0.009047611635412615,966231444.0,-1
2018-12-03,673.150024,679.0,665.950012,667.450012,670.349976,8260890.0,643.9050048000001,647.5409167272727,11.049987999999985,62.16447903988405,-1.9913772413793076,-9.206076381954745,73.05877047985602,4570529.052902862,-1132970.0728303168,16.0,80.0,-92.0,28.15002400000003,670.800008,675.6500040000001,683.8499960000001,688.6999920000001,662.6000160000001,657.7500200000001,649.5500280000001,0.11494263443000881,974492334.0,+1
2018-12-04,672.549988,688.25,671.299988,670.349976,685.25,7827923.0,645.8550048000001,652.3490933090909,19.5,63.78318438415034,-3.0377639372083207,-9.768259543842305,91.64567651607744,-1370684.9110202803,-1143775.2927480424,12.0,76.0,-92.0,20.25,676.6333213333334,681.9666546666667,693.5833333333333,698.9166666666667,665.0166426666667,659.6833093333333,648.0666306666667,-0.05604786592481553,982320257.0,+1
2018-12-05,683.0,683.650024,672.5,685.25,681.400024,5177288.0,649.2100036,659.5118197090909,33.549987999999985,71.11057371426682,-0.5091217649554518,-10.488008747799881,97.50123797172579,-1550630.579077822,-1162268.7148539415,8.0,72.0,-92.0,47.25,680.4666746666667,688.4333493333334,691.6166986666667,699.5833733333334,677.2833253333333,669.3166506666666,666.1333013333333,1.143495296512363,987497545.0,+1
2018-12-06,676.099976,685.450012,664.549988,681.400024,668.5,8039771.0,653.2100036,665.364550690909,40.0,67.06523037322533,-1.162490623674157,-11.477516210376507,77.84349156686471,-8649695.1,-1502606.277815126,4.0,68.0,-64.0,36.0,677.1333413333333,689.7166946666666,698.0333653333334,710.6167186666667,668.8166706666666,656.2333173333333,647.9166466666666,0.8062208923779236,979457774.0,-1
2018-12-07,672.0,685.75,665.599976,668.5,682.799988,5553948.0,658.1500060000001,668.1445500363636,49.40002400000003,54.97426358594478,-3.3517182859567245,-12.20356862600454,60.762539134431194,-6241641.278778854,-1718016.9596771137,0.0,64.0,-64.0,11.049987999999985,673.2833253333333,680.9666746666667,693.4333493333334,701.1166986666667,660.8166506666666,653.1333013333333,640.6666266666666,0.1439216151802115,973903826.0,-1
2018-12-10,669.900024,683.799988,665.200012,682.799988,669.200012,5121196.0,664.3550048000001,672.6263649454545,62.049987999999985,63.41151666932791,-0.9249065761561333,-10.15658812514971,71.50479340908598,1876362.9598278059,-1554636.054245072,0.0,60.0,-64.0,17.950012000000015,677.2666626666667,689.3333133333333,695.8666386666666,707.9332893333333,670.7333373333333,658.6666866666667,652.1333613333334,0.9462364897675136,979025022.0,+1
2018-12-11,669.200012,681.900024,660.599976,669.200012,674.5,7120933.0,669.1300048,673.5072753454546,47.75,52.59608111286237,-3.232921170980057,-3.3504515840576232,45.261521912280614,18626885.12596308,-637294.182417428,80.0,56.00000000000001,-64.0,20.799987999999985,670.5666706666667,680.5333653333334,691.8667186666667,701.8334133333335,659.2333173333334,649.2666226666666,637.9332693333333,0.40375664881130885,971904089.0,-1
2018-12-12,677.099976,680.650024,670.599976,674.5,678.5,6926183.0,672.6900024,674.4836381090909,35.59997599999997,55.97270384037037,-2.333474756045821,2.681234564601141,58.027693284073735,16313051.401710508,133176.07140656968,76.0,52.0,-64.0,13.30004800000006,675.25,679.900024,685.3000480000001,689.9500720000001,669.849976,665.1999519999999,659.7999279999999,0.3880602361302162,978830272.0,+1
2018-12-13,682.0,700.0,680.0,678.5,697.75,7521474.0,673.9000000000001,675.5400013090909,12.09997599999997,58.5442040427866,-3.577371048252912,9.000727074287283,91.84440334776855,1352049.594599642,188579.4133698912,72.0,48.0,-64.0,20.90002400000003,686.1666666666666,692.3333333333333,706.1666666666665,712.3333333333333,672.3333333333333,666.1666666666666,652.3333333333333,-0.075,986351746.0,+1
2018-12-14,697.450012,713.700012,694.400024,697.75,706.049988,9560576.0,677.5700012,679.8763649454546,36.700012000000015,68.6967087416796,-2.594763573878052,14.16625985986866,141.00316003842846,24846495.26985614,1309393.7704829033,96.0,44.0,-64.0,20.15002400000003,701.9500119999999,709.4999999999998,721.25,728.7999879999998,690.2000119999998,682.6500239999999,670.9000239999998,0.17357399393201553,995912322.0,+1
2018-12-17,711.849976,711.849976,692.75,706.049988,694.400024,4778465.0,681.4299987999999,685.0545443636364,38.59997599999997,72.09642328945313,-1.2445133968860294,16.147591339350242,136.75291494576632,-10474725.135160498,773752.0020445664,96.0,40.0,-60.0,18.59997599999997,703.5499880000001,714.3499760000002,722.6499640000002,733.4499520000002,695.2500000000002,684.4500120000001,676.1500240000003,0.6963353252381054,1000690787.0,+1
2018-12-18,686.5,686.5,674.549988,694.400024,676.599976,8021298.0,683.8350036,687.4127307636363,24.05004800000006,61.31208373923471,-3.1397409505825724,19.38636830963617,64.54565150643462,8739603.454379795,1135836.1589688952,92.0,36.0,23.999999999999993,22.200012000000015,685.1500040000001,695.7500200000002,697.1000160000001,707.7000320000002,683.8000080000002,673.1999920000001,671.8499960000001,1.6610892106217148,992669489.0,-1
2018-12-19,671.549988,671.549988,661.099976,676.599976,664.849976,8295459.0,682.9700012000001,686.0972712,-8.65002400000003,48.517579639836995,-6.035470192897938,20.53446485818006,10.59074275126394,-25986954.47815077,-97017.96090018147,88.0,32.0,24.0,11.450012000000015,669.7499799999999,678.3999839999999,680.1999919999998,688.8499959999999,667.9499719999999,659.2999679999999,657.4999599999999,1.4832518852609908,984374030.0,-1
2018-12-20,660.0,671.549988,656.400024,664.849976,667.049988,11705260.0,681.3149964,682.8027211636364,-16.55004800000006,41.863638523766745,-7.9469717010514795,21.39019336543356,-11.797934180886589,-1485995.3536501771,-160153.29693427222,84.0,28.000000000000004,24.0,25.5,664.2666626666667,672.1333013333333,679.4166266666666,687.2832653333332,656.9833373333333,649.1166986666667,641.8333733333334,0.5577539326166032,972668770.0,-1
2018-12-21,659.5,659.5,643.450012,667.049988,646.200012,12802132.0,681.1699952,680.2090832727272,-1.4500120000000152,43.53658503984123,-7.589071594161613,20.334808797102596,-42.457199864677804,-2121902.7738197627,-249323.7277017946,80.0,24.0,52.0,35.200012000000015,656.6666666666666,669.8833213333332,672.7166546666665,685.9333093333332,653.8333333333333,640.6166786666666,637.7833453333333,1.4704045884644894,985470902.0,+1
2018-12-24,657.0,658.799988,647.599976,646.200012,649.0,8379825.0,677.5099976000001,673.8509045090909,-36.59997599999997,33.11584673340931,-10.98096611066928,18.39158511966093,-67.69634777795389,-617747.4418294559,-266070.2601621428,76.0,20.0,56.0,19.09997599999997,650.8666586666667,654.1333413333334,662.0666706666666,665.3333533333334,642.9333293333334,639.6666466666667,631.7333173333334,-0.12499665178929742,977091077.0,-1
2018-12-26,647.0,647.0,637.349976,649.0,644.049988,6178552.0,675.4899964000001,668.6672685818182,-20.200012000000015,35.5077848566347,-10.525461320472532,18.391947581825093,-91.64593618678234,-3692815.224776348,-421831.3949173341,72.0,16.0,56.0,31.5,644.449992,651.5500079999999,654.1000159999999,661.200032,641.8999839999999,634.7999679999999,632.2499599999999,1.207253370561565,983269629.0,+1
2018-12-27,652.75,663.25,649.0,644.049988,656.799988,15333902.0,672.4449952,662.9509034181818,-30.450012000000015,33.09360938945012,-11.330734120760035,15.863037199248083,-66.18000034202615,-982336.2894912965,-447308.8901252415,68.0,12.0,56.0,33.30004800000006,652.099996,655.1999920000001,666.3499959999999,669.4499920000001,640.9499920000001,637.849996,626.6999920000001,-0.3473692631578958,967935727.0,-1
2018-12-28,663.349976,663.5,653.299988,656.799988,656.950012,4736598.0,670.2749940000001,660.1063566545455,-21.700012000000015,44.340584490184355,-9.25655163318917,15.43654810140356,-46.02378263797732,4616455.569803774,-217137.77831028606,64.0,8.0,56.0,20.19995199999994,657.8666586666667,662.4333293333334,668.0666706666668,672.6333413333334,652.2333173333334,647.6666466666667,642.0333053333334,0.3431368512115471,972672325.0,+1
2018-12-31,660.0,662.0,655.799988,656.950012,658.950012,3373319.0,666.1949952,657.6836326545455,-40.799987999999985,44.46732492391839,-9.232145581933061,13.587806627336704,-44.17177610484543,-8644845.245974062,-600215.3904768217,60.0,4.0,56.0,21.399963999999954,658.25,660.700012,664.450012,666.900024,654.5,652.049988,648.299988,0.18548738292765038,976045644.0,+1
2019-01-01,660.950012,666.299988,654.150024,658.950012,665.049988,2943390.0,661.4849975999999,656.3663629818182,-47.09997599999997,46.346602524161746,-8.906783623098416,9.694587714000136,-38.21316763480571,-2518623.5546016125,-687415.7615734031,56.00000000000001,0.0,56.0,19.450012000000015,659.800008,665.4499920000001,671.9499719999999,677.599956,653.3000280000001,647.6500440000001,641.1500640000002,0.3950619112945522,978989034.0,+1
2019-01-02,666.0,674.0,662.049988,665.049988,669.049988,7416655.0,658.549994,657.0145430545455,-29.350036000000046,52.056380230972216,-7.914433552996258,3.0759399264356944,-12.170017992973728,-9627338.507425059,-1093775.8863848422,52.0,0.0,56.0,9.65002400000003,667.0333253333333,672.0166626666667,678.9833373333333,683.9666746666667,660.0666506666666,655.0833133333333,648.1166386666666,0.25104577300842845,986405689.0,+1
2019-01-07,665.0,673.599976,661.5,661.049988,671.700012,8046340.0,657.6250000000001,661.5018177454546,-6.0,46.41857922910871,-8.28913926562673,-13.41990721913703,-17.4039743611229,-53059785.758630775,-3404311.659545606,40.0,68.0,56.0,6.200012000000015,665.3833213333334,669.2666426666667,677.4832973333332,681.3666186666667,657.1666666666667,653.2833453333334,645.0666906666668,-0.03719114814773321,993075908.0,-1
2019-01-09,686.200012,689.799988,664.0,670.049988,676.099976,18130292.0,662.2799987999999,665.8563632,21.049987999999985,55.25278472516552,-3.34292491556381,-15.370718882715892,36.45724162810881,-13605664.235479085,-4970613.95088651,32.0,60.0,52.0,15.049987999999985,674.6166586666667,685.2333173333334,700.4166466666666,711.0333053333334,659.4333293333334,648.8166706666667,633.6333413333334,0.2344957679825273,983567161.0,-1
2019-01-18,730.0,736.200012,726.299988,733.349976,730.950012,5902151.0,694.0749940000001,707.4418103272726,64.19995199999994,83.16157166414837,-0.8828162500000047,6.718522854077037,196.37763344257468,751253.1967205192,-3072040.8093579174,96.0,32.0,-28.0,13.0,731.949992,737.5999959999999,741.8500160000001,747.50002,727.6999719999999,722.0499679999999,717.7999479999999,0.7121182736526662,1055066362.0,-1
2019-01-21,738.200012,751.0,734.0,730.950012,745.0,8129422.0,701.0649963999999,714.1463590545455,69.90002400000003,79.84482964606603,-3.075151533742329,9.946562706096529,177.68349155993312,5315929.647770549,-2690769.424942987,92.0,28.000000000000004,-28.0,30.5,738.6500040000001,743.3000080000002,755.6500040000001,760.3000080000002,726.3000080000002,721.6500040000001,709.3000080000002,-0.1794110588235285,1046936940.0,-1
2019-01-24,728.099976,736.099976,721.0,731.650024,732.0,7429783.0,721.4799988000001,731.712725309091,55.55004800000006,66.11370598309583,-2.967787730061345,27.881653887390826,72.4921029419474,-13934497.201580457,-2863306.522137042,88.0,16.0,60.0,12.40002400000003,729.5833333333334,738.1666666666667,744.6833093333335,753.2666426666667,723.0666906666668,714.4833573333334,707.9667146666668,0.7053007236567828,1053442631.0,-1
2019-04-01,742.0,760.0,742.0,737.799988,755.099976,6584982.0,720.5849976000001,726.7472679272728,25.450012000000015,60.8908762698413,-3.3585494704992462,-13.873689466956876,76.19431504019936,9532795.969424667,-1122305.160366169,24.0,80.0,-80.0,18.350036000000046,746.5999959999999,751.1999919999998,764.5999959999999,769.1999919999998,733.1999919999998,728.5999959999999,715.1999919999998,-0.23333400000000085,987733730.0,-1
2019-04-04,751.400024,753.799988,745.099976,753.299988,747.900024,7688525.0,734.6999940000001,743.4799949818182,44.84997599999997,65.70081695821338,-1.8746251087215078,-6.776542212548179,74.42837694484561,11798317.150780873,3146895.537831653,92.0,68.0,-88.0,24.09997599999997,750.7333173333333,756.3666586666666,759.4333293333334,765.0666706666666,747.6666466666666,742.0333053333333,738.9666346666666,0.9425288149027842,994225932.0,-1
2019-04-05,750.900024,760.950012,748.0,747.900024,759.299988,6276040.0,738.6549988,745.8800004363636,39.55004800000006,59.39943075439847,-2.6844577567688788,-3.9375055199573126,77.8256637104602,18330630.49199581,3837065.3084754786,88.0,64.0,-56.0,11.850036000000046,752.2833453333333,756.5666906666665,765.2333573333333,769.5167026666666,743.6166786666665,739.3333333333333,730.6666666666665,-0.0077201472863476514,987949892.0,-1
2019-04-10,764.0,766.700012,751.299988,760.599976,752.700012,7031088.0,752.2699952,756.3036311272728,38.34997599999997,63.35458914077027,-1.8397661721068295,8.133989062254045,86.67738773751827,-3278279.231748082,2892850.918146087,96.0,52.0,20.0,0.0,759.5333253333333,767.7666626666667,774.9333493333334,783.1666866666667,752.3666386666666,744.1333013333333,736.9666146666666,0.6038943835412183,992569407.0,-1
2019-04-11,751.75,751.75,740.049988,752.700012,742.700012,8200995.0,753.6449952,756.3818159999998,13.75,54.84552681239255,-3.011867655786348,14.095427827108665,43.05828090579053,6192716.992925292,3042844.830636051,92.0,48.0,-56.0,0.0,748.1666666666666,756.2833453333333,759.8666786666665,767.9833573333333,744.5833333333333,736.4666546666666,732.8833213333332,1.0811975235580966,984368412.0,-1
2019-04-12,743.099976,751.549988,740.599976,742.700012,747.75,7043212.0,753.6049988000001,754.3918190545455,-0.39996399999995447,45.851053469950415,-4.4955471810089,17.806283004068973,27.77069169043982,-7469781.294388125,2564998.1885894975,88.0,44.0,20.0,28.0,744.949992,749.3000079999999,755.9000040000001,760.25002,738.3499959999999,733.9999799999999,727.3999839999999,0.19178389941490864,977325200.0,-1
2019-04-16,727.900024,727.900024,714.099976,727.5,724.099976,12524411.0,751.8400024000001,748.4000010909091,-27.59997599999997,36.032495936930495,-6.750741839762611,19.4065123567309,-56.097822465641116,8334014.406683038,2285519.735774783,80.0,36.0,24.0,14.30004800000006,723.1666666666666,732.2333573333333,736.9667146666666,746.0334053333333,718.4333093333332,709.3666186666666,704.6332613333332,0.9710128544480404,996375592.0,-1
2019-04-18,722.5,722.5,712.75,724.099976,717.049988,13801105.0,748.3099976000001,743.3563599272727,-35.30004800000006,34.13123343197641,-7.255196439169144,20.85026310360638,-66.9835835275769,6149725.28629119,2461165.442616438,76.0,32.0,24.0,12.950012000000015,719.7833253333333,726.8166506666666,729.5333253333333,736.5666506666666,717.0666506666666,710.0333253333333,707.3166506666666,1.1641001025640993,982574487.0,-1
2019-04-22,717.049988,725.75,715.0,717.049988,721.049988,6455426.0,744.6849976000001,737.6727218181818,-36.25,30.305431273584333,-8.30118872403561,19.13349574319443,-68.47946227716028,11718322.79046819,2881945.3220642456,72.0,28.000000000000004,24.0,22.09997599999997,719.2666626666665,723.5333253333331,730.0166626666664,734.2833253333331,712.7833253333331,708.5166626666665,702.0333253333331,0.19069655813953348,976119061.0,-1
2019-04-24,728.200012,737.900024,724.0,728.200012,736.450012,8285120.0,738.8899964,730.866359709091,-31.09997599999997,43.09407794935581,-6.6468824925816,14.513653430315685,-34.924459240055754,4340451.290167559,2557563.0084824557,64.0,20.0,44.0,15.950012000000015,730.0333453333333,736.0666906666665,743.9333693333333,749.9667146666666,722.1666666666665,716.1333213333332,708.2666426666665,0.3021586149779314,989920849.0,+1
2019-04-25,736.450012,737.650024,727.049988,736.450012,728.549988,8005235.0,735.8099976,730.4227261818181,-30.799987999999985,51.13389345756808,-5.422846884272995,12.439557305690187,-27.744436320340995,-3774790.518386223,2269728.757261152,60.0,16.0,44.0,20.549987999999985,733.7166746666667,740.3833613333334,744.3167106666667,750.9833973333334,729.7833253333333,723.1166386666666,719.1832893333333,0.8867917052357172,997926084.0,+1
2019-04-26,731.0,739.799988,729.0,728.549988,738.0,6895168.0,732.6049988,729.1027244363636,-32.049987999999985,44.229534588632426,-6.594957270029676,8.33160972605583,-34.85824526376641,835215.2767236134,2204523.5990549,56.00000000000001,12.0,44.0,12.100036000000046,732.449992,735.8999839999999,743.24998,746.6999719999999,725.0999959999999,721.650004,714.3000079999999,-0.04166782407536155,991030916.0,-1
2019-04-30,738.0,753.799988,738.0,738.0,751.349976,9920046.0,731.1349975999999,730.0836337454546,-14.700012000000015,52.990500285995715,-5.192878338278932,2.7338695051557806,5.52474936354517,-2301308.5941908583,1999713.0448164563,52.0,8.0,44.0,30.100036000000046,743.2666626666665,748.5333253333331,759.0666506666666,764.3333133333331,732.7333373333331,727.4666746666666,716.9333493333331,0.0,1000950962.0,+1
2019-05-02,747.0,748.400024,729.5,751.349976,730.799988,6351352.0,731.9999939999999,733.7590843636362,8.649963999999954,62.573877407554455,-3.21216973293769,-1.9073263174675503,4.291530576103467,13410590.16394942,2518389.277504319,48.0,4.0,44.0,33.65002400000003,743.0833333333334,756.6666666666667,761.9833573333335,775.5666906666668,737.7666426666667,724.1833093333333,718.8666186666667,1.1560819182028517,1007302314.0,+1
2019-05-03,722.900024,731.0,718.200012,730.799988,723.599976,6348116.0,730.3049927999999,733.5409014545454,-16.950012000000015,45.93973460106144,-6.261129376854601,-6.283398502820205,-72.12294899881786,-5345732.582148501,2160929.192974645,44.0,0.0,44.0,14.75,726.6666666666666,735.1333213333332,739.4666546666665,747.9333093333332,722.3333333333333,713.8666786666666,709.5333453333333,0.9843740478506686,1000954198.0,-1
2019-05-06,715.0,721.799988,710.650024,723.599976,718.400024,8858265.0,729.9149904000001,732.321807490909,-3.9000240000000304,41.48179246158977,-6.455000033757681,-9.093220725366109,-113.17654496243166,-8636784.154330963,1670124.04082439,40.0,0.0,44.0,10.75,718.6833293333333,726.7166346666666,729.8332933333331,737.8665986666665,715.5666706666666,707.5333653333333,704.4167066666666,1.1614344225685385,992095933.0,-1
2019-05-07,720.400024,727.900024,718.700012,718.400024,724.549988,5747436.0,729.3449952000001,730.2281772363635,-5.699951999999939,38.378333022001364,-5.406225511415244,-13.503747665778064,-89.73992543417133,5350707.154148914,1837423.273248232,36.0,96.0,44.0,12.950012000000015,721.6666866666668,724.6333613333336,730.8666986666669,733.8333733333336,715.4333493333336,712.4666746666668,706.2333373333336,-0.032607348773021634,986348497.0,-1
2019-05-08,721.0,726.0,716.5,724.549988,719.349976,6247642.0,730.0949952000002,729.3563577454545,7.5,44.08685438800321,-4.4670129102079335,-14.436342171254068,-76.22748673896969,8465253.39033876,2138688.278570529,32.0,92.0,44.0,16.850036000000046,722.3499959999999,728.1999919999998,731.8499959999999,737.6999919999998,718.6999919999998,712.8499959999999,709.1999919999998,0.8473671578947353,992596139.0,+1
2019-05-09,719.150024,730.299988,715.799988,719.349976,721.049988,7396525.0,729.924994,727.4027178909091,-1.7000120000000152,40.432578705130716,-5.261150371310028,-14.005163290265386,-68.3558593427395,8356386.90433292,2421310.9433779106,28.000000000000004,88.0,44.0,10.600036000000046,721.8166506666666,727.8333133333333,736.3166506666666,742.3333133333333,713.3333133333333,707.3166506666666,698.8333133333333,0.24482675862068862,985199614.0,-1
2019-05-10,720.799988,726.0,715.0,721.049988,716.849976,8352335.0,729.2099916,725.7890804363635,-7.15002400000003,42.23861043239005,-5.00152727553196,-12.233062961772589,-61.54475212102579,-3425922.71529886,2155527.5952562387,24.0,84.0,44.00000000000001,10.799987999999985,720.6833293333333,726.3666586666666,731.6833293333334,737.3666586666666,715.3666586666666,709.6833293333333,704.3666586666666,0.5499989090909078,993551949.0,+1
2019-05-13,716.549988,726.450012,712.099976,716.849976,719.700012,6808993.0,727.2499879999999,723.5418048727273,-19.600036000000046,38.878364856882605,-5.642946346541475,-11.33770430514312,-61.91200824881192,2010405.9215758848,2148931.1555434954,20.0,80.0,44.0,25.25,718.4666546666667,724.8333333333335,732.8166906666668,739.1833693333335,710.4832973333334,704.1166186666667,696.1332613333334,0.331009622554256,986742956.0,-1
2019-05-14,716.5,717.75,703.599976,719.700012,713.849976,10513001.0,726.3649903999999,722.1690819636365,-8.84997599999997,42.462311439718,-5.207693436915575,-10.23341788525056,-78.60995846246962,-6271346.039594415,1766191.2830372266,16.0,76.0,44.0,18.90002400000003,713.6833293333333,723.7666826666666,727.8333533333334,737.9167066666666,709.6166586666666,699.5333053333333,695.4666346666666,1.1378098015946836,997255957.0,+1
2019-05-15,714.900024,725.200012,712.599976,713.849976,716.099976,6668929.0,723.949988,719.8936248,-24.15002400000003,37.28445020827158,-6.101101516819211,-10.159843323160658,-52.176874793568246,-1111136.629163265,1635403.650664477,12.0,96.0,44.0,33.149963999999954,717.2166546666667,721.8333333333335,729.8166906666668,734.4333693333335,709.2332973333334,704.6166186666667,696.6332613333334,0.09920606576044667,990587028.0,-1
2019-05-16,720.0,737.0,719.099976,716.099976,733.099976,6468556.0,720.424988,718.4663498909091,-35.25,40.50407936043555,-5.757485139110909,-9.372760172528501,-6.823525434393253,-27290771.451374456,320577.50966270635,8.0,92.0,40.0,20.149963999999954,724.0666506666666,729.0333253333333,741.9666746666667,746.9333493333334,711.1333013333333,706.1666266666666,693.2332773333333,-0.16759754065134186,997055584.0,+1
2019-05-17,733.150024,735.799988,720.099976,733.099976,723.900024,8155948.0,720.6549868,720.7708931636364,2.299987999999985,58.89898236337626,-3.161272507537068,-9.845879804150172,29.29814560857467,-1132337.283539325,254535.92815352307,4.0,88.0,-60.0,9.200012000000015,729.6666466666666,739.2333173333332,745.3666586666666,754.9333293333332,723.5333053333331,713.9666346666666,707.8332933333331,0.8280248448217739,1005211532.0,+1
2019-05-20,719.700012,726.400024,706.0,723.900024,722.400024,11213708.0,720.6849916,721.3608999272726,0.3000480000000607,49.36794983288038,-4.56627436590606,-11.83838084283866,-40.83596528261106,-4311220.226954928,47001.557466775135,0.0,84.0,-60.0,9.5,718.7666826666667,731.5333653333334,739.1667066666669,751.9333893333335,711.1333413333334,698.3666586666667,690.7333173333334,0.8774511245673046,993997824.0,-1
