date,open,high,low,close,Adj Close,volume,SMA,WMA,MOM,RSI,WilliamK,MACD,CCI,acc_dist,AD21,Arronup,AroonDown,AroonOscillator,ATR,Pivot_Point,Resistance_1,Resistance_2,Resistance_3,Support_1,Support_2,Support_3,SO%k,On_Balance_Volume,y
2013-06-04,1555.650024,1588.75,1539.300049,1568.550049,1470.401123,431388.0,,,,,,-3.0987416014409064,,-230151.78824525952,-79195.01300069655,,,,0.0,1565.533366,1591.7666829999998,1614.9833169999997,1641.2166339999999,1542.3167319999998,1516.0834149999998,1492.8667809999997,0.5915071584196305,978.0,-1
2013-06-05,1550.099976,1576.300049,1533.25,1546.800049,1490.7915039999998,621196.0,,,,,,-3.0987416014409064,,-125583.37419193942,-95382.44401480006,,,,66.29992700000003,1552.1166993333334,1570.9833986666667,1595.166748333333,1614.0334476666667,1527.9333496666668,1509.0666503333334,1484.8833006666669,0.3147510703181769,-620218.0,-1
2013-06-06,1558.800049,1598.800049,1550.0,1568.25,1508.710571,498248.0,,,,,,-3.0987416014409064,,927000.3795910637,178315.414080869,,,,43.050048999999944,1572.350016333333,1594.7000326666662,1621.1500653333333,1643.5000816666661,1545.8999836666662,1523.5499673333331,1497.0999346666663,0.3739750343283471,-121970.0,+1
2013-06-07,1565.0,1583.5,1545.0,1587.099976,1478.10083,780953.0,,,,,,-3.0987416014409064,,133114.54672384032,168415.21073604954,,,,52.0,1571.8666586666666,1598.7333173333332,1610.3666586666668,1637.2333173333332,1560.2333173333332,1533.3666586666666,1521.7333173333332,1.0935058701298694,658983.0,+1
2013-06-10,1575.0,1580.949951,1510.150024,1554.900024,1446.6834720000002,503982.0,,,,,,-3.0987416014409064,,703813.8748535989,268338.05318590347,,,,38.5,1548.6666663333333,1587.1833086666666,1619.466593333333,1657.9832356666666,1516.3833816666665,1477.8667393333333,1445.5834546666665,0.6320627985958231,155001.0,-1
2013-06-11,1512.0,1521.0,1481.0,1521.849976,1416.8342289999998,675122.0,,,,,,-3.0987416014409064,,484700.8659893536,303722.8499477674,,,,76.94995199999994,1507.9499919999998,1534.8999839999997,1547.9499919999998,1574.8999839999997,1494.8999839999997,1467.9499919999998,1454.8999839999997,1.0212493999999992,-520121.0,-1
2013-06-12,1486.0,1490.0,1461.900024,1490.449951,1406.567749,469660.0,,,,,,-3.0987416014409064,,1487208.0433660964,476832.1664146444,,,,73.90002400000003,1480.783325,1499.6666260000002,1508.8833010000003,1527.7666020000001,1471.5666500000002,1452.6833490000001,1443.4666740000002,1.0160125047793656,-989781.0,-1
2013-06-13,1459.0,1461.5,1430.0,1479.650024,1384.6561279999999,690959.0,,,,,,-3.0987416014409064,,-622575.8618084124,330748.49128019897,,,,59.94995199999994,1457.0500080000002,1484.1000160000003,1488.5500080000002,1515.6000160000003,1452.6000160000003,1425.5500080000002,1421.1000160000003,1.576191238095239,-1680740.0,-1
2013-06-14,1482.0,1520.0,1471.650024,1456.599976,1439.363525,383703.0,1537.9750001,1516.0072665636362,,,,-3.0987416014409064,,-324811.94840195304,250643.7757139929,,,,60.449951000000056,1482.75,1493.849976,1531.099976,1542.199952,1445.5,1434.400024,1397.150024,-0.3112731224520167,-2064443.0,-1
2013-06-17,1535.099976,1551.400024,1505.099976,1514.150024,1459.421509,533292.0,1528.8300049000002,1511.6754527272728,-91.44995199999994,,,-3.0987416014409064,,50953.75,227982.1216541635,,,,48.34997599999997,1523.5500080000002,1542.0000400000004,1569.8500560000002,1588.3000880000004,1495.6999920000003,1477.24996,1449.3999440000002,0.1954651969259308,-1531151.0,+1
2013-06-18,1535.0,1547.0,1521.0,1535.25,1462.5585939999999,529919.0,1525.5000000000002,1512.8427245636362,-33.300048999999944,,,-3.0987416014409064,,54919.70676046889,209593.26621523526,,,,94.80004800000006,1534.4166666666667,1547.8333333333335,1560.416666666667,1573.8333333333335,1521.8333333333335,1508.4166666666667,1495.8333333333335,0.5480769230769231,-1001232.0,+1
2013-06-19,1529.199951,1549.5,1524.0,1538.550049,1467.501831,389004.0,1524.6750000000002,1515.2154607454545,-8.25,,,-3.0987416014409064,,565496.0253142363,245242.42941877115,,,,32.84997599999997,1537.350016333333,1550.7000326666662,1562.8500163333329,1576.2000326666662,1525.2000326666662,1511.850016333333,1499.7000326666662,0.570590156862743,-612228.0,+1
2013-06-20,1520.0,1540.900024,1493.25,1543.75,1449.8203130000002,505078.0,1522.2250000000001,1518.6836425636363,-24.5,52.3980344555695,,-7.2812002311359265,,-192247.23739120006,203694.2168254947,,,,25.5,1525.966674666667,1558.6833493333338,1573.6166986666667,1606.3333733333338,1511.0333253333338,1478.3166506666669,1463.3833013333337,1.0598105889726304,-107150.0,+1
2013-06-21,1520.0,1559.900024,1511.75,1525.150024,1477.8634029999998,433570.0,1516.0300048000001,1519.215465109091,-61.94995199999994,45.294037604882305,-4.983505742490945,-9.64012735887809,,96811.59293940624,194022.51307510547,,,,47.65002400000003,1532.2666826666666,1552.7833653333332,1580.4167066666669,1600.9333893333333,1504.6333413333332,1484.1166586666666,1456.4833173333332,0.2782973483045413,-540720.0,-1
2013-06-24,1546.0,1572.0,1531.800049,1554.650024,1468.166992,707604.0,1516.0050048,1526.237286781818,-0.25,56.16897829800517,-2.9437274008250096,-13.87741224416959,,259827.0468804424,199720.49514350554,,,,48.15002400000003,1552.816691,1573.833333,1593.016642,1614.033284,1533.633382,1512.61674,1493.433431,0.5684080311441189,166884.0,+1
2013-06-25,1540.0,1557.199951,1502.25,1544.449951,1468.880005,484805.0,1518.2650023,1531.4090951818182,22.599975000000086,52.041619641765884,-3.6238229246784006,-21.710333816962248,,174285.06546593437,197605.0717143765,,,,46.84997599999997,1534.6333006666666,1567.0166013333333,1589.583251666667,1621.9665523333333,1512.0666503333332,1479.6833496666666,1457.1166993333331,0.7679706757154344,-317921.0,-1
2013-06-26,1546.199951,1557.900024,1513.599976,1545.199951,1468.452148,408512.0,1523.7400023,1536.3063585818181,54.75,52.33874998452742,-3.573816258756496,-25.638087033851207,,122092.11370560237,191553.02727189017,,,,54.949951000000056,1538.899983666667,1564.1999913333339,1583.2000316666667,1608.500039333334,1519.8999433333338,1494.5999356666669,1475.5998953333337,0.7133169471960853,90591.0,+1
2013-06-27,1560.0,1565.0,1511.199951,1544.75,1446.06543,493875.0,1530.2499999000001,1540.1263581636363,65.09997599999997,52.11523888565786,-2.610306500505221,-25.224957655549133,,-331114.6291531359,151067.9022809413,,,,44.30004800000006,1540.3166503333334,1569.4333496666668,1594.1166993333331,1623.2333986666667,1515.6333006666669,1486.5166013333335,1461.833251666667,0.6236062907675043,-403284.0,-1
2013-06-28,1540.0,1549.199951,1517.099976,1521.199951,1461.797974,444718.0,1536.7099974,1538.4808947272727,64.59997500000009,41.430372686110346,-4.031850060771721,-21.406299634095376,,-493370.16949456185,102698.62167341835,,,,53.800048999999944,1529.1666260000002,1541.2332760000004,1561.2666010000003,1573.3332510000005,1509.1333010000003,1497.066651,1477.0333260000002,0.12772517735605945,-848002.0,-1
2013-07-01,1540.0,1622.400024,1515.0,1537.75,1526.154175,856025.0,1539.0699950000005,1538.6699861090908,23.59997599999997,49.7794947184652,-5.556651087462503,-14.87980356709295,,245911.48894322722,113138.63638658063,,,,32.099975000000086,1558.3833413333334,1601.7666826666668,1665.7833653333337,1709.1667066666669,1494.3666586666668,1450.9833173333334,1386.9666346666668,0.21182490610989058,8023.0,+1
2013-07-02,1590.5,1619.0,1572.5,1605.449951,1500.6777339999999,589430.0,1546.0899901000005,1550.739069018182,70.19995100000006,69.97871492872801,-1.1126475471290904,-1.1699267477160902,,141515.11501928087,115151.98693186183,,,,107.40002400000003,1598.9833170000002,1625.4666340000003,1645.4833170000002,1671.9666340000003,1578.9666340000003,1552.4833170000002,1532.4666340000003,0.7086010967741947,597453.0,+1
2013-07-03,1561.0,1581.0,1555.650024,1578.650024,1483.852173,173724.0,1550.0999876000003,1556.6590751818183,40.099975000000086,59.11783081723617,-2.8718655186262487,4.307197502230338,,75007.09171398262,112374.46883691671,,,,81.25,1571.7666826666666,1587.8833413333332,1597.1166586666664,1613.2333173333332,1562.5333653333332,1546.4167066666666,1537.1833893333333,0.9072986893557622,423729.0,-1
2013-07-04,1570.0,1577.0,1533.050049,1560.949951,1480.429932,278194.0,1551.8199827000003,1558.6317958,17.199951000000056,52.86525583993923,-4.033745046074647,6.429715232584158,,-97957.40558400063,98159.52824371024,,,,49.799927000000025,1557.0,1580.949951,1600.949951,1624.899902,1537.0,1513.050049,1493.050049,0.634810764635439,145535.0,-1
2013-07-05,1571.0,1575.0,1549.0,1557.349976,1477.768311,273858.0,1555.0399779000002,1559.6372491272728,32.19995199999994,51.58488659943045,-4.2700569105413155,8.108008977002328,,151812.21497781712,101707.0558877029,,,,45.599975000000086,1560.4499919999998,1571.8999839999997,1586.4499919999998,1597.8999839999997,1545.8999839999997,1534.4499919999998,1519.8999839999997,0.3211529230769219,-128323.0,-1
2013-07-08,1545.0,1563.0,1530.0,1554.550049,1474.441284,311166.0,1555.0299804,1559.5481711454545,-0.09997500000008586,50.48753898016246,-4.453851511820646,9.066043907665971,,536237.8692503553,129856.60099223496,80.0,32.0,,26.0,1549.1833496666666,1568.3666993333331,1582.1833496666668,1601.3666993333331,1535.3666993333331,1516.1833496666666,1502.3666993333331,0.7439408787878771,-439489.0,-1
2013-07-09,1544.0,1549.0,1521.0,1551.050049,1467.59668,467745.0,1555.6899902,1558.8245472545455,6.600097999999889,48.98456909013741,-4.6836007533107455,12.612298769270637,,141086.184099926,130570.27674222983,76.0,28.000000000000004,48.0,33.0,1540.350016333333,1559.7000326666662,1568.3500163333329,1587.7000326666662,1531.7000326666662,1512.350016333333,1503.7000326666662,1.0732160357142837,-907234.0,-1
2013-07-10,1537.050049,1549.650024,1530.0,1543.849976,1467.264038,344394.0,1555.5549927000002,1556.6718174,-1.3499750000000859,45.7516863889455,-5.156232556288844,13.62804548411168,,70743.76477158672,126835.70219120165,72.0,24.0,48.0,33.550048999999944,1541.1666666666667,1552.3333333333335,1560.8166906666665,1571.9833573333335,1532.6833093333335,1521.5166426666667,1513.0332853333334,0.7048325233597653,-1251628.0,-1
2013-07-11,1560.0,1579.099976,1497.25,1543.5,1431.188477,543696.0,1555.4299927000002,1554.4800005454545,-1.25,45.58296021790811,-5.179205905014482,14.727541203144938,,959635.2855581068,177954.46037654366,68.0,20.0,48.0,21.050048999999944,1539.9499919999998,1582.6499839999997,1621.7999679999998,1664.4999599999996,1500.8000079999997,1458.1000159999999,1418.9500319999997,0.5650581986731433,-1795324.0,-1
2013-07-12,1495.0,1505.050049,1438.5,1505.550049,1376.4334720000002,945429.0,1553.8650025,1545.4109198727272,-15.649902000000111,31.19087400558682,-7.670340892682044,16.1756323693553,,-36921.2447338723,164971.77631153326,64.0,16.0,48.0,81.84997599999997,1483.033366,1527.5667319999998,1549.583415,1594.1167809999997,1461.0166829999998,1416.483317,1394.4666339999999,1.0075131424771753,-2740753.0,-1
2013-07-15,1449.0,1465.0,1433.150024,1447.949951,1375.1499019999999,522612.0,1544.8849976000004,1526.1536377818181,-89.80004899999994,20.08499621324043,-11.451363414183586,17.385279200276727,,1762028.0470601642,260042.39988826594,60.0,12.0,48.0,105.0,1448.6999916666666,1464.2499593333332,1480.5499676666664,1496.0999353333332,1432.3999833333332,1416.8500156666666,1400.5500073333333,0.46467623711867284,-3263365.0,-1
2013-07-16,1429.0,1429.900024,1401.0,1446.599976,1341.546021,817379.0,1529.0000001000003,1508.2836338545453,-158.8499750000001,19.89344463010454,-11.539979337692333,19.7343679383996,,-430193.2982292443,219523.85478028553,56.00000000000001,8.0,48.0,72.40002499999991,1425.8333333333333,1450.6666666666665,1454.7333573333335,1479.5666906666665,1421.7666426666665,1396.9333093333332,1392.8666186666665,1.5778525305030862,-4080744.0,-1
2013-07-17,1412.25,1432.800049,1401.5,1411.25,1350.9571529999998,1141103.0,1512.2599977000002,1486.8745429272726,-167.40002400000003,15.443369380915072,-13.860445101318971,16.750130271980424,,-305975.9857968178,189079.04331472373,52.0,96.0,48.00000000000001,46.949951000000056,1415.1833496666666,1428.8666993333331,1446.4833986666663,1460.166748333333,1397.5666503333332,1383.8833006666666,1366.2666013333333,0.3115011097905955,-5221847.0,-1
2013-07-18,1415.0,1456.0,1407.199951,1421.150024,1374.1521,714436.0,1498.280005,1470.3090931636364,-139.79992700000003,21.143562251787756,-13.210581385680745,1.930616766989715,-152.43665873555886,-40519.08886247152,175941.2501366218,48.0,92.0,-44.0,45.09997599999997,1428.1166583333334,1449.0333656666667,1476.9167073333333,1497.8334146666666,1400.2333166666667,1379.3166093333334,1351.4332676666668,0.28586186460591445,-4507411.0,+1
2013-07-19,1450.25,1462.0,1432.099976,1445.550049,1379.807983,403857.0,1487.1000123000003,1460.7218284363635,-111.79992700000003,33.82914833124559,-11.608899318226614,-10.518374880977262,-100.0994787771657,15429.619047619046,166863.4549586681,44.0,88.0,-44.0,48.800048999999944,1446.5500083333334,1461.0000406666668,1476.4500323333336,1490.9000646666668,1431.1000166666668,1416.6499843333334,1401.1999926666667,0.4498348563198465,-4103554.0,+1
2013-07-22,1437.0,1466.5,1435.0,1451.5,1376.908569,324022.0,1476.7950074000005,1454.2490989272728,-103.05004899999994,36.69454998484961,-11.019736842105262,-22.858794470387693,-81.201791445509,-126291.76648758948,150465.97761232572,40.0,84.0,-44.0,40.84997599999997,1451.0,1467.0,1482.5,1498.5,1435.5,1419.5,1404.0,0.5238095238095238,-3779532.0,+1
2013-07-23,1442.300049,1464.0,1439.699951,1448.449951,1377.14624,451305.0,1466.5349976000002,1449.095452309091,-102.60009799999989,35.778164557910884,-8.943997908232115,-32.15716877713385,-76.39790031770471,500934.8451164844,169865.9525075888,36.0,80.0,-44.0,31.5,1450.716634,1461.7333170000002,1475.0166830000003,1486.0333660000001,1437.4332680000002,1426.4165850000002,1413.1332190000003,0.36008157843632416,-4230837.0,-1
2013-07-24,1437.0,1443.800049,1402.099976,1448.699951,1346.109009,405613.0,1457.0199951000002,1445.8527165636365,-95.15002499999991,35.92949136847494,-8.810217357911768,-40.64935900375167,-91.83526109149442,-847347.6223045553,114110.72611349092,32.0,76.0,-44.0,24.300048999999944,1431.533325333333,1460.9666746666662,1473.2333983333333,1502.6667476666662,1419.2666016666662,1389.8332523333331,1377.5665286666663,1.117503439382471,-3825224.0,+1
2013-07-25,1420.400024,1452.150024,1402.25,1416.050049,1344.160034,1896090.0,1444.275,1438.4036354545456,-127.44995100000006,26.514716595378772,-11.016142804126364,-50.20569036794495,-88.69743051045873,351244.31237924076,126987.93175130602,28.000000000000004,72.0,-44.0,46.349975000000086,1423.4833576666667,1444.7167153333335,1473.3833816666665,1494.6167393333335,1394.8166913333334,1373.5833336666667,1344.9166673333334,0.2765539551644291,-5721314.0,-1
2013-07-26,1448.0,1448.0,1352.699951,1414.0,1307.466797,1226137.0,1435.1199951,1432.89909,-91.55004899999994,26.020737317917693,-11.15465027208405,-59.54283971635368,-97.59657195553581,619986.8819264177,153524.72055430379,24.0,68.0,-44.0,49.90002400000003,1404.899983666667,1457.1000163333338,1500.200032666667,1552.4000653333337,1361.7999673333338,1309.599934666667,1266.4999183333339,0.6432320827033361,-6947451.0,-1
2013-07-29,1375.0,1378.099976,1335.800049,1375.400024,1281.610229,710715.0,1427.8650024,1422.0409134363636,-72.54992700000003,18.52332509684274,-13.762580589353373,-72.09553887632978,-123.2053817192744,-142255.34582313837,137735.88197433573,20.0,96.0,-44.0,95.30004899999994,1363.1000163333333,1390.3999836666667,1405.3999433333333,1432.6999106666667,1348.1000566666667,1320.8000893333333,1305.8001296666666,0.9361712373640754,-7658166.0,-1
2013-07-30,1349.900024,1362.800049,1340.5,1348.199951,1276.09668,459744.0,1418.0249999,1407.5563586363635,-98.40002499999991,15.007474924322977,-15.600299219246788,-79.44225298220363,-109.54386907215795,646456.8372101824,164678.0383923773,16.0,96.0,-76.0,78.19995100000006,1350.5,1360.5,1372.800049,1382.800049,1338.199951,1328.199951,1315.899902,0.34528852380548913,-8117910.0,-1
2013-07-31,1336.0,1336.0,1292.0,1342.400024,1260.791992,500776.0,1411.1400023,1393.8063630181819,-68.84997599999997,14.337902738002128,-15.992159708000694,-80.36695978050034,-110.39651898921171,-624600.808216318,123188.79323287861,12.0,92.0,-80.0,34.90002400000003,1323.4666746666667,1354.9333493333334,1367.4666746666667,1398.9333493333334,1310.9333493333334,1279.4666746666667,1266.9333493333334,1.1454550909090917,-8618686.0,-1
2013-08-01,1326.0,1359.599976,1322.25,1326.300049,1274.100464,797570.0,1401.6550048000001,1378.3809169636363,-94.84997500000009,12.545165084271204,-12.712918727688905,-81.88033801974143,-81.37449237749237,-108679.69460230351,111086.45581809939,8.0,96.0,-80.0,56.199951000000056,1336.0500083333334,1349.8500166666668,1373.3999843333331,1387.1999926666667,1312.5000406666668,1298.7000323333334,1275.1500646666668,0.10843511653126492,-9416256.0,-1
2013-08-02,1358.0,1363.849976,1327.650024,1340.300049,1271.62854,360939.0,1391.1300048,1367.2254704545453,-105.25,22.29367466967267,-9.228515612431448,-78.4996299737436,-64.8958214191133,-110604.42875374657,99592.80724106405,4.0,92.0,-88.0,37.34997599999997,1343.9333496666666,1360.2166753333331,1380.1333016666663,1396.416627333333,1324.0167233333332,1307.7333976666666,1287.8167713333332,0.34944866777723727,-9055317.0,+1
2013-08-05,1345.25,1361.800049,1332.050049,1337.699951,1277.522583,178344.0,1379.7499999,1357.510915218182,-113.80004899999994,21.77356663620637,-9.418650749542957,-78.12683819206995,-57.587949027692005,120573.89229963673,100673.67197908051,0.0,88.0,-88.0,37.549927000000025,1343.8500163333333,1355.6499836666667,1373.6000163333333,1385.3999836666667,1325.8999836666667,1314.1000163333333,1296.1499836666667,0.1899126722689113,-9233661.0,-1
2013-08-06,1330.0,1358.75,1309.25,1343.900024,1266.16272,301434.0,1369.2950071999999,1350.992737781818,-104.54992700000003,26.49203752595173,-8.965263327239485,-80.30465859490596,-56.16658875645742,114387.84027402643,101375.91641010063,0.0,84.0,-88.0,29.75,1337.300008,1365.3500159999999,1386.8000080000002,1414.8500159999999,1315.8500159999999,1287.800008,1266.3500159999999,0.7000004848484854,-8932227.0,+1
2013-08-07,1345.0,1349.900024,1302.0,1331.949951,1265.116943,456603.0,1357.6200072,1344.2027275636365,-116.75,23.35863064966763,-9.839126069469833,-79.93319536375157,-56.75766444860732,-1410331.4396786115,24410.435172599973,0.0,80.0,-84.0,49.5,1327.9499916666666,1353.8999833333332,1375.8500156666669,1401.8000073333333,1305.9999593333332,1280.0499676666666,1258.0999353333332,0.6252596240870367,-9388830.0,-1
2013-08-08,1331.099976,1392.400024,1331.099976,1330.849976,1316.6401369999999,1398921.0,1349.0999998999998,1339.3354491636362,-85.20007299999997,23.068838034776206,-9.919562998171848,-81.42606445265619,-32.58708725695136,-211146.67254611885,12482.634655800308,20.0,76.0,-80.0,47.90002400000003,1351.449992,1371.8000080000002,1412.7500400000004,1433.1000560000002,1310.49996,1290.149944,1249.199912,-0.0040783002323260785,-10787751.0,-1
2013-08-12,1392.25,1409.0,1372.199951,1385.050049,1312.029663,700028.0,1346.2050047999999,1345.8718217272726,-28.949951000000056,54.88835409688426,-5.95612073126143,-83.36546416322767,-0.6755883787773377,-132881.4294615759,5159.845944467516,16.0,72.0,-56.0,61.30004800000006,1388.75,1405.300049,1425.550049,1442.100098,1368.5,1351.949951,1331.699951,0.3491869807021156,-10087723.0,+1
2013-08-13,1355.0,1412.849976,1355.0,1380.199951,1335.694336,1031827.0,1346.6849975,1352.0527210363637,4.799927000000025,52.64029292448864,-6.1391977289377255,-81.61024557395695,-2.9791509813875914,-205353.9763419985,-5392.964994588439,12.0,68.0,-56.0,78.15002400000003,1382.683309,1410.366618,1440.533285,1468.216594,1352.516642,1324.833333,1294.666666,0.4356086681868298,-11119550.0,-1
2013-08-14,1398.0,1424.0,1385.0,1396.949951,1330.196411,530381.0,1351.5599974999998,1361.1918034909093,48.75,59.285246230313824,-4.079375680519515,-79.5973963720719,14.512969342665675,1546111.8873896569,72020.30166029363,8.0,64.0,-56.0,57.84997599999997,1401.9833170000002,1418.9666340000003,1440.9833170000002,1457.9666340000003,1379.9666340000003,1362.9833170000002,1340.9666340000003,0.30640900000000143,-10589169.0,+1
2013-08-16,1389.150024,1389.199951,1317.150024,1391.199951,1266.994873,1464791.0,1356.4399902000002,1368.3990677636364,48.799927000000025,56.163905592358105,-4.504310085279943,-72.67863283140287,-15.242921875382958,156496.82180472114,76216.67206804255,4.0,60.0,-56.0,43.800048999999944,1365.8499753333333,1414.5499266666666,1437.899902333333,1486.5998536666666,1342.4999996666666,1293.8000483333333,1270.4500726666665,1.0277585291654772,-12053960.0,-1
2013-08-19,1320.0,1336.800049,1300.0,1325.099976,1251.074951,429786.0,1356.3199829,1362.7008833636364,-1.2000729999999749,33.06960220555882,-9.11045396590067,-63.82629645270845,-54.40002157720437,1001143.9082879975,121969.32792113136,0.0,56.00000000000001,-56.0,79.79992700000003,1320.6333416666666,1341.2666833333333,1357.4333906666666,1378.0667323333332,1304.4666343333333,1283.8332926666667,1267.6665853333334,0.6820636570348046,-12483746.0,-1
2013-08-20,1300.0,1306.699951,1268.599976,1308.449951,1240.987671,916913.0,1353.1349731,1353.9972412000002,-31.85009799999989,29.539319001560813,-8.720758415094336,-54.28787171570025,-74.39683031972196,-75277.51440120889,112251.25761465971,0.0,52.0,-56.00000000000001,91.19995100000006,1294.5832926666667,1320.5666093333334,1332.6832676666668,1358.6665843333335,1282.4666343333333,1256.4833176666666,1244.3666593333332,1.0459317886691526,-13400659.0,-1
2013-08-21,1313.0,1324.849976,1275.0,1297.900024,1228.127563,926580.0,1349.1549803999999,1343.9545231818183,-39.799927000000025,27.40073981467036,-9.516979320754714,-44.77862883385933,-65.26021581372899,578913.7416337699,135155.69380153253,20.0,96.0,-52.0,56.5,1299.25,1323.5,1349.099976,1373.349976,1273.650024,1249.400024,1223.800048,0.4593788370128813,-14327239.0,-1
2013-08-22,1284.199951,1299.0,1232.599976,1284.449951,1229.3227539999998,1030562.0,1343.2099731,1332.1899723818183,-59.450072999999975,24.76344317918752,-10.532079169811317,-40.836267700027065,-89.83554582568865,-199929.7448918962,118768.67278950174,16.0,92.0,-76.0,49.84997599999997,1272.0166423333333,1311.4333086666666,1338.416666333333,1377.8333326666666,1245.0332846666665,1205.6166183333332,1178.6332606666665,0.780872835226687,-15357801.0,-1
2013-08-23,1299.900024,1324.0,1266.050049,1285.699951,1236.30249,621224.0,1338.5849730999998,1321.733604727273,-46.25,25.532041477070308,-10.437739547169807,-36.5197569243287,-64.03337386260884,-492047.6846677969,88999.99064695938,12.0,96.0,-76.0,66.40002400000003,1291.9166666666667,1317.7832843333335,1349.866617666667,1375.7332353333336,1259.8333333333335,1233.9667156666667,1201.8833823333334,0.33908401406586336,-14736577.0,+1
2013-08-26,1300.0,1318.300049,1294.449951,1293.0,1250.78833,438706.0,1334.7999754999998,1313.4454277999998,-37.84997599999997,30.328176000462605,-9.88679245283019,-35.0514287914566,-48.45140293821625,963077.258792347,131459.60415856168,8.0,92.0,-84.0,57.949951000000056,1301.9166666666667,1309.3833823333334,1325.7667646666664,1333.2334803333333,1285.5332843333335,1278.0665686666669,1261.6831863333337,-0.06079434139013023,-14297871.0,+1
2013-08-27,1299.900024,1306.949951,1240.0,1308.150024,1204.988525,929746.0,1327.1099729999999,1308.5999820727272,-76.90002499999991,39.637619465234096,-8.743394415094336,-30.92551442924787,-67.07521722164516,1912087.955882353,217687.09721886765,4.0,88.0,-84.0,32.60009799999989,1285.033325,1330.0666500000002,1351.983276,1397.0166010000003,1263.1166990000002,1218.083374,1196.166748,1.0179249272340762,-13368125.0,+1
2013-08-28,1238.0,1249.0,1215.0,1260.25,1182.1365970000002,1150637.0,1315.1149779000002,1296.4436233454544,-119.94995100000006,26.647898523882915,-12.358490566037736,-26.1814207335201,-124.12308121319084,-204081.00246696224,197323.33921314793,0.0,84.0,-84.0,66.94995100000006,1241.4166666666667,1267.8333333333335,1275.416666666667,1301.8333333333335,1233.8333333333335,1207.4166666666667,1199.8333333333335,1.3308823529411764,-14518762.0,-1
2013-08-29,1240.5,1263.800049,1223.300049,1236.349976,1195.761841,573972.0,1299.0549804,1282.1227139090906,-160.5999750000001,22.41824837621128,-14.162265962264154,-29.38139013115301,-114.9936340190265,860166.7487226648,229236.43800149442,0.0,96.0,-84.0,93.15002400000003,1241.1500246666667,1259.0000003333334,1281.650024666667,1299.5000003333334,1218.5000003333334,1200.6500246666667,1178.0000003333334,0.322220419753087,-15092734.0,-1
2013-08-30,1246.0,1249.0,1225.0,1250.599976,1189.020874,758972.0,1284.9949829000002,1273.312713109091,-140.5999750000001,30.05585490775438,-13.086794264150944,-32.466993213566184,-107.75201225773472,-385407.9381454232,199723.34426453253,4.0,92.0,-96.0,40.5,1241.5333253333333,1258.0666506666666,1265.5333253333333,1282.0666506666666,1234.0666506666666,1217.5333253333333,1210.0666506666666,1.0666656666666654,-14333762.0,+1
2013-09-02,1240.25,1307.599976,1233.0,1243.550049,1242.995483,537411.0,1276.8399902,1265.777270581818,-81.54992700000003,28.45666735846359,-13.618864226415099,-38.855342098539495,-71.08747356995754,249696.21590545637,202116.73660016805,0.0,88.0,-88.0,24.0,1261.3833416666666,1289.7666833333333,1335.9833176666666,1364.3666593333332,1215.1667073333333,1186.7833656666667,1140.5667313333333,0.14142161386218072,-14871173.0,-1
2013-09-03,1315.0,1319.599976,1254.5,1300.0,1220.095825,627614.0,1275.9949951,1269.9881814545456,-8.449951000000056,52.03531043468453,-9.358490566037736,-46.10037288282956,-25.704017275394655,439425.20949979714,213454.69228619087,0.0,84.0,-88.0,74.59997599999997,1291.3666586666666,1328.2333173333332,1356.4666346666663,1393.3332933333331,1263.1333413333332,1226.2666826666666,1198.0333653333332,0.6989249888509946,-14243559.0,+1
2013-09-04,1269.0,1282.800049,1242.0,1276.050049,1220.526123,656723.0,1273.8099976,1269.9981912545454,-21.849975000000086,44.80631663912556,-11.166034037735853,-45.618741926555685,-50.06931089004982,-1119949.3524829766,149895.8916405466,44.0,80.0,-84.0,76.04992700000003,1266.9500326666666,1291.9000653333333,1307.7500816666666,1332.7001143333332,1251.1000163333333,1226.1499836666667,1210.2999673333334,0.8345590222207819,-14900282.0,-1
2013-09-05,1290.0,1314.349976,1290.0,1276.5,1242.613159,531076.0,1273.0150025,1270.4872825999998,-7.9499510000000555,44.97203538972102,-8.735076366469343,-45.47316627275745,-14.632870510939796,138989.03531847405,149377.14666027404,40.0,76.0,-36.0,58.0,1293.6166586666666,1297.2333173333332,1317.9666346666663,1321.5832933333331,1272.8833413333332,1269.2666826666666,1248.5333653333332,-0.5544153308405732,-14369206.0,+1
2013-09-06,1311.0,1311.949951,1277.0,1299.599976,1231.904297,473918.0,1274.405005,1275.3209141454545,13.900024999999914,53.28137548204766,-3.005337819307194,-45.146247720504334,-9.80508102521874,-1255332.6479136671,82707.69120962518,36.0,72.0,-36.0,38.299927000000025,1296.183309,1315.366618,1331.13326,1350.316569,1280.416667,1261.233358,1245.466716,0.6466382742568061,-13895288.0,+1
2013-09-10,1305.0,1349.949951,1300.0,1288.400024,1278.038574,857196.0,1273.9450074000001,1277.8654630545454,-4.59997599999997,49.13096616465149,-4.920254959105076,-43.628020662813924,12.877017222222863,-1825359.7215329362,-7670.43457746506,32.0,68.0,-36.0,35.449951000000056,1312.783325,1325.5666500000002,1362.733276,1375.5166010000003,1275.6166990000002,1262.833374,1225.666748,-0.23223197956690603,-14752484.0,-1
2013-09-11,1351.0,1388.800049,1346.300049,1336.650024,1301.129639,1255303.0,1276.7950074,1289.2663751636364,28.5,63.329921763558886,-4.043264306000962,-42.0246622920547,77.5999225679555,260133.71692400472,4990.257386805937,28.000000000000004,64.0,-36.0,50.349975000000086,1357.2500406666666,1368.2000323333332,1399.7500406666663,1410.7000323333332,1325.7000323333332,1314.7500406666666,1283.2000323333332,-0.22705941176470387,-13497181.0,+1
2013-09-12,1367.949951,1376.0,1315.550049,1360.800049,1262.979248,523296.0,1286.8500123,1304.540019090909,100.55004899999994,68.42059305855024,-2.1708791236059257,-39.80834347897712,71.57730115366299,91217.52548564802,9059.320852635512,24.0,60.0,-36.0,100.40002499999991,1350.783366,1386.0166829999998,1411.2333169999997,1446.4666339999999,1325.5667319999998,1290.3334149999998,1265.1167809999997,0.7485531295137023,-12973885.0,+1
2013-09-13,1315.0,1335.0,1301.0,1320.900024,1258.198242,534719.0,1295.3050171,1310.7309303090908,84.55004800000006,54.10252967130189,-5.264383813029295,-40.76660496397403,34.58846439906598,-1291835.3905003306,-52223.528061980825,20.0,56.00000000000001,-36.0,60.449951000000056,1318.9666746666667,1336.9333493333334,1352.9666746666667,1370.9333493333334,1302.9333493333334,1284.9666746666667,1268.9333493333334,0.5852948235294126,-13508604.0,-1
2013-09-16,1343.349976,1379.300049,1334.449951,1315.900024,1300.269043,707004.0,1301.8350219,1314.475477018182,65.30004800000006,52.51356695036808,-5.652040799387496,-34.749363303859354,75.15460433865174,-481531.1070550947,-72414.0599811125,16.0,52.0,-36.00000000000001,59.800048999999944,1343.2166746666667,1351.9833983333333,1388.0667726666666,1396.8334963333332,1307.1333003333334,1298.3665766666668,1262.2832023333335,-0.4135983604762708,-14215608.0,-1
2013-09-17,1362.0,1388.800049,1360.0,1359.900024,1315.471802,478211.0,1313.4700194000002,1325.032750127273,116.34997500000009,63.42169625098742,-2.240659319435327,-24.442021219401568,109.76084330036184,-448691.69641214446,-90082.72516638755,12.0,48.0,-36.0,58.400024999999914,1369.566691,1379.133382,1398.36674,1407.933431,1350.333333,1340.766642,1321.533284,-0.003471382982715406,-13737397.0,+1
2013-09-18,1385.0,1405.0,1377.0,1375.800049,1340.379395,413270.0,1321.0500243000001,1336.3654827818182,75.80004899999994,66.61892751995441,-2.2358308575804022,-14.853706884517123,122.76220695038829,-2553786.4976928863,-205596.03795201803,8.0,44.0,-36.0,72.90002499999991,1385.9333496666666,1394.8666993333331,1413.9333496666668,1422.8666993333331,1366.8666993333331,1357.9333496666666,1338.8666993333331,-0.04285539285714484,-13324127.0,+1
2013-09-19,1441.0,1503.400024,1441.0,1401.849976,1415.102661,1132596.0,1333.6300170000002,1351.056383090909,125.79992700000003,71.35254486710545,-7.23084920710597,0.7754660555506234,203.42215258547634,714144.5802469136,-162534.68492882088,4.0,40.0,-36.0,45.09997599999997,1448.75,1456.5,1511.150024,1518.900024,1394.099976,1386.349976,1331.699952,-0.6274039894600042,-12191531.0,+1
2013-09-20,1479.900024,1482.0,1401.0,1480.0,1402.9116210000002,751243.0,1353.980017,1377.6691072727272,203.5,80.78469429166395,-1.6661936485412672,11.385282431989708,181.6952975246892,693537.5354647456,-122508.83799011967,96.0,36.0,-36.0,127.59997500000009,1454.3333333333333,1507.6666666666665,1535.333333333333,1588.6666666666665,1426.6666666666665,1373.3333333333333,1345.6666666666665,0.9753086419753086,-11440288.0,+1
2013-09-23,1450.0,1454.400024,1388.0,1467.25,1339.805664,500010.0,1370.7450194,1398.2636496363637,167.65002400000003,76.06986221271367,-2.574054641286451,27.141795394912606,136.79352505923748,-249196.36363636365,-128424.44711420765,92.0,32.0,60.0,81.0,1436.5500080000002,1485.1000160000003,1502.9500320000002,1551.5000400000004,1418.6999920000003,1370.1499840000001,1352.2999680000003,1.1935236649914458,-11940298.0,-1
2013-09-24,1390.0,1442.0,1387.0,1401.25,1348.93689,517200.0,1382.030017,1403.8100097454544,112.84997599999997,56.40682985652848,-7.2735703684379915,42.16863637720121,90.78210978538158,156380.05981706284,-115142.11585763213,88.0,28.000000000000004,60.0,92.0,1410.0833333333333,1433.1666666666665,1465.083333333333,1488.1666666666665,1378.1666666666665,1355.0833333333333,1323.1666666666665,0.2590909090909091,-12457498.0,-1
2013-09-25,1414.900024,1423.0,1376.150024,1410.800049,1332.108765,326342.0,1389.4450195,1409.0409246545455,74.15002499999991,58.21033077955644,-6.593561194641512,51.22811178707002,71.21941343543128,-209286.06669893514,-119527.49136256224,84.0,24.0,60.0,80.25,1403.316691,1430.483358,1450.166667,1477.333334,1383.633382,1356.466715,1336.783406,0.7395953628663532,-12131156.0,+1
2013-09-26,1415.0,1423.0,1380.099976,1393.199951,1326.706543,537625.0,1392.6850097,1409.7236394727272,32.39990200000011,53.50341116853641,-7.8467723666173885,61.319673166035955,56.37945015854334,75956.23651599357,-110431.79858988053,80.0,20.0,60.0,46.84997599999997,1398.7666423333333,1417.4333086666666,1441.666666333333,1460.3333326666666,1374.5332846666665,1355.8666183333332,1331.6332606666665,0.3053605517796465,-12668781.0,-1
2013-09-27,1391.900024,1407.699951,1361.550049,1387.550049,1307.01001,599199.0,1399.3500121999998,1408.7900102545452,66.65002499999991,51.94753372993579,-8.249072416706259,64.75423174566686,33.76736018001265,244874.7096288557,-93917.43332075368,76.0,16.0,60.0,42.90002400000003,1385.600016333333,1409.6499836666662,1431.7499183333334,1455.7998856666663,1363.5000816666661,1339.450114333333,1317.350179666666,0.5633814780365067,-13267980.0,-1
2013-09-30,1366.0,1373.650024,1340.0,1366.949951,1298.9782710000002,406918.0,1404.4550048999997,1402.8990900363635,51.049927000000025,46.285003998409934,-9.715897939916296,63.81656836068646,2.8017529780068116,-1152047.3679764369,-143048.1327395247,72.0,12.0,60.0,46.14990200000011,1360.1999916666666,1380.3999833333332,1393.8500156666669,1414.0500073333333,1346.7499593333332,1326.5499676666666,1313.0999353333332,0.8008895030802959,-13674898.0,-1
2013-10-01,1364.050049,1410.0,1364.0,1358.550049,1319.678833,931358.0,1404.3200074000001,1394.5527344181817,-1.3499750000000859,44.02703566653013,-10.314011145303148,68.53947693761347,13.95061718843418,-505029.721228586,-159839.12229417122,68.0,8.0,60.0,47.550048999999944,1377.5166829999998,1391.0333659999997,1423.5166829999998,1437.0333659999997,1345.0333659999997,1331.5166829999998,1299.0333659999997,-0.11847719565217511,-14606256.0,-1
2013-10-03,1394.949951,1420.0,1375.199951,1380.199951,1350.418945,650153.0,1404.7599976,1390.1672696181818,4.399902000000111,51.11872480826384,-8.772434555298753,75.61068744837735,23.942315488915668,-375845.976429401,-169849.55547078696,64.0,4.0,60.0,46.0,1391.7999673333334,1408.3999836666667,1436.6000163333333,1453.2000326666666,1363.5999346666667,1346.9999183333334,1318.7998856666668,0.11160702078696401,-13956103.0,+1
2013-10-04,1410.5,1434.949951,1406.050049,1412.349976,1365.860718,666373.0,1405.8099976,1391.5472656909092,10.5,59.83766376706178,-6.483198977786407,79.00611548006032,43.8962669477939,239383.179756985,-150901.2677630437,60.0,0.0,60.0,61.449951000000056,1417.783325333333,1429.5166016666662,1446.6832273333334,1458.4165036666664,1400.6166996666661,1388.883423333333,1371.716797666666,0.21799129284244634,-13289730.0,+1
2013-10-07,1425.0,1432.699951,1402.050049,1428.5,1348.363159,329756.0,1400.6599976,1395.672720672727,-51.5,63.600821766035,-5.333240011394363,78.00379598549489,39.875522998137725,-59518.82706623871,-146673.6620603245,56.00000000000001,0.0,60.0,54.75,1421.0833333333333,1440.1166176666666,1451.7332353333336,1470.7665196666667,1409.4667156666665,1390.4334313333331,1378.8168136666663,0.8629701654510986,-12959974.0,+1
2013-10-08,1420.0,1423.849976,1400.0,1410.199951,1344.921143,411447.0,1394.9549927,1397.4072576545454,-57.050048999999944,56.65962766896444,-6.636291042957144,71.54639443617634,24.32805815028707,463295.0855946527,-118477.60141080557,52.0,0.0,56.00000000000001,30.64990200000011,1411.3499756666668,1422.6999513333335,1435.1999516666665,1446.5499273333335,1398.8499753333335,1387.4999996666668,1374.9999993333336,0.42767133182859673,-13371421.0,-1
2013-10-09,1407.0,1407.0,1386.199951,1406.599976,1337.17627,481828.0,1395.4899903,1399.5245273454545,5.34997599999997,55.2899671642345,-6.89262648431855,54.510425146549096,8.510893654944237,-605837.4745390075,-140988.66234930503,48.0,0.0,52.0,28.5,1399.933309,1413.666667,1420.733358,1434.466716,1392.866618,1379.13326,1372.066569,0.9807681222289413,-13853249.0,-1
2013-10-10,1399.0,1425.199951,1398.25,1398.5,1358.7852779999998,617290.0,1394.2599854,1400.0718018363636,-12.300048999999944,52.02496716712205,-7.469383523735972,37.41939802571824,15.210421784216642,-548267.1062836811,-159786.95536814455,44.0,4.0,48.0,24.0,1407.3166503333334,1416.3833006666669,1434.2666013333337,1443.333251666667,1389.4333496666668,1380.3666993333334,1362.4833986666667,0.0092764547141477,-14470539.0,-1
2013-10-11,1436.099976,1470.0,1413.099976,1421.099976,1399.804077,762748.0,1397.0499879000001,1404.9518001272727,27.900024999999914,59.68863258681839,-4.4034724511930605,32.7307758263762,51.52209497691502,125730.88753697496,-146617.8653255964,40.0,0.0,40.0,26.949951000000056,1434.7333173333334,1456.3666586666668,1491.6333413333336,1513.2666826666668,1399.4666346666668,1377.8332933333334,1342.5666106666667,0.14059748024007857,-13707791.0,+1
2013-10-14,1465.25,1479.0,1442.400024,1464.0,1383.454224,697237.0,1404.694983,1417.1245296,76.44995100000006,70.13706625777387,-1.0869565217391304,26.098322168822733,94.8121360281905,-101797.42466046922,-144551.97054998364,36.0,4.0,40.0,71.5,1461.8000080000002,1481.1999920000003,1498.3999840000001,1517.7999680000003,1444.6000160000003,1425.2000320000002,1408.0000400000004,0.5901636656810919,-13010554.0,+1
2013-10-15,1452.0,1473.199951,1431.0,1446.900024,1376.760986,413066.0,1412.6899903,1424.7981734181817,79.95007299999997,62.66663140958719,-2.3260852173913023,21.3637544937892,73.78397444967334,93511.68940406098,-133585.97346424955,32.0,0.0,32.0,57.90002400000003,1450.3666583333334,1469.7333166666667,1492.5666093333334,1511.9332676666668,1427.5333656666667,1408.1667073333333,1385.3334146666666,0.376778257396555,-13423620.0,-1
2013-10-17,1440.050049,1451.800049,1418.0,1439.900024,1364.4746089999999,316070.0,1420.8249878000001,1429.745452272727,81.34997500000009,59.66492750778852,-2.8333315942028965,18.680558832243833,45.07844257780159,-513405.5038582417,-151071.06923893123,28.000000000000004,0.0,32.0,42.199951000000056,1436.566691,1455.133382,1470.36674,1488.933431,1421.333333,1402.766642,1387.533284,0.6479287648369997,-13739690.0,-1
2013-10-18,1432.0,1472.5,1428.099976,1427.050049,1404.345947,490221.0,1425.5099976000001,1430.8772815818181,46.85009799999989,54.16907500535133,-3.764489202898555,17.999484852367914,57.28852120080733,-909958.7839575656,-185986.39607461012,24.0,8.0,28.000000000000004,33.800048999999944,1442.5500083333334,1457.0000406666668,1486.9500323333336,1501.4000646666668,1412.6000166666668,1398.1499843333334,1368.1999926666667,-0.02364699172234737,-14229911.0,-1
2013-10-21,1470.349976,1542.75,1470.099976,1468.75,1453.3009029999998,877353.0,1431.15,1438.7391002,56.40002400000003,65.92250817539554,-5.125541125541125,22.961064818574187,182.85732153458972,-16050.362192041952,-178172.21391434502,20.0,4.0,16.0,44.40002400000003,1493.8666586666666,1517.6333413333332,1566.5166826666668,1590.2833653333332,1444.9833173333332,1421.2166346666666,1372.3332933333331,-0.018581907144311047,-13352558.0,+1
2013-10-22,1523.0,1536.0,1505.300049,1519.949951,1448.185425,351924.0,1440.2949951,1454.8845458363635,91.44995100000006,75.00402065746412,-1.5792241731601695,28.420637993469654,217.33394945613944,14547.862825215481,-169315.0326215607,96.0,0.0,16.0,115.69995100000006,1520.4166666666667,1535.5332843333335,1551.116617666667,1566.2332353333336,1504.8333333333335,1489.7167156666667,1474.1333823333334,0.47719626653476044,-13000634.0,+1
2013-10-23,1516.800049,1545.0,1482.5,1514.599976,1461.810547,534863.0,1450.7349976,1468.3945423636364,104.40002499999991,72.66910869905252,-2.1023529737206106,27.408057203957924,158.606172580046,93287.47007286956,-157252.22226881565,92.0,0.0,96.0,67.25,1514.033325333333,1545.5666506666662,1576.5333253333329,1608.0666506666662,1483.0666506666662,1451.533325333333,1420.5666506666662,0.5135996159999995,-13535497.0,-1
2013-10-24,1528.0,1549.75,1499.949951,1528.849976,1447.516235,580715.0,1462.9599976,1482.597265709091,122.25,75.05565110428068,-1.440635809064279,24.451003042965112,149.03369153902787,47123.86413598098,-147868.5930801146,96.0,36.0,92.0,62.5,1526.183309,1552.416667,1575.983358,1602.216716,1502.616618,1476.38326,1452.816569,0.5803212161498064,-12954782.0,+1
2013-10-25,1501.099976,1533.099976,1490.0,1513.900024,1442.544067,432129.0,1474.5,1491.859088690909,115.40002400000003,67.880467390136,-2.4711339651904165,26.691487606666215,105.65210856700946,-516350.43512138067,-164779.1362880423,96.0,32.0,60.0,49.800048999999944,1512.3333333333333,1534.6666666666665,1555.4333093333335,1577.7666426666665,1491.5666906666665,1469.2333573333333,1448.4667146666666,0.554525227577854,-13386911.0,-1
2013-10-28,1510.349976,1529.0,1503.0,1508.699951,1446.990356,919522.0,1483.2599975,1498.0772616,87.59997500000009,65.37227538662188,-2.8295742891607754,30.845514205954032,94.60656528291914,-9387444.537419297,-587844.7923721896,92.0,28.000000000000004,64.0,43.09997599999997,1513.5666503333334,1524.1333006666669,1539.5666503333332,1550.1333006666669,1498.1333006666669,1487.5666503333334,1472.1333006666669,0.21922888461538675,-14306433.0,-1
2013-10-29,1590.900024,1646.5,1565.75,1513.349976,1563.544922,4085346.0,1488.1949951,1503.5481667818183,49.34997599999997,66.643973478184,-8.60420187399031,38.58716362387736,158.4322172836674,-392458.97446970287,-578885.7224024165,88.0,24.0,64.0,26.0,1575.1999919999998,1584.6499839999997,1655.9499919999998,1665.3999839999997,1503.8999839999997,1494.4499919999998,1423.1499839999997,-0.6489167058823533,-10221087.0,+1
2013-10-30,1641.0,1659.900024,1625.0,1635.25,1564.883667,951167.0,1507.0299927000003,1530.2854404,188.34997599999997,84.19784263692776,-1.5792186316219845,52.102462146914604,197.5573175598027,241495.1516113555,-541283.6043965259,96.0,20.0,64.0,137.80004899999994,1640.0500080000002,1655.1000160000003,1674.9500320000002,1690.0000400000004,1620.1999920000003,1605.1499840000001,1585.2999680000003,0.29369607310298673,-9269920.0,+1
2013-10-31,1626.099976,1646.699951,1617.25,1636.650024,1564.4533689999998,760636.0,1526.7049927000003,1553.8527188181818,196.75,84.30728268978886,-1.4895252509778936,60.069299477435834,145.9515652028697,-240369.33943486656,-527496.4582182295,96.0,16.0,76.0,146.55004800000006,1633.533325,1649.8166500000002,1662.983276,1679.2666010000003,1620.3666990000002,1604.083374,1590.916748,0.6587455442625353,-8509284.0,+1
2013-11-01,1642.0,1655.849976,1626.25,1636.199951,1564.405518,733492.0,1547.6199829000002,1573.7608930545457,209.1499020000001,84.09125663185472,-1.5183594487535208,67.19791987969165,122.24505286192135,178420.07890061676,-495164.84686536854,92.0,12.0,80.0,29.449951000000056,1639.433309,1652.616618,1669.033285,1682.216594,1623.016642,1609.833333,1593.416666,0.3361472657950826,-9242776.0,-1
2013-11-05,1645.0,1645.0,1617.199951,1636.150024,1552.071167,491093.0,1564.3599853000005,1589.8572641636365,167.40002400000003,84.0636857984347,-1.5215580520741923,76.9715367581116,98.0549497474188,-116238.75,-477815.7002540207,88.0,8.0,80.0,29.59997599999997,1632.783325,1648.3666990000002,1660.5833740000003,1676.166748,1620.5666500000002,1604.9832760000002,1592.7666010000003,0.6816561006780963,-9733869.0,-1
2013-11-06,1622.0,1644.0,1610.0,1623.25,1543.752686,526949.0,1574.6899902000002,1600.5645395636361,103.30004899999994,76.57840146091189,-2.3480058579331553,88.41651462987534,80.18277774303608,-212652.92637529614,-465679.2230120019,84.0,4.0,80.0,27.800048999999944,1625.75,1641.5,1659.75,1675.5,1607.5,1591.75,1573.5,0.3897058823529412,-10260818.0,-1
2013-11-07,1610.300049,1644.900024,1602.400024,1614.550049,1540.167236,496581.0,1584.6849975,1607.8118229818183,99.95007299999997,71.61608298745149,-2.9053734577942505,94.79603018621901,65.37107022848838,763519.3202252557,-409436.64904395666,80.0,0.0,80.0,34.0,1620.6166990000002,1638.8333740000003,1663.1166990000002,1681.3333740000003,1596.3333740000003,1578.1166990000002,1553.8333740000003,0.28588294117646856,-10757399.0,-1
2013-11-08,1605.099976,1610.0,1557.5,1610.800049,1511.2436519999999,740937.0,1592.8800048,1612.560014163636,81.95007299999997,69.38006443072317,-3.1456194660164916,93.47601649601233,37.93549190247003,-50126.12844850865,-393001.16842388746,76.0,0.0,80.0,42.5,1592.7666829999998,1628.0333659999997,1645.2666829999998,1680.5333659999997,1575.5333659999997,1540.2666829999998,1523.0333659999997,1.0152390285714274,-11498336.0,-1
2013-11-11,1580.0,1604.0,1561.300049,1580.550049,1513.1560060000002,509621.0,1599.5450073,1610.3182040181819,66.65002499999991,53.75767847069474,-5.083603932342568,91.99702386261993,24.80110374641978,-704074.4416682565,-407226.1094464378,72.0,0.0,76.0,57.050048999999944,1581.9500326666666,1602.6000163333333,1624.6499836666667,1645.2999673333334,1559.9000653333333,1539.2500816666666,1517.2001143333332,0.4508201894657906,-12007957.0,-1
2013-11-12,1591.5,1622.0,1582.099976,1582.550049,1517.50647,720325.0,1606.9300171,1607.2282116,73.85009799999989,54.53860105615104,-4.955472727957373,90.27783802644262,28.962387817075072,153169.72171885584,-381607.0209931367,68.0,12.0,72.0,49.5,1595.5500083333334,1609.0000406666668,1635.4500323333336,1648.9000646666668,1569.1000166666668,1555.6499843333334,1529.1999926666667,0.011280018277682602,-11287632.0,+1
2013-11-13,1580.0,1594.0,1573.0,1587.099976,1510.239624,446748.0,1614.3050171,1603.622749581818,73.75,56.46832877324162,-4.663978914770013,93.15838074007206,18.717859778722186,-1084148.3428736303,-413716.04405813257,64.0,8.0,56.0,41.449951000000056,1584.6999919999998,1596.3999839999997,1605.6999919999998,1617.3999839999997,1575.3999839999997,1563.6999919999998,1554.3999839999997,0.6714274285714271,-10840884.0,+1
2013-11-14,1596.699951,1625.0,1591.449951,1579.5,1541.888184,633129.0,1608.7300171,1597.2945646545456,-55.75,52.19798647426057,-5.150875953859299,98.26996581339608,24.08766209419783,-612014.5046014539,-422776.8367075777,60.0,4.0,56.0,21.0,1598.649983666667,1605.8500163333338,1632.200032666667,1639.4000653333337,1572.2999673333338,1565.099934666667,1538.7499183333339,-0.35618281809365093,-11474013.0,-1
2013-11-18,1627.699951,1635.150024,1612.050049,1612.599976,1557.903687,642611.0,1606.3250122999998,1597.9981935454546,-24.05004800000006,65.36168386397571,-3.0303060588587742,103.24122471677879,34.006141313749005,-1104254.7062457362,-453907.98843843973,56.00000000000001,0.0,56.0,37.90002400000003,1619.9333496666666,1627.8166503333332,1643.0333246666664,1650.9166253333333,1604.7166753333331,1596.8333746666665,1581.616700333333,0.02380638940085533,-10831402.0,+1
2013-11-19,1630.0,1691.0999760000002,1625.449951,1629.349976,1608.7709960000002,1253144.0,1605.6400148,1602.184550581818,-6.849975000000086,70.15977823164279,-3.8785252767317555,91.87830629603445,48.42382822418418,237008.87691252894,-422352.8179635129,52.0,0.0,56.00000000000001,55.65002400000003,1648.6333009999998,1671.8166509999996,1714.2833260000002,1737.4666759999998,1606.1666259999995,1582.9832759999997,1540.5166009999994,0.05940629877901655,-9578258.0,+1
2013-11-20,1690.0,1700.0,1643.099976,1682.550049,1577.504883,612988.0,1610.2800173,1616.1681931636363,46.400024999999914,80.2073525362561,-1.0899407245471615,80.60403901870382,61.665725189898644,-140434.10655901916,-409479.9755989134,96.0,0.0,52.0,78.50000000000023,1675.216675,1707.3333739999998,1732.1166989999997,1764.2333979999999,1650.4333499999998,1618.3166509999999,1593.5333259999998,0.6933226073858941,-8965270.0,+1
2013-11-21,1654.900024,1667.699951,1638.849976,1649.849976,1574.779663,591465.0,1612.9400149000003,1623.3627311090909,26.59997599999997,64.74574017129702,-3.132418738288571,69.52419945939619,40.80579882876839,-386052.3209876543,-408410.454207999,96.0,8.0,96.0,70.65002400000003,1652.1333009999998,1665.4166259999997,1680.983276,1694.2666009999998,1636.5666509999996,1623.2833259999998,1607.7166759999996,0.38128282606830566,-9556735.0,-1
2013-11-22,1662.0,1676.75,1636.25,1647.0,1568.230225,822901.0,1616.1850100000004,1629.5554556727275,32.449951000000056,63.51446914658743,-3.3104309806371015,60.560428164854784,40.349449011927966,-937565.2676976983,-432562.7061048266,92.0,4.0,88.0,43.700072999999975,1653.3333333333333,1670.4166666666665,1693.833333333333,1710.9166666666665,1629.9166666666665,1612.8333333333333,1589.4166666666665,0.2654320987654321,-10379636.0,-1
2013-11-25,1653.0,1689.800049,1646.300049,1640.150024,1605.2810060000002,730897.0,1619.1200075,1633.9127309454543,29.349975000000086,60.33254474719566,-3.738287070580885,51.73598232643849,43.54374549304975,180500.5291063911,-404585.8903781424,88.0,0.0,88.0,40.5,1658.7500406666666,1671.2000323333332,1702.2500406666663,1714.7000323333332,1627.7000323333332,1615.2500406666666,1584.2000323333332,-0.1413798850574693,-11110533.0,-1
2013-11-26,1680.0,1688.0,1654.550049,1678.9000239999998,1590.365112,395917.0,1628.955005,1644.7818248545454,98.34997499999986,70.1074187200514,-1.3179247970018861,44.34420065362292,55.87480572755724,307277.8199780668,-372106.2112335667,84.0,0.0,88.0,43.5,1673.816691,1693.083333,1707.266642,1726.533284,1659.633382,1640.36674,1626.183431,0.7279524863877923,-10714616.0,+1
2013-11-27,1668.050049,1670.0,1641.0,1663.300049,1587.161743,571218.0,1637.0300049999998,1651.026378309091,80.75,62.90672997317358,-2.2923142410993163,36.1290945299354,34.68030939289841,-107572.47674858003,-360038.59832398,80.0,0.0,84.0,47.84997599999997,1658.100016333333,1675.2000326666662,1687.1000163333329,1704.2000326666662,1646.2000326666662,1629.100016333333,1617.2000326666662,0.7689672068965498,-11285834.0,-1
2013-11-28,1669.0,1675.0,1648.150024,1659.949951,1593.568115,888680.0,1644.3150025000002,1655.1936412181817,72.84997500000009,61.34547403118197,-2.5015645846346,34.617526331730915,36.85394129975819,-521815.1372549021,-367417.3803407985,76.0,4.0,80.0,37.9000239999998,1661.033325,1673.9166260000002,1687.8833010000003,1700.7666020000001,1647.0666500000002,1634.1833490000001,1620.2166740000002,0.4394762587497299,-12174514.0,-1
2013-11-29,1670.0,1692.6500239999998,1667.150024,1666.650024,1602.651489,502124.0,1653.0300049000002,1659.2545542181817,87.15002400000003,63.43939505253408,-2.083071580262334,36.56254126235535,58.609581791060435,258392.90021569506,-338878.041173019,72.0,0.0,72.0,26.84997599999997,1675.4833573333333,1683.8166906666665,1700.983357333333,1709.3166906666663,1658.3166906666668,1649.9833573333335,1632.816690666667,-0.019607843137255075,-11672390.0,+1
2013-12-02,1670.0,1682.300049,1656.599976,1676.150024,1588.54834,495575.0,1659.3850097000002,1663.4581940545456,63.55004800000006,66.41576797137495,-1.4896924422236084,38.28261565639559,51.91925326895383,-269527.50507064007,-335715.8638636431,68.0,4.0,72.0,32.70007299999975,1671.6833496666666,1686.7667233333332,1697.3834226666663,1712.4667963333331,1661.0666503333332,1645.9832766666666,1635.3665773333332,0.7607000960658781,-11176815.0,+1
2013-12-03,1660.0,1686.8499760000002,1652.25,1661.400024,1590.317017,572128.0,1662.5900145000003,1663.824560290909,32.05004800000006,57.962283151570816,-2.4109916302311034,42.15188495793382,43.12456142978128,272089.89080029936,-308005.684657903,64.0,0.0,64.0,25.700072999999975,1666.8333333333333,1681.4166666666665,1701.4333093333335,1716.0166426666667,1646.8166906666663,1632.233357333333,1612.2167146666661,0.2644517441283768,-11748943.0,-1
2013-12-04,1652.300049,1669.800049,1633.949951,1663.25,1567.8477779999998,428767.0,1660.6600096,1663.9445576545456,-19.300048999999944,58.722607354943825,-2.2954403497813867,41.076495619176285,25.72709739854036,-4516025.177680217,-499825.39093293104,60.0,0.0,64.0,34.5999760000002,1655.6666666666667,1677.3833823333334,1691.5167646666664,1713.2334803333333,1641.5332843333335,1619.8165686666669,1605.6831863333337,0.8172934143722573,-11320176.0,+1
2013-12-05,1667.150024,1708.699951,1667.150024,1639.75,1625.5991210000002,1947489.0,1659.650012,1660.1427377272726,-10.09997599999997,46.41737214339806,-4.28340393233944,36.95649566517773,47.421705888004716,-400679.6615692332,-495306.48673708545,56.00000000000001,28.000000000000004,60.0,35.85009799999989,1671.8666583333334,1676.5832926666667,1713.4165853333334,1718.1332196666667,1635.0333656666667,1630.3167313333333,1593.4834386666666,-0.6594481862747921,-13267665.0,-1
2013-12-06,1705.75,1717.6500239999998,1694.0,1700.1500239999998,1626.889893,834899.0,1664.9650144000002,1667.5063762727273,53.1500239999998,66.95375239824946,-1.0811478541083321,27.07267596772249,90.59330568496807,-1498359.3471074381,-541018.3742825304,96.0,24.0,28.000000000000004,45.449951000000056,1703.9333493333331,1713.8666986666663,1727.583373333333,1737.516722666666,1690.2166746666664,1680.2833253333333,1666.5666506666666,0.2600430342057942,-12432766.0,+1
2013-12-09,1738.9000239999998,1770.0,1709.5,1701.5,1686.410278,1184977.0,1671.1000120000003,1674.1491009272727,61.34997599999997,67.27718765052899,-4.09934171154997,29.136075102571112,113.45690315774021,27261.407710334486,-515123.35718525737,96.0,20.0,72.0,77.9000239999998,1727.0,1744.5,1787.5,1805.0,1684.0,1666.5,1623.5,-0.1322314049586777,-11247789.0,+1
2013-12-10,1763.0,1780.5999760000002,1746.0,1763.75,1674.984375,1048021.0,1679.5850096000004,1690.9945532909094,84.8499760000002,78.4824026199091,-1.002020471008867,33.575417227149956,152.21616176033177,-119227.35467054899,-497085.45134073554,96.0,16.0,76.0,69.8499760000002,1763.449992,1780.8999840000001,1798.0499680000003,1815.4999600000003,1746.300008,1728.8500159999999,1711.7000319999997,0.5130061361892245,-10199768.0,+1
2013-12-11,1743.300049,1775.9000239999998,1735.0,1751.800049,1676.131714,668007.0,1688.4350096000003,1704.1245604545456,88.5,72.94933966748638,-1.7126502979921694,39.23056372676206,122.88059319757562,605741.7301638697,-446843.5929357037,96.0,12.0,80.0,79.0999760000002,1754.2333576666667,1773.4667153333335,1795.1333816666665,1814.3667393333333,1732.5666913333337,1713.333333666667,1691.6666673333339,0.4107589032221601,-10867775.0,-1
2013-12-12,1748.0,1748.0,1710.4000239999998,1753.0,1639.606934,478485.0,1697.7400145000001,1715.8636496181819,93.05004899999994,73.16851082083363,-1.6412926019214094,40.040387132215756,83.18878206145466,418125.6727511558,-407441.9551103538,92.0,8.0,84.0,40.9000239999998,1737.1333413333332,1763.8666586666666,1774.7333173333334,1801.4666346666668,1726.2666826666664,1699.533365333333,1688.6667066666662,1.132978808284345,-10389290.0,+1
2013-12-13,1710.0,1719.949951,1682.5999760000002,1714.800049,1615.5119630000002,577334.0,1702.5550170000001,1718.9654740727271,48.150024999999914,56.3869805158545,-3.912935771830687,41.51122860134137,32.313399425254545,-128766.58185526499,-394748.79997661785,88.0,4.0,84.0,41.40002500000014,1705.783325333333,1728.966674666666,1743.1333003333332,1766.3166496666659,1691.6166996666661,1668.4333503333332,1654.2667246666663,0.8621176587132888,-10966624.0,-1
2013-12-16,1687.0,1714.9000239999998,1676.0,1689.5999760000002,1626.985718,428119.0,1703.9000122,1716.6100120727272,13.449952000000167,48.006083214716085,-5.41151292214338,42.55539274431567,11.250969014744415,-352435.83901224064,-392821.70219181484,84.0,0.0,84.0,70.4000239999998,1693.5,1711.0,1732.4000239999996,1749.9000239999998,1672.0999760000002,1654.5999760000002,1633.1999520000004,0.3496135632204306,-11394743.0,-1
2013-12-17,1710.199951,1731.699951,1694.949951,1701.5999760000002,1627.272583,552326.0,1707.9200074,1716.1918236727274,40.19995200000017,51.9316155558837,-4.697906822520078,42.97080695803925,31.16831531986801,-565350.1579435791,-400678.62090757827,80.0,0.0,84.0,38.9000239999998,1709.4166260000002,1723.8833010000003,1746.1666260000002,1760.6333010000003,1687.1333010000003,1672.6666260000002,1650.3833010000003,0.18095306122449364,-10842417.0,+1
2013-12-18,1703.75,1740.8499760000002,1695.4000239999998,1701.9000239999998,1654.092285,791839.0,1711.7850098,1715.0972812363636,38.6500239999998,52.03609190406976,-4.68006381560512,40.35537844550868,33.76995349304888,-1279588.3835943895,-440700.6193821886,76.0,4.0,80.0,42.09997499999986,1712.7166746666664,1730.033325333333,1758.1666266666668,1775.4832773333335,1684.5833733333327,1667.266722666666,1639.1334213333323,0.1430144524685074,-10050578.0,+1
2013-12-19,1741.0,1798.0,1725.25,1729.949951,1702.4736329999998,1469454.0,1720.8050049,1718.3999978181819,90.19995100000006,61.14547502114297,-4.005300117716301,40.7603051004869,84.9357092342488,-1189480.9664002354,-474794.2745177927,72.0,0.0,72.0,45.449952000000394,1751.0666503333334,1776.8833006666669,1823.8166503333332,1849.6333006666669,1704.1333006666669,1678.3166503333334,1631.3833006666669,0.06460413745704544,-8581124.0,+1
2013-12-20,1795.0,1830.0,1774.949951,1780.550049,1730.297607,1493300.0,1728.8450074,1729.262733109091,80.40002500000014,72.15355714033068,-2.8567273830156013,42.877098621675486,137.99020785261246,106554.85562760096,-448326.1964022064,96.0,0.0,72.0,96.0999760000002,1795.1666666666667,1815.3833823333334,1850.216715666667,1870.4334313333334,1760.3333333333335,1740.1166176666668,1705.2832843333335,0.10172739355781309,-7087824.0,+1
2013-12-23,1809.0,1819.9000239999998,1795.5999760000002,1809.6500239999998,1723.3654789999998,681383.0,1739.6600098000004,1743.9545543090908,108.1500239999998,76.56024500394294,-1.1756196418255458,49.239115284090076,134.28863783582847,404827.1704814114,-409486.1017076072,96.0,0.0,96.0,100.05004899999994,1808.3833413333332,1821.1667066666662,1832.6833893333326,1845.4667546666658,1796.8666586666666,1784.0832933333336,1772.566610666667,0.5781901336161901,-6406441.0,+1
2013-12-24,1795.0,1802.550049,1775.25,1802.4000239999998,1710.361938,409326.0,1743.5250122000002,1755.3618296181817,38.6500239999998,73.22890909906441,-1.5944526863085033,49.934841593430065,96.03990224678245,-65895.0392568435,-393845.10998992034,92.0,0.0,96.0,39.34997499999986,1793.4000243333332,1811.5500486666665,1820.7000733333334,1838.8500976666664,1784.2499996666666,1766.0999753333333,1756.9499506666666,0.9945045886181324,-6815767.0,-1
2013-12-26,1785.0,1803.75,1778.449951,1788.800049,1714.951416,362435.0,1747.2250122000005,1763.5936544909089,37.0,66.92577521953083,-2.380124263431546,51.58864480467855,77.82312911409986,313895.59375204897,-361629.4333582064,88.0,40.0,92.0,34.4000239999998,1790.3333333333333,1802.2167156666665,1815.633382333333,1827.5167646666664,1776.9166666666665,1765.0332843333333,1751.6166176666666,0.4090939902922683,-7178202.0,-1
2013-12-27,1790.25,1800.699951,1763.0,1793.5999760000002,1697.214844,503568.0,1751.2850098000004,1772.025466090909,40.5999760000002,68.04584662907581,-2.102832120161745,48.28175598907774,62.610489269298284,-170003.27384948413,-352907.35726420884,84.0,36.0,48.0,25.300048999999944,1785.7666423333333,1808.5332846666665,1823.4665933333335,1846.2332356666666,1770.8333336666665,1748.0666913333332,1733.1333826666664,0.8116715058860462,-6674634.0,+1
2013-12-30,1785.0,1794.8499760000002,1768.0,1775.050049,1699.2705079999998,358010.0,1757.3100098000004,1776.3463823090908,60.25,59.11827629831029,-3.174462796071638,43.98669424511991,49.93968613372039,131829.67051794636,-330845.37466736726,80.0,32.0,48.0,37.699951000000056,1779.3000083333336,1790.6000166666672,1806.149984333334,1817.4499926666674,1763.750040666667,1752.4500323333334,1736.9000646666668,0.26257189205680825,-7032644.0,-1
2013-12-31,1780.0999760000002,1784.949951,1757.550049,1777.199951,1686.5538329999997,303542.0,1766.0700073,1779.9627352545454,87.59997499999986,59.82318285841286,-3.0502627960716318,39.23986297661145,39.07056499487265,-59541.34151639197,-318498.1578269147,76.0,28.000000000000004,48.0,26.849976000000197,1773.2333170000002,1788.9165850000004,1800.6332190000003,1816.3164870000005,1761.5166830000003,1745.833415,1734.1167810000002,0.7171522730263791,-6729102.0,+1
2014-01-01,1770.0,1776.9000239999998,1756.550049,1763.9000239999998,1686.6492920000003,214453.0,1772.3000121000002,1779.5681928363638,62.300047999999606,53.26716084427043,-3.8186005777007628,39.01579505112181,27.22805062535102,-1285117.0564346632,-362487.12362956855,72.0,24.0,48.0,27.39990200000011,1765.7833656666664,1775.016682333333,1786.1333406666663,1795.3666573333328,1754.666707333333,1745.4333906666666,1734.3167323333332,0.361178576386453,-6943555.0,-1
2014-01-02,1759.0,1814.800049,1759.0,1764.0,1690.856445,1565710.0,1778.5100097000002,1778.0590997272727,62.0999760000002,53.311539571941545,-3.8128249566724435,45.124994793294945,39.65153954903354,-249333.80162930719,-357338.0093428931,68.0,20.0,48.0,20.64990200000011,1779.2666829999998,1799.5333659999997,1835.0667319999998,1855.3334149999996,1743.7333169999997,1723.4666339999999,1687.9332679999998,0.08960565608105478,-5377845.0,+1
2014-01-03,1766.0,1808.6500239999998,1752.25,1768.4000239999998,1719.7320559999998,583504.0,1782.355017,1776.2209205090908,38.45007299999975,55.45944662546346,-3.558635239745823,49.39872939013844,30.096082456450468,-301803.1385451453,-354810.9886448867,64.0,16.0,48.0,55.800048999999944,1776.4333493333331,1800.6166986666663,1832.833373333333,1857.016722666666,1744.2166746666664,1720.0333253333333,1687.8166506666666,0.2863478214122721,-4794341.0,+1
2014-01-06,1805.0,1819.4000239999998,1792.550049,1798.5999760000002,1728.433228,549379.0,1784.1600097000003,1779.1745494181814,18.049927000000253,67.35373666784298,-1.8139817446562567,54.84457320371939,61.796990547465725,-2787098.8488550605,-465482.75101304916,60.0,12.0,48.0,56.4000239999998,1803.516683,1814.4833170000002,1830.366658,1841.333292,1787.6333420000003,1776.6667080000002,1760.7833670000005,0.2253233755338798,-4244962.0,+1
2014-01-07,1838.0,1854.25,1820.0999760000002,1807.699951,1764.8146969999998,1614578.0,1783.9650024000002,1783.4545387454546,-1.9500729999997475,70.12730677729131,-2.652046660019937,57.74459959582191,84.14200131728671,188886.45289706404,-435709.62127383833,56.00000000000001,8.0,48.0,51.0,1827.3499756666668,1834.5999753333333,1861.4999996666668,1868.749999333333,1800.4499513333335,1793.199951666667,1766.2999273333337,-0.36310443002910375,-2630384.0,+1
2014-01-08,1850.0,1860.0,1827.050049,1845.75,1756.926392,1398622.0,1788.3000000000002,1794.6881746727272,43.3499760000002,78.81205785504851,-0.8091993185689949,55.54956292231759,95.87142510954959,243835.5749300529,-404792.38334430585,96.0,4.0,48.00000000000001,55.6500239999998,1844.2666829999998,1861.4833169999997,1877.2166339999999,1894.4332679999998,1828.5333659999997,1811.3167319999998,1795.5834149999996,0.5675259122540128,-1231762.0,+1
2014-01-09,1858.800049,1859.0,1801.0999760000002,1837.5,1732.3535160000001,947521.0,1793.1699951,1803.6336292181818,48.699951000000056,73.46849669309871,-1.2776831345826234,48.15487971671223,70.76420736214045,591171.230529145,-359480.99225418974,96.0,0.0,92.0,52.300048999999944,1832.5333253333336,1863.966674666667,1890.4333493333336,1921.8666986666667,1806.066650666667,1774.6333013333337,1748.1666266666673,0.628670274817156,-2179283.0,-1
2014-01-10,1811.0999760000002,1814.550049,1768.0,1811.800049,1715.429565,670378.0,1794.9900024,1807.0209117454547,18.200072999999747,59.07228721890507,-2.737078421351508,40.925876195414276,25.951502190811606,95112.32001544161,-338800.09461356135,92.0,0.0,96.0,57.9000239999998,1798.1166993333334,1828.2333986666667,1844.666748333333,1874.7834476666667,1781.6833496666668,1751.5666503333334,1735.1333006666669,0.9409238001016926,-2849661.0,-1
2014-01-13,1800.0,1814.75,1765.0,1794.0999760000002,1704.577271,559984.0,1796.8949951000002,1806.8590887636362,19.049927000000253,51.113081383287096,-3.742193299261772,33.37271246702926,14.02486349893216,237054.39821265795,-312603.65187416674,88.0,24.0,92.0,69.5,1791.2833253333336,1817.566650666667,1841.0333253333338,1867.316650666667,1767.816650666667,1741.5333253333336,1718.066650666667,0.5849241407035215,-3409645.0,-1
2014-01-14,1783.0,1791.800049,1759.0999760000002,1782.75,1695.589478,530939.0,1797.4500000000003,1804.2872714727273,5.5500489999999445,46.479515578370865,-4.38671209540034,28.36123913497522,-10.237425691764379,-420502.90235695004,-317511.96174561774,84.0,20.0,64.0,49.75,1777.8833416666666,1796.666707333333,1810.5834146666664,1829.3667803333328,1763.9666343333333,1745.183268666667,1731.2665613333336,0.7232407095849598,-3940584.0,-1
2014-01-15,1790.0,1807.0,1767.0999760000002,1773.3499760000002,1721.166382,612338.0,1798.3949952000003,1799.905448927273,9.449952000000394,42.77402811519403,-4.920501078932413,25.599122654024995,-9.95081181577869,73250.91265839057,-299736.88224447257,80.0,16.0,64.0,35.0,1782.4833173333336,1797.866658666667,1822.3833413333334,1837.7666826666668,1757.9666346666672,1742.5832933333338,1718.0666106666674,0.1566415097895688,-4552922.0,-1
2014-01-16,1803.0999760000002,1810.800049,1785.0,1800.0999760000002,1711.3657230000001,429527.0,1802.0049928000003,1800.2154454363638,36.0999760000002,54.64641645504601,-3.4014777967064056,27.10492967867367,11.184756695751348,33590.73147261545,-284574.93586880394,76.0,12.0,64.0,39.9000239999998,1798.6333416666666,1812.2666833333333,1824.4333906666666,1838.0667323333332,1786.4666343333333,1772.8332926666667,1760.6665853333334,0.5852692760389807,-4123395.0,+1
2014-01-17,1778.199951,1808.800049,1766.300049,1789.8499760000002,1697.3582760000002,310359.0,1804.1499880000001,1798.005442381818,21.449952000000394,50.05506118497339,-3.983533446905156,29.68745513942963,-13.177613579310213,-86094.45345603664,-275547.0192252392,72.0,8.0,64.0,37.45007299999975,1788.3166913333334,1810.333333666667,1830.8166913333334,1852.833333666667,1767.833333666667,1745.8166913333334,1725.333333666667,0.5541159294117707,-4433754.0,-1
2014-01-20,1774.0,1797.3499760000002,1762.0,1775.199951,1700.226685,340046.0,1801.8099855,1792.7417992909093,-23.40002500000014,43.96343510352551,-4.815448551959111,32.275714243390894,-35.91268165902591,-676125.4425436032,-293766.8353887136,68.0,4.0,64.0,42.5,1778.183309,1794.366618,1813.5332850000004,1829.7165940000002,1759.0166419999998,1742.8333329999998,1723.6666659999996,0.37340763682555206,-4773800.0,-1
2014-01-21,1782.0,1812.699951,1782.0,1778.199951,1722.887329,541958.0,1798.8599855000002,1788.4490657454546,-29.5,45.52973712255584,-4.6450908006814275,32.20417288529916,-4.570792063122698,-180525.12546600698,-288616.32621297607,64.0,0.0,64.0,35.3499760000002,1790.966634,1799.9332680000002,1821.666585,1830.6332190000003,1769.2333170000002,1760.266683,1738.5333660000001,-0.12378029528450836,-4231842.0,+1
2014-01-22,1805.5,1819.0,1795.0,1801.9000239999998,1728.5765379999998,424767.0,1794.4749878999999,1789.0018000181822,-43.8499760000002,56.59009489132525,-3.299260420215798,27.01465741958168,30.304102940599737,115401.14844052329,-270241.1385756447,60.0,0.0,64.0,37.5,1805.300008,1815.6000159999999,1829.3000080000002,1839.6000159999999,1791.6000159999999,1781.300008,1767.6000159999999,0.2875009999999918,-3807075.0,+1
2014-01-23,1796.0999760000002,1819.9000239999998,1788.449951,1807.8499760000002,1715.1427,493794.0,1791.5099855000003,1791.433616036364,-29.650023999999803,59.00160058368684,-2.9613869392390577,21.25673301952338,30.06482234582301,142503.90969616346,-251469.5104696719,56.00000000000001,0.0,60.0,40.800048999999944,1805.399983666667,1822.3500163333338,1836.8500566666667,1853.8000893333335,1790.899943333334,1773.9499106666672,1759.4498703333343,0.6168515093748843,-3313281.0,+1
2014-01-24,1784.9000239999998,1804.9000239999998,1769.25,1793.800049,1696.449951,377713.0,1789.7099855000001,1791.849991218182,-18.0,51.24518558437888,-3.7592249290176065,9.451478474110218,-13.989448121714275,1469828.976923077,-173186.91434662897,52.0,0.0,56.00000000000001,31.450072999999747,1789.316691,1809.383382,1824.9667149999996,1845.0334059999998,1773.7333580000002,1753.6666670000002,1738.0833340000004,0.6886404620653294,-3690994.0,-1
2014-01-27,1755.0,1755.0,1690.0,1774.25,1627.654907,923081.0,1787.7249879000003,1789.0390847636363,-19.849976000000197,42.31410355810866,-4.86939239068711,-0.7378270027156759,-164.08334900263918,3523058.6347031947,-5090.166109711299,48.0,36.0,52.0,38.5999760000002,1739.75,1789.5,1804.75,1854.5,1724.5,1674.75,1659.5,1.2961538461538462,-4614075.0,-1
2014-01-28,1715.0,1751.5,1540.400024,1702.300049,1497.331543,6599087.0,1779.6799928000003,1773.507277690909,-80.44995100000006,24.317263246731756,-8.955136342986943,-6.694732831563215,-393.3573038521257,-14764687.155698068,-676307.1561396396,44.0,96.0,12.0,103.80004899999994,1664.7333576666667,1789.0666913333334,1875.833333666667,2000.1666673333334,1577.9667153333335,1453.6333816666668,1366.8667393333335,0.766935307467775,-11213162.0,-1
2014-01-29,1615.199951,1697.800049,1615.199951,1566.0,1600.452393,6737926.0,1758.9449952000004,1734.656369909091,-207.3499760000002,12.60183283011689,-16.647727272727273,-12.435450330205413,-425.1812407110527,1640978.5637883134,-570927.099338712,40.0,96.0,-52.0,233.84997599999997,1626.3333333333333,1637.4667156666665,1708.9334313333334,1720.0668136666663,1554.8666176666666,1543.7332353333334,1472.2665196666667,-0.59564034657683,-17951088.0,-1
2014-01-30,1668.0,1674.0,1625.599976,1673.849976,1564.1665039999998,1651215.0,1746.3199952000004,1719.1845482363633,-126.25000000000023,39.30097104641849,-8.486840953173225,-15.105903484300597,-251.0489495015792,-86494.89783714151,-548897.6985167066,36.0,92.0,-56.0,87.10009799999989,1657.8166506666666,1690.0333253333333,1706.2166746666667,1738.4333493333334,1641.6333013333333,1609.4166266666666,1593.2332773333333,0.9969003321155372,-16299873.0,+1
2014-01-31,1655.0,1655.0,1620.849976,1635.900024,1564.501221,729347.0,1730.9250000000004,1699.1081898363636,-153.94995200000017,34.96427902711528,-10.692079576611116,-18.718040691371016,-230.20155824015353,-11217.695783174433,-524447.3631815591,32.0,88.0,-56.0,108.0,1637.25,1653.650024,1671.400024,1687.800048,1619.5,1603.099976,1585.349976,0.4407038776898092,-17029220.0,-1
2014-02-03,1620.0,1660.0,1613.050049,1636.25,1547.529419,957497.0,1717.0300049000004,1681.8945534727272,-138.94995100000006,35.04055233159572,-10.671742776383377,-26.398790526466428,-176.82426211637025,298896.125,-487007.55264114786,28.000000000000004,84.0,-56.0,53.0,1636.4333496666666,1659.8166503333332,1683.3833006666669,1706.7666013333333,1612.8666993333331,1589.4833986666665,1565.916748333333,0.4941421770599937,-16071723.0,+1
2014-02-04,1601.0,1630.0,1590.0,1618.5,1548.6289060000001,703285.0,1701.0600098000004,1663.9800071272728,-159.69995100000006,32.790092595386795,-11.70317980075755,-35.19866424402085,-165.8103828253065,421175.23898514645,-445710.6112199281,24.0,80.0,-56.0,46.949951000000056,1612.8333333333333,1635.6666666666665,1652.833333333333,1675.6666666666665,1595.6666666666665,1572.8333333333333,1555.6666666666665,0.7125,-16775008.0,-1
2014-02-05,1619.0,1623.099976,1602.099976,1619.650024,1536.24707,627278.0,1682.8350098000003,1649.1781915272727,-182.24999999999977,33.11124403707797,-11.636352908784653,-42.76602440611646,-127.48206742388528,-584965.1312263008,-452042.6900633916,20.0,76.0,-56.0,46.25,1614.9499919999998,1627.8000079999997,1635.9499919999998,1648.8000079999997,1606.8000079999997,1593.9499919999998,1585.8000079999997,0.8357165714285744,-16147730.0,+1
2014-02-06,1610.199951,1644.949951,1593.0,1606.699951,1567.799805,1237835.0,1662.7200073000001,1635.3354535636363,-201.15002500000014,31.175687598848754,-12.388870360083146,-52.86629780286694,-102.77779944338208,-1661678.1285959263,-507045.42121748655,16.0,72.0,-56.0,21.0,1614.8833006666666,1636.7666013333333,1666.833251666667,1688.7165523333333,1584.8166503333332,1562.9333496666666,1532.8666993333331,0.26371441620801606,-17385565.0,-1
2014-02-07,1654.949951,1670.400024,1648.5,1639.699951,1591.942627,921283.0,1647.3099975,1631.1499887818181,-154.1000979999999,41.27006408021805,-10.471269131669194,-66.65299323850218,-55.036786159135,-899135.3561144931,-524873.6630723127,12.0,68.0,-56.0,51.949951000000056,1652.8666583333334,1657.2333166666667,1674.7666823333334,1679.1333406666668,1635.3332926666667,1630.9666343333333,1613.4332686666667,-0.401828281101424,-16464282.0,+1
2014-02-10,1665.0,1701.5999760000002,1665.0,1664.949951,1614.794556,896683.0,1636.3799926000002,1634.3572530545455,-109.30004899999994,48.00309296112082,-9.004013646291853,-81.82992139993644,-28.496618116443777,114329.11650318814,-495809.6979924111,8.0,64.0,-56.0,63.700072999999975,1677.183309,1689.366618,1713.7832850000004,1725.9665940000002,1652.7666419999998,1640.5833329999998,1616.1666659999996,-0.0013674599130869439,-15567599.0,+1
2014-02-11,1690.25,1698.0,1668.099976,1688.8499760000002,1604.563965,294694.0,1635.0349853000002,1643.8972500363636,-13.450072999999747,53.78911538209087,-7.615204031166869,-94.06040117653674,-17.957342036627157,221886.48794991968,-463177.18403973937,4.0,60.0,-56.0,61.90002500000014,1684.9833173333334,1701.8666586666668,1714.8833413333336,1731.7666826666668,1671.9666346666668,1655.0832933333334,1642.0666106666667,0.693979376070073,-15272905.0,+1
2014-02-12,1685.0,1689.800049,1643.099976,1678.1500239999998,1575.4492189999999,442825.0,1646.2499877000002,1651.7363479818182,112.1500239999998,50.86526405609216,-8.236968912959933,-104.58192726493644,-24.790432612007724,68449.0227936867,-439005.3141051396,0.0,56.00000000000001,-56.0,33.050048999999944,1670.350016333333,1697.6000566666662,1717.0500893333333,1744.3001296666662,1650.8999836666662,1623.649943333333,1604.1999106666663,0.7505351865295767,-15715730.0,-1
2014-02-13,1646.0,1658.800049,1632.5,1647.699951,1569.28186,439092.0,1643.6349852,1651.9999776727273,-26.150024999999914,43.161366708927886,-9.215081235030205,-104.45872325260666,-36.87079200964291,158598.8929466412,-411833.93009674945,0.0,52.0,-56.00000000000001,46.700072999999975,1646.3333333333333,1660.1666666666665,1672.6333823333334,1686.4667156666665,1633.8666176666666,1620.0332843333333,1607.5665686666666,0.5779438281654946,-16154822.0,-1
2014-02-14,1642.0,1653.550049,1615.650024,1641.25,1571.337524,451950.0,1644.1699827999998,1651.566344,5.34997599999997,41.6206799889322,-6.868961352657005,-85.93739556182823,-37.04050122327708,-357341.36116188724,-409356.33744103735,36.0,48.0,-52.0,45.6500239999998,1636.816691,1657.983358,1674.716716,1695.8833829999999,1620.083333,1598.916666,1582.1833080000001,0.6754606626248935,-16606772.0,-1
2014-02-17,1635.0,1674.900024,1635.0,1643.400024,1592.659668,617227.0,1644.8849852,1651.426351490909,7.15002400000003,42.411342064019166,-6.541602178517396,-83.13331486648235,-21.888786152587073,-965943.5401796582,-434662.1681070071,32.0,44.0,-12.0,37.900024999999914,1651.100016,1667.2000320000002,1691.00004,1707.1000560000002,1627.3000080000002,1611.199992,1587.3999840000001,0.21052679066057764,-15989545.0,+1
2014-02-18,1675.0,1733.6500239999998,1666.099976,1665.699951,1633.5351560000001,954637.0,1649.6049803,1655.2108907272727,47.199951000000056,50.44363214139024,-4.15685755374875,-75.55042826051181,10.2067032029312,45859.48553551854,-412814.9904381397,28.000000000000004,40.0,-12.0,39.90002400000003,1688.4833170000002,1710.8666580000004,1756.0333649999998,1778.4167060000002,1643.3166100000005,1620.9332690000003,1575.7665620000007,-0.0059219054885040956,-15034908.0,+1
2014-02-19,1714.0,1721.0,1692.0,1708.449951,1623.639038,341015.0,1658.4849730000003,1665.9099763090908,88.79992700000003,62.12791837546437,-1.541618856024912,-67.22156649642784,32.91681882600129,173582.63646059562,-386154.3973947202,24.0,36.0,-11.999999999999996,90.24999999999977,1707.149983666667,1722.2999673333338,1736.1499836666671,1751.2999673333338,1693.2999673333338,1678.149983666667,1664.2999673333338,0.5672396896551744,-14693893.0,+1
2014-02-20,1697.0,1706.0,1674.199951,1698.0999760000002,1609.488159,344996.0,1667.6249755000003,1673.112704127273,91.40002500000014,58.288738468625205,-2.1747803797786878,-56.652252957939936,27.095559882837964,-81230.51238453072,-372291.16551921034,20.0,32.0,-12.0,55.300048999999944,1692.7666423333333,1711.3333336666665,1724.566691333333,1743.1333826666664,1679.5332846666665,1660.9665933333333,1647.7332356666666,0.7515719551249805,-15038889.0,-1
2014-02-21,1686.0999760000002,1702.4000239999998,1671.550049,1683.300049,1602.125732,340948.0,1671.9849853,1675.9627174909092,43.60009799999989,52.89562459614284,-3.0801684923842676,-44.16079315724414,28.330299059813616,69099.81456879896,-352223.7175632763,16.0,28.000000000000004,-12.0,34.25,1685.7500406666666,1699.9500323333332,1716.6000156666664,1730.800007333333,1669.1000573333333,1654.9000656666667,1638.2500823333335,0.38087551124433827,-15379837.0,-1
2014-02-24,1675.0,1695.0,1645.800049,1675.599976,1610.539795,326898.0,1673.0499878,1676.6199885272727,10.650024999999914,50.11218713455709,-3.5512217996333537,-29.814629847073775,19.2807824601735,28533.023255811662,-334913.11687880976,12.0,24.0,-12.000000000000004,30.84997499999986,1672.1333416666666,1698.4666343333333,1721.3332926666667,1747.6665853333334,1649.2666833333333,1622.9333906666666,1600.0667323333332,0.6056901763987528,-15706735.0,-1
2014-02-25,1690.0999760000002,1693.9000239999998,1672.400024,1684.4000239999998,1604.42041,245384.0,1672.6049926,1678.683631472727,-4.449952000000394,53.349301021556904,-3.012877330126293,-19.862052898910406,38.344412371283724,369278.4350081647,-302898.2733674048,8.0,20.0,-12.0,49.199951000000056,1683.5666906666665,1694.733357333333,1705.066690666666,1716.2333573333328,1673.2333573333333,1662.0666906666668,1651.7333573333335,0.5581395348837163,-15461351.0,+1
2014-02-26,1668.0,1684.0999760000002,1651.0,1678.0,1591.082275,584837.0,1672.5899902,1679.664541909091,-0.15002399999980298,50.59437333387404,-3.404399913311341,-12.84167984145779,19.56216573079215,1974167.2693639956,-199376.3530219716,4.0,16.0,-12.0,21.499999999999773,1671.0333253333336,1691.066650666667,1704.1333013333337,1724.1666266666673,1657.966674666667,1637.9333493333334,1624.8666986666667,0.8157105612402813,-16046188.0,-1
2014-02-28,1640.0,1659.050049,1573.0,1664.050049,1519.32312,1768632.0,1674.225,1678.1118253272725,16.35009799999989,44.77879560422954,-4.257790596037692,-7.757173677639912,-56.05844482127484,-351774.9046931339,-206304.7699685864,0.0,12.0,-12.0,33.4000239999998,1632.033366,1691.0667319999998,1718.083415,1777.1167809999997,1605.0166829999998,1545.983317,1518.9666339999999,1.0581057193819843,-17814820.0,-1
2014-03-03,1582.0,1616.900024,1575.0,1589.0,1512.821045,1060385.0,1669.0,1662.6163707818184,-52.25,26.13236863944546,-8.848990418514184,-2.643906122608769,-145.87148722883478,171593.0456439262,-189124.73241362994,0.0,8.0,-12.0,105.0,1593.6333413333334,1612.2666826666668,1635.5333653333337,1654.1667066666669,1570.3666586666668,1551.7333173333334,1528.4666346666668,0.33412868689526265,-18875205.0,-1
2014-03-04,1577.0,1603.0,1550.0,1582.199951,1527.354736,797764.0,1662.8799927000002,1646.834543690909,-61.200072999999975,25.042173587585637,-9.264984600764901,5.702773014897957,-163.48083192134905,-598888.6116175997,-207753.32773240146,0.0,4.0,-8.0,89.05004899999994,1578.399983666667,1606.7999673333338,1631.3999836666671,1659.7999673333338,1553.7999673333338,1525.399983666667,1500.7999673333338,0.6075462452830199,-19672969.0,-1
2014-03-05,1614.699951,1636.949951,1593.550049,1597.400024,1554.127075,728060.0,1656.0500000000002,1634.9290948363637,-68.29992700000003,32.3240201151078,-8.335117486897598,14.389553399128772,-85.33608150837665,-262418.0743721019,-210238.46643782675,0.0,0.0,-4.0,53.0,1609.3000080000002,1625.0499670000004,1652.6999100000003,1668.4498690000005,1581.6500650000003,1565.900106,1538.2501630000002,0.08870930169381663,-18944909.0,+1
2014-03-06,1629.699951,1657.0,1618.0,1625.400024,1578.0783689999998,422906.0,1647.7450073000002,1629.356371927273,-83.04992700000003,43.90640684074316,-6.622212608856254,19.302998580991698,-39.17210942503614,-762944.6065579333,-235365.11607582876,56.00000000000001,92.0,0.0,54.75,1633.466674666667,1648.9333493333338,1672.4666746666671,1687.9333493333338,1609.9333493333338,1594.466674666667,1570.9333493333338,0.18974420512820592,-18522003.0,+1
2014-03-07,1655.0,1747.0,1640.199951,1650.449951,1658.9689939999998,944177.0,1642.9800048000004,1629.848179872727,-47.65002500000014,52.32847734333,-5.858619478155337,13.31980368475206,44.012385700060676,-840127.8999404703,-262858.1387089643,52.0,88.0,-35.99999999999999,59.59997599999997,1679.216634,1718.2333170000002,1786.0166830000003,1825.0333660000001,1611.4332680000002,1572.4165850000002,1504.6332190000003,0.09597373873864051,-17577826.0,+1
2014-03-10,1730.0,1817.25,1716.6500239999998,1735.050049,1722.122559,1324717.0,1648.1550048,1646.588187909091,51.75,69.92491573935398,-4.78393429361269,9.91081863825525,200.95006460087976,480396.0033311891,-229069.39554872824,96.0,84.0,-36.0,121.59997599999997,1756.316691,1795.9833580000002,1856.9166670000002,1896.5833340000004,1695.383382,1655.7167149999998,1594.7834059999998,0.18290287663687022,-16253109.0,+1
2014-03-11,1804.0,1811.699951,1744.800049,1801.0999760000002,1677.231201,703249.0,1660.7050048,1674.396364490909,125.50000000000023,77.42988482322909,-0.9399111887094312,6.992361145262748,220.19488625860566,485130.13690795883,-196601.68596287252,96.0,80.0,12.0,166.80004899999994,1785.8666586666668,1826.9332683333337,1852.766560666667,1893.8331703333338,1760.0333663333336,1718.9667566666667,1693.1334643333334,0.8415547006331962,-15549860.0,+1
2014-03-12,1725.0,1791.0,1680.0,1754.1500239999998,1686.6973879999998,1443683.0,1667.6800048,1691.386367981818,69.75,64.27480368683464,-3.6723396478975814,4.958957741569975,109.45091237099017,46550.43817045852,-185547.98607413055,92.0,76.0,16.0,76.64990200000011,1741.7166746666664,1803.433349333333,1852.7166746666662,1914.433349333333,1692.433349333333,1630.7166746666664,1581.433349333333,0.6680182342342325,-16993543.0,-1
2014-03-13,1766.0,1790.9000239999998,1733.0,1764.050049,1670.72937,641720.0,1676.2850097000003,1708.9081941999998,86.05004899999994,65.6929383928344,-3.096170580532522,3.154559352848537,127.35440760150635,360259.57088081434,-160735.70060626793,88.0,72.0,16.0,121.0999760000002,1762.6500243333332,1792.3000486666665,1820.550048333333,1850.2000726666663,1734.4000246666667,1704.7500003333334,1676.500000666667,0.5362700540504103,-16351823.0,+1
2014-03-14,1715.0,1756.3499760000002,1710.0,1747.3499760000002,1662.219604,588996.0,1684.6150024,1721.8290971636363,83.29992700000025,60.98132444053996,-4.0680939327804335,-0.1772761368747524,77.34230101328806,-8997348.179310234,-562443.9644474862,84.0,68.0,16.0,57.9000239999998,1737.8999840000004,1765.7999680000007,1784.2499600000006,1812.149944000001,1719.4499920000005,1691.5500080000002,1673.1000160000003,0.8058251421748317,-16940819.0,-1
2014-03-18,1900.0,1909.0,1852.25,1738.449951,1786.2801510000002,1795672.0,1699.5599975000002,1731.6172696363637,149.44995100000006,58.405447389057954,-9.422654640883975,-3.7055916902966146,183.08779261662738,-54434.31915774983,-539350.1990935855,80.0,64.0,16.0,54.050048999999944,1833.2333170000002,1814.2166340000003,1889.9833170000002,1870.9666340000003,1757.4666340000003,1776.4833170000002,1700.7166340000003,-2.005287207048457,-18736491.0,-1
2014-03-19,1873.0,1889.0,1850.75,1868.199951,1787.762207,621508.0,1728.1599975000004,1762.2790793636364,286.0,75.6834673679702,-2.2541463535911572,0.15827621916582757,183.18393504190604,193075.99814945925,-506054.771748907,96.0,60.0,16.0,161.6500239999998,1869.3166503333334,1887.8833006666669,1907.5666503333332,1926.1333006666669,1849.6333006666669,1831.0666503333334,1811.3833006666669,0.45620786928104723,-18114983.0,+1
2014-03-20,1869.0,1874.800049,1848.050049,1869.75,1775.141113,310199.0,1755.3949951,1788.0227161818184,272.34997599999997,75.82190861311719,-2.1685082872928176,17.12975970564571,144.16061189481732,-284182.0,-495968.68359670904,92.0,56.00000000000001,36.0,150.55004899999994,1864.2000326666666,1880.3500163333333,1890.9500326666666,1907.1000163333333,1853.6000163333333,1837.4500326666666,1826.8500163333333,0.8112131214953292,-17804784.0,+1
2014-03-21,1856.550049,1879.25,1856.550049,1856.550049,1786.6149899999998,284182.0,1778.5099976,1806.4145441636363,231.1500249999999,71.8049878883671,-2.8977873480663012,38.13889190547388,119.64033185953781,-166697.29709513206,-481000.4393990394,88.0,52.0,35.99999999999999,26.75,1864.1166993333334,1871.6833496666668,1886.8166503333337,1894.3833006666669,1848.9833986666667,1841.4167483333333,1826.2834476666667,0.0,-18088966.0,-1
2014-03-25,1881.0,1912.0,1875.8499760000002,1886.300049,1818.311279,395158.0,1802.0950073999998,1826.0127353272728,235.8500979999999,75.21910278530878,-1.4175372862658608,59.25588928090565,121.04571388362753,-49699.38255385922,-461394.1417279442,84.0,48.0,36.0,22.699951000000056,1891.3833416666669,1906.9167073333335,1927.5333656666664,1943.0667313333333,1870.7666833333337,1855.233317666667,1834.616659333334,0.2890751331174719,-17693808.0,+1
2014-03-26,1911.0,1949.0,1911.0,1901.699951,1852.1590579999997,634815.0,1818.7599976000001,1844.1227250727272,166.6499020000001,76.89048426579477,-2.5567594054054026,77.12009030170225,123.96796502490201,-335768.1380832032,-455683.3950198892,96.0,44.0,28.0,0.0,1920.5666503333334,1930.1333006666669,1958.5666503333332,1968.1333006666669,1892.1333006666669,1882.5666503333334,1854.1333006666669,-0.24473813157894592,-17058993.0,+1
2014-03-27,1941.0,1968.4000239999998,1920.1500239999998,1937.0999760000002,1850.677002,825829.0,1832.3599976,1865.6390847818182,136.0,80.39726592272825,-1.6743365570856337,94.0105423100797,119.95868440538779,206327.90973350863,-425589.588716009,96.0,40.0,28.0,0.0,1941.8833413333332,1963.6166586666666,1990.133341333333,2011.8666586666666,1915.3666586666666,1893.6333413333332,1867.1166586666666,0.35129434196892007,-16233164.0,+1
2014-03-28,1935.9000239999998,1956.550049,1920.0999760000002,1935.550049,1846.7088620000002,326409.0,1850.5000001,1884.400912309091,181.40002500000014,79.78562279195495,-1.7572469550797363,100.97077617702575,99.2771892122066,-102474.89510918199,-410901.446797004,96.0,36.0,36.0,0.0,1937.4000246666667,1954.7000733333332,1973.8500976666667,1991.150146333333,1918.2500003333334,1900.949951666667,1881.7999273333337,0.4238694665988695,-16559573.0,-1
2014-03-31,1937.949951,1980.0,1925.0,1931.4000239999998,1885.289673,437613.0,1867.2349976000003,1899.1100075636364,167.34997499999986,77.95339596301616,-2.583730781499213,100.92962546928061,87.79788943729045,-205575.0691432162,-401567.75609733653,92.0,32.0,52.0,62.699951000000056,1945.4666746666664,1965.933349333333,2000.4666746666662,2020.933349333333,1910.933349333333,1890.4666746666664,1855.933349333333,0.11636407272726915,-16997186.0,-1
2014-04-01,1976.0,1980.0,1922.0999760000002,1971.75,1846.182983,288560.0,1889.675,1918.1127352727272,224.4000239999998,82.46971034219517,-0.43859649122807015,111.79369271979522,79.30819179993121,73061.90564358543,-379992.19440705114,96.0,28.000000000000004,56.0,66.70007299999975,1957.949992,1993.800008,2015.8500159999996,2051.7000319999997,1935.8999840000001,1900.0499680000003,1877.9999600000003,0.8575130124298389,-16708626.0,+1
2014-04-02,1935.0,1948.699951,1922.8499760000002,1930.8499760000002,1848.430054,268932.0,1908.9150025000001,1925.5990945454548,192.40002500000014,66.52977051690965,-2.612973099415194,120.92367915249156,57.342284056093256,231565.2359172193,-352192.30153537134,92.0,24.0,60.0,36.45007299999975,1934.133301,1945.416626,1959.9832760000002,1971.2666009999998,1919.566651,1908.2833260000002,1893.7166760000002,0.3094780555880632,-16977558.0,-1
2014-04-03,1940.0,1964.4000239999998,1927.0,1933.199951,1854.644897,307539.0,1915.4150025,1930.014539727273,65.0,66.95322706291248,-2.4880408825093006,132.803374080416,52.17810010029788,-66563.79280584255,-339208.37260689173,88.0,20.0,60.0,55.0,1941.5333249999996,1956.0666499999993,1978.9333489999995,1993.466673999999,1918.6666259999995,1904.1333009999998,1881.2666019999997,0.16577398453006575,-16670019.0,+1
2014-04-04,1940.0,1950.0,1917.1500239999998,1939.699951,1842.692993,195927.0,1922.4099976,1934.4299849090908,69.94995100000006,68.23581144549748,-2.142480010632639,147.20036049305372,40.91414602175641,-208651.85205288656,-333273.62976427935,84.0,16.0,68.0,57.9000239999998,1935.6166583333331,1954.0832926666665,1968.4666343333336,1986.9332686666667,1921.2333166666663,1902.766682333333,1888.383340666666,0.686451856159655,-16474092.0,+1
2014-04-07,1925.0,1936.0,1872.0,1927.199951,1821.418579,319401.0,1929.4749878000002,1935.3008855272728,70.64990200000011,62.82532632329228,-2.8070201488569877,145.08711352248702,23.503826003336584,949271.8042717259,-274972.7760488792,80.0,12.0,68.0,48.9000239999998,1911.7333170000002,1951.4666340000003,1975.7333170000002,2015.4666340000003,1887.4666340000003,1847.7333170000002,1823.4666340000003,0.8624992343750009,-16793493.0,-1
2014-04-09,1890.0,1940.0,1876.0,1904.949951,1847.76062,698363.0,1931.3399780000002,1930.841787927273,18.64990200000011,54.026955697166684,-3.989901594896329,142.0274866192285,16.13841428010199,96426.81134868685,-258090.0550524596,76.0,8.0,68.0,37.4000239999998,1906.9833170000002,1937.9666340000003,1970.9833170000002,2001.9666340000003,1873.9666340000003,1842.9833170000002,1809.9666340000003,0.45234298437500087,-17491856.0,-1
2014-04-10,1933.0,1973.5,1916.0999760000002,1932.5,1874.0069579999997,486855.0,1934.4199829000002,1931.0527010181818,30.800048999999944,61.69174375026893,-2.525252525252525,140.86846575512914,28.993247488329924,-357021.28615921654,-262587.16351699556,72.0,4.0,68.0,32.8499760000002,1940.699992,1965.300008,1998.1000159999996,2022.7000319999997,1907.8999840000001,1883.2999680000003,1850.4999600000003,0.2857145843702062,-17005001.0,+1
2014-04-11,1941.0,1948.699951,1923.1500239999998,1959.949951,1850.820313,504763.0,1936.7049804000003,1935.6945133999998,22.84997499999986,67.85341871455933,-1.0659249867091942,131.87696650052385,28.331764688852992,-51088.80327252636,-252973.12351510016,68.0,0.0,68.0,67.69995100000006,1943.9333086666666,1964.7165933333333,1969.4832356666668,1990.2665203333336,1939.166666333333,1918.3833816666663,1913.6167393333328,1.44031436958704,-16500238.0,+1
2014-04-15,1924.300049,1948.5999760000002,1904.0,1935.699951,1842.692993,228758.0,1936.7199706000006,1935.5117807818183,0.149902000000111,58.295572299377504,-2.3551328548644306,119.65081363450417,16.92177704251073,-524470.1907267197,-265314.4852176291,64.0,0.0,68.0,64.0,1929.433309,1954.866618,1974.0332850000004,1999.4665940000002,1910.2666419999998,1884.8333329999998,1865.6666659999996,0.7107616156564729,-16728996.0,-1
2014-04-16,1929.25,1964.800049,1926.449951,1927.199951,1850.390015,371554.0,1936.2999633000002,1933.7808681272727,-4.2000729999997475,55.15349789987782,-2.8070201488569877,102.84143737847307,18.86421737457876,22345.49658508943,-252238.43891734382,60.0,0.0,68.0,68.55004899999994,1939.4833170000002,1952.5166830000003,1977.833415,1990.8667810000002,1914.1665850000004,1901.1332190000003,1875.8164870000005,0.01955666449665923,-17100550.0,-1
2014-04-17,1937.5,1961.5,1915.9000239999998,1935.25,1865.78418,337629.0,1932.6499633,1933.5899657090908,-36.5,57.647991586975074,-2.3790536948431686,87.51811516006364,12.94379671545303,-188182.91748671373,-249326.6983501582,56.00000000000001,0.0,68.0,25.549927000000253,1937.550008,1959.199992,1983.1499840000004,2004.7999680000003,1913.6000159999999,1891.9500319999997,1868.0000399999997,0.4243418022851616,-16762921.0,+1
2014-04-21,1953.449951,2001.0,1953.449951,1951.3499760000002,1901.114014,481905.0,1934.6999633,1936.989968018182,20.5,62.465859813450244,-2.6104113564668667,74.16653719521105,32.03328990914973,0.0,-237993.19862485267,52.0,8.0,64.0,55.949951000000056,1968.5999756666668,1983.7500003333334,2016.150024666667,2031.3000493333334,1936.1999513333335,1921.0499266666668,1888.6499023333336,-0.04416346658233435,-16281016.0,+1
2014-04-22,1998.949951,2006.8499760000002,1967.0,1988.300049,1888.9707030000002,323792.0,1940.2099730999998,1946.7354381454545,55.10009799999989,71.15519412617299,-0.972294846730666,60.862328269923864,46.50125983983858,734381.9410682842,-193792.5864704621,96.0,4.0,60.0,38.35009799999989,1987.3833416666669,2007.7666833333337,2027.233317666667,2047.616659333334,1967.9167073333335,1947.5333656666667,1928.0667313333333,0.5345059429897734,-15957224.0,+1
2014-04-23,1984.9000239999998,1994.0,1969.0,1975.5999760000002,1895.137939,398691.0,1943.7999756000002,1953.1699841272728,35.90002500000014,65.17166165352143,-1.6379694626470982,56.58793288732477,39.39441547687103,74958.3267649586,-181576.1762455331,96.0,0.0,56.00000000000001,45.5999760000002,1979.5333253333336,1990.066650666667,2004.5333253333338,2015.066650666667,1965.066650666667,1954.5333253333336,1940.066650666667,0.2639990400000079,-16355915.0,-1
2014-04-24,1982.050049,1982.050049,1982.050049,1982.050049,1895.137939,0.0,1949.2849853999999,1960.1245429272726,54.85009799999989,66.80734544426664,-1.299888739260086,49.14873905274658,41.23563273070457,195938.37211077474,-164415.80776241643,92.0,4.0,44.0,65.75,1982.0500490000002,1982.0500490000004,1982.050049,1982.0500490000004,1982.0500490000004,1982.0500490000002,1982.0500490000004,,-16355915.0,+1
2014-04-25,1990.0,1994.0,1917.0,1982.050049,1870.421509,1064921.0,1956.9949952,1966.0818272181818,77.10009799999989,66.80734544426664,-1.299888739260086,41.25492092695026,22.44144588498257,-153871.20843989198,-163936.49136183364,88.0,0.0,92.0,55.5,1964.350016333333,2011.7000326666662,2041.3500163333329,2088.700032666666,1934.7000326666662,1887.350016333333,1857.7000326666662,0.8448058311688305,-16355915.0,-1
2014-04-28,1950.0,1966.800049,1936.949951,1956.199951,1864.9237059999998,258675.0,1959.3649903,1965.937273727273,23.699951000000056,53.42075456450224,-2.654822215433995,33.22825601512159,8.62436388864873,648735.6396541925,-126995.64024087907,84.0,8.0,96.0,25.0,1953.3166503333334,1969.6833496666668,1983.1667483333335,1999.5334476666667,1939.833251666667,1923.4665523333335,1909.983153666667,0.6448890050545252,-16614590.0,-1
2014-04-29,1955.0,1961.0,1910.300049,1950.449951,1832.46228,335612.0,1958.4149903000002,1964.316357490909,-9.5,50.80781221830811,-2.9562085965610607,27.513207017960212,-10.07320955525821,-109227.32756365534,-126187.96443669086,80.0,4.0,88.0,6.4500729999997475,1940.5833333333333,1970.8666176666666,1991.283284333333,2021.5665686666666,1920.1666666666665,1889.8833823333332,1869.4667156666665,0.7919120474100668,-16950202.0,-1
2014-04-30,1921.0999760000002,1940.800049,1911.0,1916.5,1838.6771239999998,243902.0,1956.4949952000002,1956.6954501636365,-19.199951000000056,38.1089237946495,-4.735696052444753,25.26435861439063,-43.53469132072561,-24246.962628766265,-121554.14437685335,76.0,0.0,88.0,77.0,1922.7666829999998,1934.5333659999997,1952.5667319999998,1964.3334149999996,1904.7333169999997,1892.9666339999999,1874.9332679999998,0.18456345491244025,-17194104.0,-1
2014-05-02,1895.0,1908.699951,1880.050049,1923.0,1800.813721,324650.0,1956.0750001000001,1950.6054510363633,-4.1999510000000555,41.34742743684838,-4.394998404214157,19.318497383825843,-79.13185782325095,297703.36112577346,-102496.44264959435,72.0,0.0,76.0,45.10009799999989,1903.9166666666667,1927.7832843333335,1932.5665686666666,1956.4331863333337,1899.1333823333334,1875.2667646666666,1870.4834803333333,1.4991308172712035,-16869454.0,+1
2014-05-05,1883.0,1916.4000239999998,1866.0,1883.4000239999998,1814.630127,352889.0,1950.8900025000003,1937.3918190181816,-51.8499760000002,30.22850881203368,-6.470632049320024,14.621205531419719,-101.37145471757654,-104071.06056781714,-102568.0181357919,68.0,36.0,76.0,50.699951000000056,1888.6000159999996,1911.2000319999993,1939.0000399999994,1961.600055999999,1860.8000079999995,1838.1999919999998,1810.3999839999997,0.3452384070293274,-17222343.0,-1
2014-05-06,1899.0,1916.050049,1883.0,1897.8499760000002,1826.48645,239206.0,1945.5400025,1927.7481778363638,-53.5,37.32476693249894,-5.71323748571308,13.146510207512392,-78.9712476295264,-310955.3715641043,-112040.4161999453,64.0,96.0,76.0,39.449951000000056,1898.966675,1914.9333499999998,1932.016724,1947.9833989999997,1881.8833009999998,1865.916626,1848.833252,0.4493178209811496,-16983137.0,+1
2014-05-07,1905.199951,1907.199951,1878.0999760000002,1910.25,1798.758057,246112.0,1937.7349976,1921.3318137454544,-78.05004899999994,43.05906209356786,-5.063289944974174,11.794229248467673,-78.07615690712555,-446503.51771355054,-127243.6607765894,60.0,92.0,72.0,36.449951000000056,1898.5166423333333,1918.9333086666663,1927.6166173333334,1948.0332836666662,1889.8333336666665,1869.4166673333334,1860.7333586666666,1.104812770457705,-16737025.0,+1
2014-05-08,1888.0,1900.0,1876.199951,1881.25,1813.434814,180796.0,1928.3000000000002,1911.061814181818,-94.3499760000002,34.533105767061926,-6.58332560631068,9.582794595092992,-97.4040890826629,-428441.4435293165,-140934.79257582358,56.00000000000001,88.0,32.0,57.0,1885.8166503333334,1895.4333496666668,1909.6166993333331,1919.2333986666667,1871.6333006666669,1862.0166013333335,1847.833251666667,0.21218649591855698,-16917821.0,-1
2014-05-09,1880.0,1983.75,1880.0,1896.5999760000002,1888.25354,457287.0,1919.7549927000002,1905.2981734545456,-85.45007299999975,41.595942503899046,-5.778756264218964,2.1026985923501798,-28.221798421209915,6531.387280197139,-134231.63321832102,52.0,84.0,-32.0,33.050048999999944,1920.1166586666668,1960.2333173333336,2023.8666586666668,2063.9833173333336,1856.4833173333336,1816.3666586666668,1752.7333173333336,0.1599997686747007,-16460534.0,+1
2014-05-12,1975.0,2064.850098,1965.050049,1974.8499760000002,1960.0128170000003,555623.0,1919.0349854,1915.3154431454548,-7.2000729999997475,64.26954497641508,-4.578178269623064,-2.550298198449809,122.45165470526716,-311850.683273999,-142305.40022038072,48.0,80.0,-32.0,29.09997499999986,2001.5833743333333,2038.1166996666666,2101.383423333333,2137.9167486666665,1938.3166506666666,1901.7833253333333,1838.5166016666667,0.0981956131103729,-15904911.0,+1
2014-05-13,2080.0,2120.0,2042.550049,2049.899902,1998.6890870000002,528807.0,1928.4049805000002,1939.1090643454547,93.69995100000006,75.00714472761709,-3.468584760019787,-4.0177715785343935,237.03764220774983,-1010094.4504615029,-181751.16766489894,96.0,76.0,-31.999999999999993,34.050048999999944,2070.816650333333,2099.0832516666665,2148.2666013333333,2176.5332026666665,2021.6333006666664,1993.3666993333331,1944.1833496666663,0.09489809748233619,-15376104.0,+1
2014-05-14,2092.0,2120.0,2059.5,2090.350098,1993.7645260000002,329237.0,1942.3949951999998,1968.5536311636365,139.90014699999983,78.94257479931036,-1.467090648193969,-7.139147284750152,228.15049075027082,-1109498.3725155983,-223922.32238860472,96.0,72.0,-32.0,103.75,2089.9500326666666,2120.4000653333333,2150.4500326666666,2180.9000653333333,2059.9000653333333,2029.4500326666666,1999.4000653333333,0.5099189752066098,-15046867.0,+1
2014-05-15,2082.0,2127.0,2078.0,2085.199951,2024.983398,441637.0,1959.2649903000001,1994.518168581818,168.69995100000006,77.15772111794595,-2.061146400394475,-6.624760293886084,193.36765476417503,41289.35415045299,-211867.02045412085,92.0,68.0,-32.0,168.2501219999997,2096.733317,2115.4666340000003,2145.733317,2164.4666340000003,2066.4666340000003,2047.7333170000002,2017.4666340000003,0.1469377755102052,-15488504.0,-1
2014-05-16,2200.0,2318.5,2140.100098,2117.850098,2057.779053,808438.0,1978.7500000999999,2023.3518245272726,194.8500979999999,80.39942644343654,-9.040319981977927,-3.776452222734406,272.2142660909979,51179.17871137073,-199910.1613292115,96.0,64.0,20.0,145.1500239999998,2192.1500653333333,2244.2000326666666,2370.5499673333334,2422.5999346666667,2065.8001306666665,2013.7501633333331,1887.4002286666664,-0.12471979945370142,-14680066.0,+1
2014-05-19,2190.0,2250.0,2190.0,2152.149902,2117.53833,490566.0,2005.6249879000002,2054.8790794181814,268.7498780000003,83.27630058254259,-7.49493570624014,4.538240902243615,207.33539815165437,-1272419.1842490921,-248661.40319997666,96.0,60.0,24.0,70.10009799999989,2197.383300666667,2204.7666013333337,2257.3833006666664,2264.7666013333337,2144.7666013333337,2137.383300666667,2084.7666013333337,-0.6308349666666648,-14189500.0,+1
2014-05-20,2222.0,2236.800049,2182.550049,2214.649902,2097.794189,225127.0,2037.3049805,2092.8836092545457,316.7999259999999,87.22010697490839,-4.6789861680558635,13.249671757012038,172.05900552100243,-400969.1376314961,-255584.59478447502,92.0,56.00000000000001,24.0,49.0,2211.3333333333335,2240.116617666667,2265.5833333333335,2294.366617666667,2185.866617666667,2157.0833333333335,2131.616617666667,0.5917023594470077,-13964373.0,+1
2014-05-21,2201.0,2209.949951,2166.0,2194.0,2074.081055,186665.0,2065.6799805000005,2121.3736128,283.75,80.02564531288976,-5.609371480063078,30.163419347127956,124.28412355922532,-193097.1887462601,-252744.21399231083,88.0,52.0,32.0,233.30004899999994,2189.983317,2213.9666340000003,2233.9332680000007,2257.9165850000004,2170.0166830000003,2146.033366,2126.0667320000002,0.6370883098367951,-14151038.0,-1
2014-05-22,2204.949951,2287.0,2204.949951,2169.199951,2165.489502,679922.0,2094.4749756000006,2140.1954256181816,287.94995100000006,71.81666232176721,-6.726742464519034,48.101313744165736,122.6978032728757,78362.5480817465,-237693.6832976363,84.0,48.0,36.0,132.1499020000001,2220.383300666667,2235.8166503333337,2302.4333496666663,2317.8666993333336,2153.7666013333337,2138.333251666667,2071.7165523333338,-0.435709672763267,-14830960.0,-1
2014-05-23,2278.699951,2403.0,2265.350098,2264.800049,2281.231445,397790.0,2131.2949829000004,2171.1636207818183,368.20007299999975,80.64678863315093,-5.99826176215278,67.19273940796256,152.47866275979175,-194728.48410304208,-235740.69203562327,80.0,44.0,35.99999999999999,84.65014699999983,2311.050049,2356.75,2448.6999509999996,2494.399902,2219.100098,2173.400147,2081.450196,-0.003995999939033331,-14433170.0,+1
2014-05-26,2407.5,2505.0,2314.050049,2385.850098,2238.635254,778712.0,2172.3949951000004,2217.446368981818,411.0001219999997,86.72392256342792,-4.952198753117211,95.34270696734643,168.54901262725738,115952.39226860821,-219754.42661114509,96.0,40.0,36.0,48.64990200000011,2401.633382333333,2489.216715666666,2592.5833333333335,2680.166666666666,2298.266764666666,2210.683431333333,2107.316813666666,0.37601501662600545,-13654458.0,+1
2014-05-27,2345.949951,2368.0,2289.0,2341.300049,2201.105957,241821.0,2201.5350098000004,2248.1563787818177,291.40014699999983,76.52031721539333,-6.803821737323361,124.0212867997916,108.01065825615571,39069.147917256465,-207989.56684463445,96.0,36.0,36.0,93.0,2332.766683,2376.5333659999997,2411.766683,2455.5333659999997,2297.5333659999997,2253.766683,2218.5333659999997,0.66202593670886,-13896279.0,-1
2014-05-28,2290.0,2360.300049,2285.25,2302.050049,2208.659668,352579.0,2222.7050049000004,2266.431840454545,211.69995100000006,68.34573544029763,-8.435160058187865,144.8562935024729,84.53358134750516,-233958.6612942604,-209169.99477045774,92.0,32.0,36.0,233.80004899999994,2315.866699333333,2346.4833986666663,2390.916748333333,2421.5334476666662,2271.4333496666663,2240.816650333333,2196.3833006666664,0.22385127290189985,-14248858.0,-1
2014-05-29,2303.100098,2337.699951,2255.050049,2309.949951,2204.739502,352983.0,2245.1800049,2282.2945579272728,224.75,69.11205127233167,-8.106818329177056,160.01695627400431,66.71625306925993,-144718.23662906908,-206240.33495025476,88.0,28.000000000000004,56.0,240.19995100000006,2300.8999836666667,2346.7499183333334,2383.549885666667,2429.3998203333335,2264.1000163333333,2218.2500816666666,2181.450114333333,0.6642464258457322,-13895875.0,+1
2014-05-30,2314.149902,2339.949951,2254.0,2305.850098,2172.1826170000004,189180.0,2263.9800049,2293.3254839454544,188.0,68.12446921659416,-8.277219534497094,170.3834848131944,55.547424062637845,-308392.96045273397,-210883.68822918576,84.0,24.0,60.0,96.85009799999989,2299.933349666667,2345.8666993333336,2385.8833006666664,2431.8166503333337,2259.9167483333335,2213.9833986666667,2173.9667973333335,0.6032591920849362,-14085055.0,-1
2014-06-02,2270.0,2340.350098,2270.0,2271.800049,2222.380615,246577.0,2275.9450196,2294.7473101454543,119.65014699999983,59.919367155329226,-9.692433541147134,182.52742881079485,45.01193217727646,-462790.5877721399,-222334.12452909382,80.0,20.0,60.0,75.05004899999994,2294.050049,2318.100098,2364.4001470000003,2388.450196,2247.75,2223.699951,2177.399902,0.025587014818372354,-14331632.0,-1
2014-06-03,2344.699951,2356.800049,2310.0,2324.300049,2234.380127,372134.0,2286.9100343,2303.5391336727275,109.65014699999983,66.99211295338563,-7.510388653366586,192.9871568944318,49.61827475334899,-233628.84181235477,-222847.52601998503,76.0,16.0,60.0,82.64990200000011,2330.366699333333,2350.7333986666663,2377.166748333333,2397.5334476666662,2303.9333496666663,2283.566650333333,2257.1333006666664,0.3055562826440622,-13959498.0,+1
2014-06-04,2339.300049,2393.050049,2338.0,2336.850098,2268.036865,296026.0,2301.1950441000004,2312.6191452545454,142.8500979999999,68.52413554810218,-6.98877398171239,198.78582895647742,50.23479221193104,-264220.42708364694,-224728.13079134005,72.0,12.0,60.0,85.94995100000006,2355.9667156666665,2373.933431333333,2411.016764666667,2428.983480333333,2318.883382333333,2300.9166666666665,2263.833333333333,-0.020888301116682242,-13663472.0,+1
2014-06-05,2410.0,2427.0,2367.149902,2372.050049,2276.785645,553410.0,2321.4800539000003,2325.5018734181817,202.8500979999999,72.63462381463954,-5.5257668744804675,197.4193222761187,52.343914979660646,-189293.1664550668,-223117.4355845983,68.0,8.0,60.0,70.35009799999989,2388.733317,2410.3167320000002,2448.583415,2470.16683,2350.4666340000003,2328.8832190000003,2290.6165360000005,0.08187366710744304,-13110062.0,+1
2014-06-06,2402.0,2412.899902,2380.0,2381.199951,2287.159424,252012.0,2333.1200441,2336.3600365272728,116.39990200000011,73.66608631757174,-5.145471695760596,197.75967454458032,46.495591294543544,104665.28399644356,-208218.08852619873,64.0,4.0,60.0,85.0,2391.3666176666666,2402.733235333333,2424.2665196666667,2435.6331373333333,2369.833333333333,2358.4667156666665,2336.933431333333,0.036472783414371615,-12858050.0,+1
2014-06-09,2415.0,2449.0,2387.050049,2392.050049,2328.369385,315081.0,2333.7400392,2347.074582872727,6.1999510000000555,74.9575832687051,-4.694511679135497,203.3208342368771,46.83974876191605,10943.93293498252,-198256.09387418884,60.0,0.0,60.0,68.75,2409.366699333333,2431.6833496666663,2471.3166503333337,2493.6333006666664,2369.7333986666663,2347.416748333333,2307.7834476666662,0.08071031404044203,-12542969.0,+1
2014-06-10,2475.0,2484.0,2411.0,2435.149902,2356.241455,559445.0,2343.1250245,2365.5127397454544,93.84985300000017,79.55362820418428,-2.903162842892763,195.297768564325,53.41178026752882,231069.31922179184,-178741.14420345833,56.00000000000001,8.0,60.0,90.14990200000011,2443.383300666667,2475.7666013333337,2516.3833006666664,2548.7666013333337,2402.7666013333337,2370.383300666667,2329.7666013333337,0.3308205753424673,-11983524.0,+1
2014-06-11,2470.0,2482.5,2433.0,2464.300049,2341.182373,395488.0,2359.3500245,2387.544562381818,162.25,82.1151920026021,-1.6916022859517894,172.02975292579595,53.24786473250101,173196.44243249382,-162743.85741188706,52.0,4.0,60.0,40.84985300000017,2459.9333496666663,2486.8666993333327,2509.433349666666,2536.3666993333327,2437.3666993333327,2410.4333496666663,2387.8666993333327,0.6323242222222211,-11588036.0,+1
2014-06-12,2420.0,2488.350098,2406.75,2448.550049,2372.065918,446513.0,2373.2100343,2403.7627486545452,138.6000979999999,76.16625663435397,-2.346215752285954,154.543495402374,43.68094406780389,-188909.35170274597,-163933.20684460344,48.0,0.0,60.0,67.80004899999994,2447.8833823333334,2489.016764666667,2529.4834803333333,2570.6168626666667,2407.416666666667,2366.2832843333335,2325.816568666667,0.512254887242905,-12034549.0,-1
2014-06-13,2485.0,2496.0,2393.550049,2480.850098,2297.964355,328108.0,2390.7100343,2423.3336693272727,175.0,79.65414250735516,-1.0037365752285998,141.24631871956262,44.69754586690282,-205591.18605346826,-165826.76470206436,44.0,0.0,48.00000000000001,91.94995100000006,2456.800049,2520.050049,2559.2499999999995,2622.5,2417.600098,2354.350098,2315.150147,0.852123872660514,-11706441.0,+1
2014-06-16,2399.0,2409.0,2360.5,2403.350098,2276.737305,225806.0,2403.8650392000004,2425.6318627272726,131.55004899999994,56.68726555483615,-3.8652441385064713,125.93205989167427,17.900143230588757,196085.25641025644,-149376.10759582283,40.0,0.0,48.0,49.5,2390.9500326666666,2421.4000653333333,2439.4500326666666,2469.9000653333333,2372.9000653333333,2342.4500326666666,2324.4000653333333,0.8835071752577297,-11932247.0,-1
2014-06-17,2388.0,2422.5,2381.0,2381.149902,2308.577393,190284.0,2409.5500245000003,2421.5018377818183,56.84985300000017,51.75497457869379,-4.79141001251564,115.43806879839303,17.351727802725353,2884.405016359511,-142455.1307517596,36.0,0.0,48.0,81.60009799999989,2394.883300666667,2408.7666013333337,2436.3833006666664,2450.2666013333337,2367.2666013333337,2353.383300666667,2325.7666013333337,0.0036120963855448434,-12122531.0,-1
2014-06-18,2415.0,2449.0,2400.0,2414.449951,2328.226318,501190.0,2417.3100098000004,2422.392733509091,77.59985300000017,58.069354388353126,-3.4021714226115956,115.5053148312154,26.37692295218841,-47659.42908473826,-138146.2088037397,32.0,0.0,44.0,102.44995100000006,2421.1499836666667,2442.2999673333334,2470.1499836666662,2491.2999673333334,2393.2999673333334,2372.1499836666667,2344.2999673333334,0.2948969591836746,-11621341.0,+1
2014-06-19,2441.0,2449.0,2371.0,2435.0,2275.685791,305893.0,2423.6050049,2425.6090953636367,62.949951000000056,61.64395764755992,-2.5448477263245723,112.0493491285597,21.54221657366662,-336263.28905246616,-147151.58333494645,28.000000000000004,0.0,40.0,120.35009799999989,2418.3333333333335,2465.666666666667,2496.333333333334,2543.666666666667,2387.666666666667,2340.3333333333335,2309.666666666667,0.8205128205128205,-11315448.0,+1
2014-06-20,2363.25,2397.350098,2362.0,2380.050049,2262.634277,135952.0,2423.4900147000003,2417.690012472727,-1.149902000000111,48.806563351378166,-4.8372945765540285,105.55490746564146,-1.1017791451045547,-282942.57781961025,-153323.9357463116,24.0,0.0,36.0,41.5,2379.800049,2397.600098,2415.1501470000003,2432.950196,2362.25,2344.449951,2326.899902,0.5106081742687106,-11451400.0,-1
2014-06-23,2392.0,2394.949951,2351.050049,2366.399902,2275.925049,158501.0,2420.925,2407.3099919818183,-25.650146999999833,46.057381093949196,-5.406762536503959,95.92464601379561,-5.917122082788757,4461.997467206105,-146151.80962889598,20.0,8.0,32.0,67.85009799999989,2370.7999673333334,2390.549885666667,2414.699869333333,2434.449787666667,2346.6499836666667,2326.9000653333333,2302.7500816666666,0.3496557463841292,-11609901.0,-1
2014-06-24,2390.0,2422.0,2389.199951,2380.300049,2308.720947,217974.0,2415.4400146999997,2399.9236372545456,-54.84985300000017,49.405917319156494,-4.826864872757616,87.31383712161414,9.646659320374148,203980.40617753184,-130236.62790306799,16.0,4.0,28.000000000000004,78.0,2397.1666666666665,2405.133382333333,2429.966715666666,2437.933431333333,2372.333333333333,2364.3666176666666,2339.533284333333,-0.271338070257155,-11391927.0,+1
2014-06-25,2414.949951,2528.0,2391.100098,2414.600098,2362.6479489999997,430866.0,2410.4700196000003,2399.7709251272727,-49.699951000000056,57.0050447806398,-4.6685838616714745,81.81145785973695,42.85182735799976,68180.32121637477,-121217.63185084207,12.0,0.0,24.0,73.0,2444.566732,2498.0333659999997,2581.4666339999994,2634.9332679999998,2361.1334639999995,2307.6668299999997,2224.2335619999994,0.17165826751285754,-10961061.0,+1
2014-06-26,2485.0,2503.949951,2437.5,2471.0,2377.850586,539042.0,2412.7150147,2410.776376109091,22.449951000000056,66.54004779776258,-2.3466447097571015,70.26770268984819,62.39306506874133,-1642501.1198734979,-190367.2020039048,96.0,0.0,12.0,43.89990200000011,2470.8166503333337,2504.1333006666673,2537.2666013333337,2570.5832516666674,2437.6833496666673,2404.3666993333336,2371.233398666667,0.5041388217125995,-10422019.0,+1
2014-06-27,2480.050049,2480.050049,2440.0,2486.899902,2347.0622559999997,151990.0,2413.3199951,2424.2645374363638,6.049804000000222,68.79139122034475,-1.6920583779333014,52.95860345643632,57.19143423283006,-526249.6144320009,-205634.6519749373,92.0,20.0,12.0,55.60009799999989,2468.9833169999997,2497.9666339999994,2509.0333659999997,2538.0166829999994,2457.9165849999995,2428.9332679999998,2417.8665359999995,1.1710323250790573,-10270029.0,+1
2014-06-30,2454.949951,2469.5,2428.199951,2454.699951,2332.3857420000004,240672.0,2418.4549804,2431.7881657818184,51.34985300000017,59.44506551098186,-3.0177047756278284,42.2590472971724,36.00749074361684,58089.98132514987,-193647.11798731826,88.0,16.0,12.0,147.69995100000006,2450.799967333334,2473.3999836666676,2492.100016333334,2514.7000326666675,2432.0999346666677,2409.499918333334,2390.7998856666677,0.6416457278295248,-10510701.0,-1
2014-07-01,2453.800049,2605.399902,2446.600098,2439.350098,2470.501465,1505073.0,2424.275,2435.5872780727273,58.20019599999978,55.31155006212135,-6.625032336918764,33.61918829504884,84.45588191255595,-102763.38120039635,-189516.02237915253,84.0,12.0,96.0,89.34985300000017,2497.116699333333,2547.6333006666664,2655.916503333333,2706.4331046666666,2388.833496666666,2338.316895333333,2230.033692666666,-0.0456549681887516,-12015774.0,-1
2014-07-02,2593.800049,2665.0,2568.25,2583.800049,2526.1015629999997,775548.0,2441.2100098,2464.591832436364,169.3500979999999,74.536946968339,-3.164456391270462,36.229677987963896,214.40769781403543,39016.461094087215,-179128.14222501102,96.0,8.0,72.0,40.050048999999944,2605.6833496666663,2643.1166993333327,2702.433349666666,2739.8666993333327,2546.3666993333327,2508.9333496666663,2449.6166993333327,0.16072402067183406,-11240226.0,+1
2014-07-03,2650.0,2662.0,2615.0,2641.949951,2514.580078,395691.0,2461.9050049,2501.0900035636364,206.94995100000006,78.77777313895294,-0.8982871784879168,41.671826775245336,226.9610367378946,150849.35588715278,-164129.10991261463,96.0,4.0,72.0,58.699951000000056,2639.6499836666667,2664.2999673333334,2686.6499836666662,2711.2999673333334,2617.2999673333334,2592.6499836666667,2570.2999673333334,0.5734032127659586,-10844535.0,+1
2014-07-04,2627.0,2654.300049,2616.649902,2629.899902,2526.627441,346996.0,2486.8899902000003,2531.6345303090907,249.84985300000017,75.76079440336848,-1.367891582229146,43.64509217559316,188.09523617833221,283527.5424474347,-143781.008874445,92.0,0.0,72.0,158.79980400000022,2633.616617666667,2650.583333333334,2671.266764666667,2688.233480333334,2612.933186333334,2595.966470666667,2575.2830393333343,0.3519242567631956,-11191531.0,-1
2014-07-07,2649.0,2660.0,2618.600098,2642.5,2523.137695,252391.0,2514.5000000000005,2559.927259363636,276.1000979999999,76.83133366818802,-0.8768511301636788,43.50843671908888,158.86785602366544,-217313.50022288543,-147123.40603767196,88.0,0.0,88.0,225.6499020000001,2640.366699333333,2662.1333006666664,2681.7666013333337,2703.5332026666665,2620.7333986666663,2598.966797333333,2579.333496666666,0.5772936853811887,-10939140.0,+1
2014-07-08,2660.0,2661.149902,2578.0,2638.850098,2476.095215,325370.0,2540.3550049,2582.536368090909,258.55004899999994,75.7136634815279,-1.0190920498830909,49.62367308746752,120.81917647050862,93516.1472351796,-136185.20956098038,84.0,0.0,92.0,78.19995100000006,2626.0,2674.0,2709.149902,2757.149902,2590.850098,2542.850098,2507.700196,0.7318120230616725,-11264510.0,-1
2014-07-09,2607.0,2607.0,2492.199951,2589.649902,2406.10498,406355.0,2557.8599853,2591.4990766545457,175.04980400000022,61.743537082079634,-2.936480826188616,61.09211754216176,59.20496634131944,5715.725975418301,-129735.14735594577,80.0,0.0,92.0,37.65014699999983,2562.949951,2633.699951,2677.7500000000005,2748.5,2518.899902,2448.149902,2404.099853,0.84886680666835,-11670865.0,-1
2014-07-10,2517.0,2630.0,2490.0,2516.449951,2420.686035,349298.0,2562.4049804,2583.969979509091,45.449951000000056,46.89082368261286,-5.789167926734215,71.12517928461284,40.78872905823998,-149895.43171961396,-130651.52658692376,76.0,48.0,88.0,41.39990200000011,2545.483317,2600.9666340000003,2685.483317,2740.9666340000003,2460.9666340000003,2405.483317,2320.9666340000003,0.18892822142857182,-12020163.0,-1
2014-07-11,2525.0,2560.949951,2472.0,2531.699951,2394.821777,273178.0,2566.8849853,2578.3872468909094,44.800048999999944,49.79402189769154,-5.194857716289944,80.26814841900296,19.69265879483348,-154061.79142042497,-131715.63249227917,72.0,44.0,84.0,83.14990200000011,2521.549967333334,2571.0999346666677,2610.499918333334,2660.0498856666677,2482.1499836666676,2432.6000163333338,2393.2000326666675,0.6711633938955179,-11746985.0,+1
2014-07-14,2482.0,2525.550049,2482.0,2504.649902,2399.603027,142260.0,2571.8799804000005,2567.0717772000003,49.949951000000056,44.783621303627065,-6.249029540140292,82.44865053670037,3.089798085468086,152345.18804022946,-118803.74274817276,68.0,40.0,80.0,146.65014699999983,2504.066650333333,2526.1333006666664,2547.6166993333336,2569.6833496666663,2482.5832516666665,2460.5166013333333,2439.0332026666665,0.5200890129882549,-11889245.0,-1
2014-07-15,2526.0,2549.350098,2507.0,2509.649902,2408.016846,171337.0,2578.9099608,2555.757217490909,70.29980400000022,45.94371036566155,-6.054173733437252,83.69411627065028,11.34234037754235,338195.39359438163,-98031.0021119953,64.0,36.0,28.0,140.0,2522.0,2537.0,2564.350098,2579.350098,2494.649902,2479.649902,2452.299804,0.06257133100377048,-11717908.0,+1
2014-07-16,2524.949951,2584.800049,2502.0,2518.449951,2459.362061,255637.0,2572.3749510000007,2544.7644884363635,-65.35009799999989,48.15572116063636,-5.7112256040529985,92.92443676681933,17.098741084262898,-238243.0,-104404.29015396285,60.0,32.0,28.0,88.94995100000006,2535.0833333333335,2568.166666666667,2617.8833823333334,2650.966715666667,2485.366617666667,2452.2832843333335,2402.566568666667,0.19867078822622516,-11462271.0,+1
2014-07-17,2575.0,2579.75,2527.25,2572.149902,2448.079834,214428.0,2565.3949461,2544.7235704363634,-69.80004899999994,59.75206984891188,-3.618476149649255,108.63912784246531,31.1678386504812,98332.06795630694,-95188.9798790606,56.00000000000001,28.000000000000004,28.0,49.699951000000056,2559.716634,2592.1832679999998,2612.2166340000003,2644.6832679999998,2539.6832679999998,2507.216634,2487.1832679999998,0.8552362285714307,-11247843.0,+1
2014-07-18,2550.0,2553.199951,2505.0,2560.350098,2413.897217,260815.0,2558.4399657000004,2543.8063253272726,-69.54980400000022,56.545314256812425,-4.0783282151208144,104.0011883612865,9.863529759031746,92194.91589149486,-86671.51130570893,52.0,24.0,28.0,44.70019599999978,2539.5166830000003,2574.0333660000006,2587.7166340000003,2622.2333170000006,2525.8334150000005,2491.3167320000002,2477.6334640000005,1.1483434495607645,-11508658.0,-1
2014-07-21,2524.600098,2573.0,2524.600098,2524.600098,2429.912842,238243.0,2546.6499755000004,2537.653622109091,-117.89990200000011,47.61259095992569,-5.4715472330475485,91.90148579134166,4.302328956876206,-176652.8034975397,-90761.57864329578,48.0,20.0,28.0,82.80004899999994,2540.7333986666667,2556.8666993333336,2589.1333006666673,2605.2666013333337,2508.4667973333335,2492.3334966666666,2460.0668953333334,0.0,-11746901.0,-1
2014-07-22,2545.800049,2561.0,2493.649902,2541.350098,2403.188477,236100.0,2536.8999755,2536.6900080181817,-97.5,51.73460787991571,-4.8187802805923665,75.96926334489399,-8.427100026502469,-210246.76797548032,-96192.73451572408,44.0,16.0,28.000000000000004,61.300048999999944,2532.0,2570.350098,2599.350098,2637.700196,2503.0,2464.649902,2435.649902,0.7082424141387271,-11510801.0,+1
2014-07-23,2525.149902,2529.449951,2479.0,2513.399902,2380.862305,253475.0,2529.2749755,2532.4172673818184,-76.25,44.9281747958363,-5.797896917674596,54.931606406308674,-37.176217324697674,5622.825649287438,-91564.74564005288,40.0,12.0,28.0,67.14990200000011,2507.2832843333335,2535.566568666667,2557.733235333333,2586.016519666667,2485.116617666667,2456.8333333333335,2434.666666666667,0.6818619506686948,-11764276.0,-1
2014-07-24,2500.0,2511.0,2485.0,2490.050049,2389.133057,288868.0,2526.6349853,2525.2854625636364,-26.39990200000011,39.871673926118945,-6.677979803853027,34.309599672373224,-59.74951574980311,-85976.93333333333,-91310.753706988,36.0,8.0,28.0,48.39990200000011,2495.3500163333333,2505.7000326666666,2521.3500163333338,2531.7000326666666,2479.7000326666666,2469.3500163333333,2453.7000326666666,0.1942326538461517,-12053144.0,-1
2014-07-25,2497.0,2537.0,2496.899902,2498.699951,2399.268311,230984.0,2523.3349853,2520.206365418182,-33.0,42.63148808502007,-6.340376528055307,20.56581573126732,-52.03123541252826,42663.210165463206,-85221.0174439696,32.0,4.0,28.0,67.35009799999989,2510.8666176666666,2524.833333333333,2550.9667156666665,2564.933431333333,2484.733235333333,2470.7665196666667,2444.6331373333333,0.044888892790235814,-11822160.0,+1
2014-07-28,2510.0,2525.0,2492.600098,2509.300049,2395.634766,182179.0,2523.7999999999997,2517.6545588181816,4.6501469999998335,46.127814107040706,-5.926657643312243,13.02990306954689,-72.82785364416694,-701987.35742858,-113255.89780258696,28.000000000000004,0.0,28.0,62.35009799999989,2508.966715666667,2525.333333333334,2541.3666176666675,2557.733235333334,2492.933431333334,2476.566813666667,2460.5335293333337,0.515432145442909,-11639981.0,+1
2014-07-30,2509.949951,2560.0,2485.0,2505.5,2440.526123,189655.0,2523.3850098000003,2514.3272860909087,-4.149902000000111,44.99354584302197,-4.919004346108258,2.0624136594306037,-75.2422418512511,-322142.2070064312,-122750.74514396705,24.0,0.0,28.0,28.39990200000011,2516.8333333333335,2548.666666666667,2591.833333333334,2623.666666666667,2473.666666666667,2441.8333333333335,2398.666666666667,0.2733333333333333,-11829636.0,-1
2014-07-31,2564.75,2590.0,2511.399902,2552.449951,2413.371338,958095.0,2526.7850098000004,2519.6118208545454,34.0,59.27099348526295,-3.0640082576056873,-3.491681016199891,3.7785601803677045,-108413.43187586681,-122099.04809670137,20.0,0.0,28.0,46.949951000000056,2551.283284333333,2591.166666666666,2629.8833823333325,2669.766764666666,2512.566568666666,2472.683186333333,2433.9664706666663,0.5222646032833191,-10871541.0,+1
2014-08-01,2510.0,2626.550049,2509.0,2524.050049,2472.60498,943610.0,2521.9750245000005,2519.1145552545454,-48.09985300000017,50.18025092020861,-4.05531039990892,-8.339449807780966,21.165593312615908,188331.13869280062,-107988.56460751838,16.0,8.0,28.000000000000004,32.39990200000011,2553.200032666666,2597.4000653333323,2670.750081666666,2714.9501143333323,2479.8500163333324,2435.6499836666662,2362.2999673333325,0.12803098874080393,-11815151.0,-1
2014-08-04,2590.0,2660.0,2571.399902,2586.0,2529.6870120000003,480503.0,2524.5400147,2530.755459890909,25.64990200000011,64.05598047489141,-2.889496290511519,-9.360610735413502,176.6376398206788,-171645.0,-110882.04294702585,12.0,4.0,24.0,75.0,2605.7999673333334,2640.2000326666666,2694.4000653333333,2728.8001306666665,2551.5999346666667,2517.1998693333335,2462.999836666667,0.1647864768727446,-11334648.0,+1
2014-08-05,2653.699951,2675.0,2628.600098,2645.699951,2548.9536129999997,412319.0,2536.65,2552.7845392181816,121.09985300000017,72.55544250014972,-1.137424262422358,-15.34255297369782,255.86830049474116,451006.27509802557,-85341.63112203385,8.0,0.0,20.0,84.5,2649.766683,2670.9332679999998,2696.166585,2717.33317,2624.5333659999997,2603.3667809999997,2578.1334639999995,0.3685320930203716,-10922329.0,+1
2014-08-06,2654.0,2670.0,2630.350098,2665.850098,2521.368896,238191.0,2549.1000000000004,2576.275466127272,124.5,74.86971434800424,-0.3551980590062155,-21.398826487608403,215.78412690670442,-379243.04540877516,-98700.80315877488,96.0,0.0,8.0,117.55004899999994,2655.4000653333333,2680.4500326666666,2695.0499673333334,2720.0999346666667,2640.8001306666665,2615.750163333333,2601.1502286666664,0.8953363869600459,-10684138.0,+1
2014-08-07,2629.5,2667.0,2629.5,2637.0,2533.224854,286075.0,2561.4600098,2592.2572843090907,123.60009799999989,65.7150955664685,-1.4751552795031055,-24.158419245823097,157.60062330984533,-18035.36940810727,-95034.18812136166,92.0,28.000000000000004,8.0,135.94995100000006,2644.5,2659.5,2682.0,2697.0,2622.0,2607.0,2584.5,0.2,-10970213.0,-1
2014-08-08,2629.0,2635.0,2593.5,2649.399902,2507.600586,266242.0,2577.3949951,2608.2463556181815,159.34985300000017,67.67524080938915,-0.9937926242235982,-19.642475186703905,109.50350693113994,61681.06339205297,-87910.75941538223,88.0,24.0,8.0,89.0,2625.966634,2658.4332679999998,2667.4666340000003,2699.9332679999998,2616.9332679999998,2584.466634,2575.4332679999998,1.3469855903614485,-10703971.0,+1
2014-08-11,2639.0,2672.0,2635.050049,2622.600098,2547.710693,226565.0,2589.7850098,2616.465465236364,123.90014699999983,59.23040374836639,-2.034157686335408,-7.67268396604959,115.35152684503983,-234307.6860689993,-94565.17246880218,84.0,20.0,96.0,39.64990200000011,2643.2167156666665,2651.383382333333,2680.1666666666665,2688.333333333333,2614.433431333333,2606.2667646666664,2577.483480333333,-0.33694093396768066,-10930536.0,-1
2014-08-12,2672.0,2684.949951,2647.199951,2664.550049,2547.423584,223239.0,2605.3100098,2630.059108727273,155.25,66.72893089176965,-0.7888745871555389,8.91526189062688,121.1625357162631,-204338.33712166874,-99554.86699362376,80.0,16.0,64.0,37.5,2665.5666503333337,2683.9333496666673,2703.3166503333337,2721.6833496666673,2646.1833496666673,2627.8166503333337,2608.4333496666673,0.4596052450331096,-10707297.0,+1
2014-08-13,2653.300049,2674.949951,2643.0,2664.25,2534.706787,186796.0,2621.1850098000004,2640.7754705818184,158.75,66.62779539005967,-0.8004776346114231,26.524206783441514,95.41288883366944,-551449.666480846,-120095.5602191038,96.0,12.0,64.0,43.5,2660.733317,2678.4666340000003,2692.6832680000007,2710.4165850000004,2646.5166830000003,2628.783366,2614.5667320000002,0.6651027414721219,-10894093.0,-1
2014-08-14,2645.0,2693.0,2645.0,2650.949951,2549.622803,311544.0,2631.035009800001,2646.187278072727,98.5,61.83455028870187,-1.6210504626060118,43.56244173155574,85.89853478430537,131870.90923275938,-108642.52795814993,92.0,8.0,64.0,36.949951000000056,2662.983317,2680.9666340000003,2710.983317,2728.9666340000003,2632.9666340000003,2614.983317,2584.9666340000003,0.12395731250000115,-11205637.0,-1
2014-08-18,2651.149902,2722.5,2651.149902,2666.550049,2585.000732,359547.0,2645.2850098,2652.6445579272727,142.5,65.22077721394805,-2.132645359252909,59.90068778947534,94.31829086502127,-209642.36801094422,-113233.43395786225,96.0,4.0,64.0,62.34985300000017,2680.0666503333337,2708.983398666667,2751.416748333334,2780.333496666667,2637.6333006666673,2608.7165523333338,2566.2832026666674,0.21583918497210555,-10846090.0,+1
2014-08-19,2715.0,2760.0,2712.199951,2703.550049,2628.744629,404906.0,2657.0400146999996,2663.238201418182,117.55004899999994,72.01567357104646,-2.1213810973318323,67.41832577003015,123.48818586357844,20799.228637541422,-107141.03490966494,96.0,0.0,84.0,31.949951000000056,2725.25,2738.300049,2773.050049,2786.100098,2690.5,2677.449951,2642.699951,-0.18096010738399287,-10441184.0,+1
2014-08-20,2749.0,2755.0,2724.949951,2749.300049,2617.7966309999997,212477.0,2667.4000244999997,2680.012753109091,103.60009799999989,78.11571305288143,-0.40210263059000584,82.17998707106835,120.25053377425708,-807085.6407353034,-138956.725199782,96.0,28.000000000000004,84.0,48.0,2743.0833333333335,2761.216715666667,2773.133382333334,2791.266764666667,2731.166666666667,2713.0332843333335,2701.116617666667,0.8103180796809993,-10228707.0,+1
2014-08-21,2743.949951,2771.0,2738.100098,2737.850098,2629.939697,206504.0,2674.6000244999996,2692.8218573818185,72.0,73.48972159540645,-1.240640044910184,87.79577916545804,105.80710589918337,373312.84061835724,-115671.7264998764,92.0,24.0,92.0,71.55004899999994,2748.9833986666667,2759.8666993333336,2781.8833006666673,2792.7666013333337,2726.9667973333335,2716.0834966666666,2694.0668953333334,-0.007598806829272596,-10435211.0,-1
2014-08-22,2756.0,2767.899902,2729.0,2750.550049,2634.05127,192631.0,2685.9550293999996,2706.630952745454,113.55004899999994,75.35738872458856,-0.7653424775449122,86.4569404255758,86.50503116344943,-118684.85023575927,-115808.686773196,96.0,20.0,96.0,93.44995100000006,2749.1499836666667,2769.2999673333334,2788.0498856666673,2808.1998693333335,2730.4000653333333,2710.2500816666666,2691.500163333333,0.553987231124641,-10242580.0,+1
2014-08-25,2781.0,2824.949951,2779.199951,2754.850098,2682.814697,390940.0,2696.500049,2719.1573288545455,105.45019599999978,76.01747301124391,-2.571575203509676,83.20782530605902,94.71640161567166,-284579.1870488583,-123480.07868343439,92.0,16.0,68.0,51.449951000000056,2786.3333333333335,2793.466715666667,2832.0833333333335,2839.216715666667,2747.716715666667,2740.5833333333335,2701.966715666667,-0.5322372240437195,-9851640.0,+1
2014-08-26,2785.0,2799.899902,2755.0,2805.850098,2650.831299,295099.0,2714.8250490000005,2739.0391559454542,183.25,82.45057284739336,-0.7006677797952046,88.92200099343518,81.24288398561266,-710503.1739130435,-150162.96502226163,96.0,12.0,68.0,32.89990200000011,2786.9166666666665,2818.833333333333,2831.816568666667,2863.733235333333,2773.933431333333,2742.0167646666664,2729.033529333333,1.1325213582871465,-9556541.0,+1
2014-08-27,2785.0,2798.649902,2760.75,2772.399902,2659.330322,308090.0,2725.6100343000003,2749.5073110363637,107.84985300000017,68.53731500536915,-1.9277701331501793,92.12059312204838,65.64715852780697,-357628.20213671663,-159593.20927142142,92.0,8.0,76.0,38.89990200000011,2777.2666013333333,2793.7832026666665,2815.166503333334,2831.6831046666666,2755.8833006666664,2739.366699333333,2717.9833986666663,0.3073860718690005,-9864631.0,-1
2014-08-28,2775.0,2803.699951,2761.699951,2769.25,2673.974609,444326.0,2736.1100343000007,2757.4418502545454,105.0,67.30330737563777,-2.043322584832008,97.46591466810514,58.26644779649778,-83836.48351320105,-156149.71957643205,88.0,4.0,76.0,74.39990200000011,2778.2166340000003,2794.7333170000006,2820.216634000001,2836.7333170000006,2752.7333170000006,2736.2166340000003,2710.7333170000006,0.17976307142857012,-10308957.0,-1
2014-09-01,2804.0,2930.0,2792.0,2784.5,2797.182129,640846.0,2749.4650392000003,2766.240025836363,133.55004899999994,70.29139748290974,-5.139526669021547,99.23167251818404,85.15535915549273,65636.10548665462,-146068.53967227094,84.0,0.0,84.0,45.04980400000022,2835.5,2879.0,2973.5,3017.0,2741.0,2697.5,2603.0,-0.05434782608695652,-9668111.0,+1
2014-09-02,2929.0,2966.0,2907.800049,2912.800049,2799.342773,431825.0,2774.0900392000003,2795.9373003454543,246.25,84.25738458058242,-1.8555964771538214,103.21063098645936,126.2005393827938,210168.73028861315,-129875.92723522318,96.0,0.0,84.0,45.10009799999989,2928.866699333333,2949.9333496666663,2987.0666503333337,3008.1333006666664,2891.7333986666663,2870.666748333333,2833.5334476666662,0.08591072525129781,-9236286.0,+1
2014-09-03,2940.0,2942.0,2897.0,2915.050049,2793.1010739999997,423897.0,2795.2400392,2821.5663930363635,211.5,84.40572456078681,-1.7771172305545886,108.78112055115525,102.02387455936807,-108832.36792710656,-128919.40129015513,96.0,8.0,84.0,42.0,2918.016683,2939.0333659999997,2963.016683,2984.0333659999997,2894.0333659999997,2873.016683,2849.0333659999997,0.40111219999999875,-8812389.0,+1
2014-09-04,2910.0,2923.550049,2883.100098,2908.550049,2782.729736,254066.0,2811.1650392,2842.1682130000004,159.25,81.83532357063642,-2.003835054063483,113.85918148495557,83.50709302414164,-24809.94177296403,-124187.15066529565,92.0,4.0,84.0,160.75,2905.066732,2927.0333659999997,2945.516683,2967.4833169999997,2886.5834149999996,2864.6167809999997,2846.1334639999995,0.6291713678466513,-9066455.0,-1
2014-09-05,2872.0,2901.949951,2859.899902,2897.75,2766.404053,262632.0,2827.1550294000003,2857.9109331454547,159.8999020000001,77.32105862106243,-2.3805371468433902,115.33971518660746,65.02075228684143,79712.40561933792,-114918.98440773008,88.0,0.0,96.0,181.5,2886.533284333333,2913.166666666666,2928.583333333333,2955.216715666666,2871.116617666666,2844.483235333333,2829.066568666666,0.9001201877315277,-9329087.0,-1
2014-09-08,2875.0,2924.399902,2856.0,2880.75,2799.918701,393871.0,2840.1750245,2867.6554732545455,130.19995100000006,70.27983589544513,-2.973491454482037,110.5417731955863,57.6866825680929,80325.17094630432,-106044.24586138442,84.0,4.0,88.0,45.0,2887.049967333334,2918.0999346666677,2955.4498693333335,2986.4998366666678,2849.7000326666675,2818.6500653333337,2781.3001306666674,0.3618426236926474,-9722958.0,-1
2014-09-09,2930.0,2932.0,2903.0,2915.649902,2794.493408,194446.0,2856.2550049,2881.3781782545457,160.79980400000022,75.55327734972506,-1.7561945587722319,111.6346735196048,64.36494296709225,-514664.5117797949,-124617.902726835,80.0,0.0,88.0,40.449951000000056,2916.883300666667,2930.7666013333337,2945.8833006666664,2959.7666013333337,2901.7666013333337,2887.883300666667,2872.7666013333337,0.4362035172413831,-9528512.0,+1
2014-09-10,2891.050049,2919.949951,2885.0,2910.0,2791.564209,185112.0,2866.6699951,2891.149995545454,104.14990200000011,73.12945991046436,-1.9532612486920127,109.83023088234177,52.12320638817638,253922.4787114149,-107411.5143115096,76.0,0.0,88.0,48.65014699999983,2904.983317,2924.9666340000003,2939.9332680000007,2959.9165850000004,2890.0166830000003,2870.033366,2855.0667320000002,0.7153085851250538,-9713624.0,-1
2014-09-11,2905.0,2924.0,2876.25,2906.949951,2801.311523,280993.0,2880.1250000000005,2898.473623890909,134.55004899999994,71.69674478974798,-2.0596459365190074,111.94812724480562,45.81542141773077,101719.3701640529,-97905.56109319594,72.0,12.0,80.0,68.39990200000011,2902.3999836666667,2928.5499673333334,2950.1499836666662,2976.2999673333334,2880.7999673333334,2854.6499836666667,2833.0499673333334,0.6429309109947655,-9994617.0,-1
2014-09-12,2921.0,2979.0,2921.0,2917.100098,2853.840332,453657.0,2894.9100098000004,2905.196368981818,147.8500979999999,73.67697930470347,-2.1493021527777816,111.68767665529322,58.15038829527157,-2510.9608658628317,-93569.44119249366,68.0,8.0,80.0,51.25,2939.0333659999997,2957.0667319999993,2997.0333659999997,3015.0667319999993,2899.0667319999993,2881.0333659999997,2841.0667319999993,-0.06723968965517432,-9540960.0,+1
2014-09-15,2970.899902,2974.399902,2930.0,2971.800049,2845.005371,287604.0,2913.6400147,2919.1763761090906,187.30004899999994,81.65711650554843,-0.24999829861111303,119.41512153210806,60.725920876481226,-316610.7944745596,-103707.68833666603,96.0,4.0,76.0,34.949951000000056,2958.733317,2987.4666340000003,3003.1332190000003,3031.8665360000005,2943.0667320000002,2914.333415,2898.66683,0.9414446230083985,-9253356.0,+1
2014-09-16,2955.0,2980.300049,2931.0,2962.600098,2833.2416989999997,360771.0,2918.6200196,2928.078209436364,49.800048999999944,77.11991903213804,-0.6143043313431762,126.82400246247926,53.970400267866324,-167049.1616133745,-106586.84724655854,92.0,0.0,60.0,47.75,2957.966715666667,2984.933431333334,3007.266764666667,3034.233480333334,2935.633382333334,2908.666666666667,2886.333333333334,0.6409749815867307,-9614127.0,-1
2014-09-17,2950.0,2985.0,2916.25,2950.350098,2849.422852,313982.0,2922.1500244999997,2933.8473146,35.300048999999944,71.05420531140172,-1.2006203049203088,133.882532399909,45.01763780014468,201585.51550859885,-92579.00777535704,96.0,0.0,60.0,72.05004899999994,2950.5333659999997,2984.8167319999993,3019.2833659999997,3053.5667319999993,2916.0667319999993,2881.7833659999997,2847.3167319999993,0.49600142545454384,-9928109.0,-1
2014-09-18,2978.0,3060.0,2960.0,2967.199951,2921.92627,369872.0,2928.0150147000004,2942.0382103272727,58.64990200000011,74.26654443677309,-3.1340779804120213,122.60331020616195,62.40751757502264,-192793.96746564275,-97134.23470595086,96.0,4.0,92.0,57.29980400000022,2995.733317,3031.4666340000003,3095.733317,3131.4666340000003,2931.4666340000003,2895.733317,2831.4666340000003,0.07199951000000056,-9558237.0,+1
2014-09-19,3045.199951,3094.0,3030.0,3042.699951,2960.050049,276972.0,2942.5100098,2962.890016927273,144.94995100000006,83.64848461286675,-1.7128563939899815,115.29780105513692,84.30343743211331,9314.432425152145,-92295.65741639344,96.0,0.0,92.0,49.300048999999944,3055.5666503333337,3081.1333006666673,3119.566650333334,3145.1333006666673,3017.1333006666673,2991.5666503333337,2953.1333006666673,0.19843673437500087,-9281265.0,+1
2014-09-22,3074.300049,3085.0,3041.5,3082.399902,2944.49292,228956.0,2962.675,2988.3245427818188,201.6499020000001,86.61029072046107,-0.3873154590984938,109.9857156879225,82.04269726646115,3350.915647894117,-87948.08461762598,96.0,0.0,96.0,68.75,3069.633300666667,3097.7666013333337,3113.1333006666664,3141.2666013333337,3054.2666013333337,3026.133300666667,3010.7666013333337,0.9402276321839106,-9052309.0,+1
2014-09-23,3079.0,3112.0,3054.100098,3066.199951,2940.268066,331237.0,2977.7300049000005,3007.1472611454546,150.55004899999994,79.80422500098217,-1.5200812811151658,105.28843799142123,80.75663735146668,152122.36548129632,-77035.78832661551,92.0,0.0,92.0,109.64990200000011,3077.4333496666663,3100.766601333333,3135.333251666666,3158.666503333333,3042.8666993333327,3019.5334476666662,2984.9667973333326,0.20897881657900116,-9383546.0,-1
2014-09-24,3075.0,3090.0,3031.0,3061.800049,2949.871094,211358.0,2992.9100098000004,3022.432723709091,151.80004899999994,77.88615645310321,-1.6661118818453386,104.34185650074642,66.16640290581097,230345.88805937493,-63063.890150930856,96.0,0.0,96.0,126.80004899999994,3060.9333496666663,3090.8666993333327,3119.933349666666,3149.8666993333327,3031.8666993333327,3001.9333496666663,2972.8666993333327,0.5220347288135584,-9594904.0,-1
2014-09-25,3075.0,3100.0,3043.0,3071.800049,2935.8984379999997,318285.0,3009.3950195999996,3036.7763672,164.8500979999999,79.19733580474538,-1.3342167607036195,101.76542925903095,65.26318506535185,-345031.678926825,-75880.61114512419,92.0,0.0,96.0,43.5,3071.6000163333333,3100.2000326666666,3128.6000163333338,3157.2000326666666,3043.2000326666666,3014.6000163333333,2986.2000326666666,0.5052640175438586,-9276619.0,+1
2014-09-26,3040.300049,3087.0,2961.899902,3057.25,2917.412598,290099.0,3023.4100097999994,3045.477272727273,140.1499020000001,72.02750957340739,-1.8171257882509129,103.05398561781794,39.08239758008588,351712.8395565695,-56444.54039462382,88.0,4.0,92.0,57.89990200000011,3035.383300666667,3108.8666993333336,3160.4833986666663,3233.9667973333335,2983.7666013333337,2910.283202666667,2858.666503333334,0.7621904340954231,-9566718.0,-1
2014-09-29,3036.0,3037.0,3001.850098,3038.0,2888.747559,217945.0,3030.0300048999998,3048.1299982181818,66.19995100000006,63.281870499662325,-2.456023896448722,104.3284039075852,29.454528295562177,68414.85431393389,-50769.112021851244,84.0,0.0,96.0,59.0,3025.616699333333,3049.3833006666664,3060.7666013333337,3084.5332026666665,3014.2333986666663,2990.466797333333,2979.083496666666,1.0284495814526025,-9784663.0,-1
2014-09-30,3018.0,3078.0,3013.800049,3008.149902,2941.2763670000004,293390.0,3034.5849853000004,3044.1517976909095,45.54980400000022,51.98764979000335,-3.446734085628938,104.98853945688825,32.348441801280835,-95271.58627867221,-52791.95221688449,80.0,4.0,92.0,57.0,3033.3166503333327,3052.8332516666655,3097.5166013333323,3117.0332026666656,2988.6333006666655,2969.1166993333327,2924.4333496666654,-0.08800858742088181,-10078053.0,-1
2014-10-01,3048.0,3081.899902,2961.149902,3062.850098,2853.0239260000003,513843.0,3045.8349853000004,3049.2909090909093,112.5,65.14202322841948,-1.6312612678393665,100.1934701763621,31.0991208863605,-403172.10556665837,-68718.3262513663,76.0,0.0,84.0,125.10009799999989,3035.299967333334,3109.4500326666675,3156.0499673333334,3230.2000326666675,2988.7000326666675,2914.549967333334,2867.9500326666675,0.8422376480331245,-9564210.0,+1
2014-10-07,2971.0,2994.0,2934.0,2970.949951,2822.005859,295318.0,3046.2099853,3035.6754483090904,3.75,42.545349070249735,-4.681382309990041,97.82030223072707,-12.47433456930996,355462.16818154766,-49437.390725211386,72.0,0.0,84.0,55.39990200000011,2966.3166503333337,2998.6333006666673,3026.316650333334,3058.6333006666673,2938.6333006666673,2906.3166503333337,2878.6333006666673,0.6158325166666676,-9859528.0,-1
2014-10-08,2939.0,2968.0,2924.050049,2938.649902,2833.961914,283872.0,3035.8049804000007,3016.1190695272726,-104.05004899999994,37.29838394967836,-5.753405177563886,94.48809282682669,-30.167055086582696,79012.02885860666,-43598.77959918179,68.0,0.0,76.0,64.19995100000006,2943.5666503333327,2963.0832516666655,2987.5166013333323,3007.0332026666656,2919.1333006666655,2899.6166993333327,2875.1833496666654,0.3321927025584203,-10143400.0,-1
2014-10-09,2961.0,3013.550049,2961.0,2951.100098,2886.875,292837.0,3022.675,3000.7181818181816,-131.29980400000022,40.55873983326748,-5.3401892465980785,89.09798810872417,-12.919686433277294,-20308.406265779413,-42540.12606768063,64.0,0.0,76.0,120.75,2975.216715666667,2989.433431333334,3027.766764666667,3041.983480333334,2936.883382333334,2922.666666666667,2884.333333333334,-0.1883899670578827,-9850563.0,+1
2014-10-10,2990.100098,2995.0,2942.0,3006.199951,2848.462646,249861.0,3016.675,2997.7227183636364,-60.0,53.03042326682026,-3.5114520079654814,75.36048521197426,-11.857591543655303,0.0,-40606.4836281974,60.0,16.0,72.0,128.8500979999999,2981.0666503333337,3020.1333006666673,3034.066650333334,3073.1333006666673,2967.1333006666673,2928.0666503333337,2914.1333006666673,1.2113198301886803,-9600702.0,+1
2014-10-13,2941.0,2980.0,2925.050049,2966.199951,2854.8486329999996,158747.0,3007.1149901999997,2988.5454367272723,-95.60009799999989,45.103498160177146,-4.839032492532358,62.33017518961287,-33.533935728101135,79913.78348758769,-35128.28873405287,56.00000000000001,12.0,68.0,46.89990200000011,2957.0833333333335,2989.116617666667,3012.033284333334,3044.066568666667,2934.166666666667,2902.1333823333334,2879.216715666667,0.748861486700872,-9759449.0,-1
2014-10-14,2980.100098,2992.699951,2957.100098,2972.850098,2844.525391,176342.0,2997.2199951,2982.3154563272724,-98.94995100000006,46.63375890032511,-4.618317358114839,50.87105966428999,-24.458811172074125,53205.43725266344,-31113.118717338784,52.0,8.0,64.0,74.90014699999983,2974.216715666667,2991.333333333334,3009.816568666667,3026.933186333334,2955.733480333334,2938.6168626666667,2920.1336273333336,0.44241755717361886,-9583107.0,+1
2014-10-15,2962.100098,2962.100098,2962.100098,2962.100098,2844.525391,0.0,2987.7050048999995,2975.930020490909,-95.14990200000011,44.32895800520433,-4.975104613342188,38.44742029728741,-40.62918789725941,-592051.0443310026,-56610.301116657465,48.0,4.0,44.0,53.0,2962.1000980000003,2962.100098000001,2962.100098,2962.100098000001,2962.100098000001,2962.1000980000003,2962.100098000001,,-9583107.0,-1
2014-10-16,2956.100098,2980.0,2912.0,2962.100098,2820.278076,168761.0,2980.1150147000003,2971.274582872727,-75.89990200000011,44.328958005204335,-4.975104613342188,22.926820185500674,-57.748411225634825,-257099.0917896184,-65723.42931726122,44.0,0.0,44.00000000000001,81.14990200000011,2951.366699333333,2990.7333986666663,3019.3666993333336,3058.7333986666663,2922.7333986666663,2883.366699333333,2854.7333986666663,0.7367661470588219,-9583107.0,-1
2014-10-17,2940.0,2960.699951,2902.0,2936.850098,2824.3588870000003,283917.0,2972.9850343000003,2963.408234381818,-71.29980400000022,38.394858860640404,-5.436517894035325,6.534461259268028,-86.87916712601172,-473566.17365362006,-84261.73850296205,40.0,8.0,44.0,35.59985300000017,2933.1833496666673,2964.3666993333345,2991.8833006666673,3023.0666503333346,2905.6667483333345,2874.483398666667,2846.9667973333344,0.5936989283006362,-9867024.0,-1
2014-10-20,2978.0,3014.800049,2978.0,2941.100098,2884.473877,196994.0,2960.8100343000006,2957.610973236364,-121.75,39.9558955176491,-5.294898433855385,-6.063432600438318,-35.31852534284723,111637.96809846174,-75357.20518117728,36.0,4.0,44.0,10.75,2977.966715666667,2977.933431333334,3014.766764666667,3014.733480333334,2941.133382333334,2941.166666666667,2904.333333333334,-1.0027133931261931,-9670030.0,+1
2014-10-21,3015.0,3084.75,3010.0,3003.699951,2953.616211,220013.0,2964.0850343,2965.4091399090908,32.75,58.0303088009921,-2.7878195783132513,-14.142179908441449,42.020024206437185,220379.0,-61914.64866590275,32.0,0.0,44.0,68.0,3032.8166503333337,3055.6333006666673,3107.566650333334,3130.3833006666673,2980.8833006666673,2958.0666503333337,2906.1333006666673,-0.0842815919732434,-9450017.0,+1
2014-10-22,3092.0,3189.0,3085.399902,3075.699951,3051.087402,398874.0,2977.7900392000006,2985.7027611272724,137.05004899999994,70.0106261926471,-3.6666682524271828,-28.87890040190723,182.5831243013665,-191422.24467089836,-67801.35830018162,28.000000000000004,88.0,32.0,60.10009799999989,3116.699951,3148.0,3220.3000490000004,3251.600098,3044.399902,3013.099853,2940.799804,-0.09362878208860445,-9051143.0,+1
2014-10-27,3171.0,3190.0,3105.5,3177.199951,3043.88501,160160.0,3000.4000245000007,3021.9591087272725,226.09985300000017,79.51988090458559,-0.4141070527337414,-28.193717664816177,222.43053094190645,-589379.113816279,-91509.44088335523,96.0,84.0,32.0,77.94995100000006,3157.5666503333337,3209.6333006666673,3242.066650333334,3294.1333006666673,3125.1333006666673,3073.0666503333337,3040.6333006666673,0.8485201301775155,-8890983.0,+1
2014-10-28,3169.699951,3169.699951,3130.050049,3169.699951,3026.263428,220379.0,3016.7500245,3052.7409135454545,163.5,77.42667092190365,-0.6567469750889662,-19.0590978354212,187.27462895916577,-1006763.9349397591,-133111.92255417243,96.0,80.0,32.0,143.6499020000001,3156.483317,3182.9165850000004,3196.1332190000007,3222.5664870000005,3143.2666830000003,3116.833415,3103.616781,1.0,-9111362.0,-1
2014-10-29,3166.0,3219.0,3145.399902,3151.350098,3078.167725,228343.0,3035.2650392000005,3077.213654181818,185.15014699999983,72.07096587151462,-2.1682660897435935,-11.574195223741299,178.15240239573384,502757.48275862064,-104208.76467139737,92.0,76.0,-60.0,185.30004899999994,3171.9166666666665,3198.433431333333,3245.516764666666,3272.033529333333,3124.833333333333,3098.3165686666666,3051.233235333333,0.08084494670101916,-9339705.0,-1
2014-10-30,3221.850098,3299.0,3171.0,3205.399902,3111.634766,1274329.0,3058.5200196000005,3108.1472655999996,232.54980400000022,77.38705875114267,-2.9250030624999965,-10.308258589688648,199.67321091328137,-190676.67567042497,-108139.12466410926,96.0,72.0,12.0,114.30004899999994,3225.133300666667,3279.2666013333337,3353.1333006666664,3407.2666013333337,3151.2666013333337,3097.133300666667,3023.2666013333337,0.26874923437500087,-8065376.0,+1
2014-10-31,3265.0,3350.0,3246.25,3240.25,3204.784668,902391.0,3086.3350098000005,3141.1890802181815,278.1499020000001,80.19206386550692,-3.375884343278991,-0.762077935537036,208.24724081889713,43761.104888754075,-101234.5681014965,96.0,68.0,16.0,47.14990200000011,3278.8333333333335,3311.416666666667,3382.583333333334,3415.166666666667,3207.666666666667,3175.0833333333335,3103.916666666667,-0.05783132530120482,-7162985.0,+1
2014-11-03,3330.0,3334.0,3276.0,3337.25,3156.38501,452092.0,3123.8500000000004,3186.809987527273,375.1499020000001,85.83503423265321,-0.3921870193786527,16.47769638222826,189.1404864433254,-28034.596441901143,-97907.29635246094,96.0,64.0,16.0,73.60009799999989,3315.75,3355.5,3373.75,3413.5,3297.5,3257.75,3239.5,1.0560344827586208,-6710893.0,+1
2014-11-05,3295.0,3327.850098,3280.0,3286.850098,3158.401611,267172.0,3158.85,3216.446368981818,350.0,73.31347992496046,-1.9424762227007109,38.44765657815287,140.0066812368674,-50962.32047291591,-95773.43362273034,92.0,60.0,24.0,147.6499020000001,3298.2333986666667,3316.4667973333335,3346.083496666666,3364.3168953333334,3268.6166993333336,3250.383300666667,3220.7666013333337,0.14315744975067565,-6978065.0,-1
2014-11-07,3286.0,3318.699951,3249.149902,3288.949951,3157.825684,302843.0,3193.6349853,3240.100905527273,347.84985300000017,73.49932782333627,-1.87788523531221,61.70164182528606,111.0026921156352,-99242.92546327434,-95931.13781068675,88.0,56.00000000000001,28.0,144.6000979999999,3285.5999346666667,3322.0499673333334,3355.149983666667,3391.6000163333333,3252.4999183333334,3216.049885666667,3182.9498693333335,0.5722504810888052,-6675222.0,+1
2014-11-10,3285.0,3315.0,3268.050049,3288.350098,3176.503418,207284.0,3222.1,3257.3218351090914,284.65014699999983,73.33099951366374,-1.8963365733620459,90.72021300409415,95.0966311981874,5716.229896470018,-91310.80254055075,84.0,52.0,32.0,93.75,3290.466715666667,3312.883382333334,3337.4166666666674,3359.833333333334,3265.933431333334,3243.516764666667,3218.983480333334,0.43237636179854416,-6882506.0,-1
2014-11-11,3298.0,3334.899902,3291.149902,3307.800049,3196.862061,213365.0,3245.3100098000004,3272.9036622,232.1000979999999,75.4357422697753,-1.2980606274992328,123.27478270496476,89.22416872129868,-35145.25120060394,-88757.82273674029,80.0,48.0,32.0,57.25,3311.283284333333,3331.416666666666,3355.0332843333335,3375.166666666666,3287.666666666666,3267.533284333333,3243.916666666666,0.38057478857142474,-6669141.0,+1
2014-11-12,3329.0,3371.3000490000004,3310.0,3329.0,3226.391357,261098.0,3260.4900147000003,3288.120024054546,151.80004899999994,77.65374133171815,-1.2926702431498327,149.83489413921916,86.60765702842225,-78691.87542713151,-88300.2796434344,76.0,44.0,31.999999999999993,69.55004899999994,3336.7666830000003,3363.5333660000006,3398.066732000001,3424.833415000001,3302.233317,3275.466634,3240.9332679999998,0.30995081260049034,-6408043.0,+1
2014-11-13,3370.0,3396.0,3321.699951,3359.75,3196.429932,235947.0,3279.4950196,3306.1672941090915,190.05004899999994,80.58734135493458,-1.099484379739157,168.5187417676225,83.06599750340425,-100256.3221507995,-88843.73615933902,96.0,40.0,32.0,46.949951000000056,3359.1499836666667,3396.6000163333333,3433.450032666666,3470.9000653333333,3322.2999673333334,3284.8499346666667,3247.9999183333334,0.5121133769373419,-6172096.0,+1
2014-11-14,3329.100098,3344.0,3320.300049,3328.550049,3197.3901370000003,115687.0,3297.2150146999998,3315.0863903636364,177.19995100000006,69.85166222753878,-2.0457977252047335,172.19701660570672,59.409181534678574,31740.210958692533,-83362.64728528105,96.0,36.0,32.0,46.54980400000022,3330.950032666666,3341.6000163333324,3354.649983666666,3365.2999673333325,3317.9000653333323,3307.250081666666,3294.2001143333323,0.34810198552731103,-6287783.0,-1
2014-11-17,3321.949951,3370.0,3313.100098,3329.550049,3208.5776370000003,186565.0,3309.6300294,3320.965487509091,124.15014699999983,69.99946605261883,-2.015467121625722,181.31387398922834,52.288006960962996,31114.36031886937,-78159.14660552732,92.0,32.0,32.0,63.500000000000455,3337.550049,3362.0,3394.4499509999996,3418.899902,3305.100098,3280.650147,3248.200196,0.289103327453886,-6101218.0,+1
2014-11-18,3341.0,3376.75,3324.550049,3341.199951,3231.049316,276896.0,3319.7250245,3326.7054732545453,100.94995100000006,71.854297990418,-1.6621185623293886,188.79860586232235,48.24097324823348,6484.498872394506,-74311.70793890234,88.0,28.000000000000004,56.0,74.30004899999994,3347.5,3370.449951,3399.699951,3422.649902,3318.25,3295.300049,3266.050049,0.3189639392573394,-5824322.0,+1
2014-11-19,3378.0,3395.0,3323.600098,3364.600098,3210.69043,213795.0,3322.4600343,3334.8645775272726,27.35009799999989,75.38186271144869,-0.952377979981805,188.53051488699066,45.92853397159634,69951.37954518256,-67754.29448780707,84.0,24.0,60.0,39.449951000000056,3361.066732,3398.5333659999997,3432.4666339999994,3469.9332679999998,3327.1334639999995,3289.6668299999997,3255.7335619999994,0.5742304800362322,-5610527.0,+1
2014-11-20,3343.0,3364.8000490000004,3312.0,3343.399902,3203.104248,164288.0,3328.1150147000003,3338.6718262000004,56.54980400000022,66.64954921371228,-1.5953927206551377,184.3643771285665,31.412013101186208,118189.1417235544,-59302.31964256274,80.0,20.0,60.0,56.89990200000011,3340.0666503333337,3368.1333006666673,3392.8666993333336,3420.9333496666677,3315.333251666667,3287.2666013333333,3262.5332026666665,0.5946945617417869,-5774815.0,-1
2014-11-21,3333.050049,3364.0,3305.550049,3335.5,3221.87793,261401.0,3332.7700196000005,3340.0145508000005,46.550048999999944,63.48741823395767,-1.835001516530179,170.0258739026699,23.829319739384186,84796.27747380592,-52752.38306084566,76.0,16.0,60.0,52.199951000000056,3335.016683,3364.4833169999997,3393.466634,3422.9332679999998,3306.0333659999997,3276.566732,3247.5834149999996,0.512403355137116,-6036216.0,-1
2014-11-24,3350.350098,3363.100098,3334.0,3355.050049,3220.005371,156584.0,3339.4400147000006,3344.0654652363633,66.69995100000006,67.84376008205439,-1.2420367303609359,160.2127851545024,25.01429288172709,27371.714832593043,-49110.37842582569,72.0,12.0,60.0,71.39990200000011,3350.716715666667,3367.433431333334,3379.8168136666663,3396.5335293333337,3338.333333333334,3321.616617666667,3309.233235333334,0.7233669453621779,-5879632.0,+1
2014-11-25,3358.0,3388.0,3281.649902,3353.100098,3158.305664,343894.0,3343.9700196000003,3346.5491167454547,45.300048999999944,66.92481335998094,-1.301179921140434,150.41045448999876,18.252426547724955,-358351.4344986893,-63166.79074823089,68.0,8.0,60.0,52.8000490000004,3340.9166666666665,3400.183431333333,3447.266764666666,3506.533529333333,3293.833333333333,3234.5665686666666,3187.483235333333,0.6718394937445178,-6223526.0,-1
2014-11-26,3280.0,3306.899902,3248.699951,3288.850098,3153.6484379999997,223306.0,3339.955029400001,3336.5273128181816,-40.14990200000011,44.175813098144644,-3.249921201091905,138.30994689788304,-9.657706708399925,-392604.16523731896,-78141.21755562951,64.0,4.0,60.0,58.449951000000056,3281.4833169999997,3314.2666829999994,3339.6832679999993,3372.4666339999994,3256.0667319999993,3223.2833659999997,3197.8667809999993,0.6898656495432409,-6446832.0,-1
2014-11-27,3286.699951,3305.399902,3257.199951,3284.0,3133.9135739999997,244311.0,3332.3800294000007,3326.3536711090906,-75.75,42.90549253697812,-3.397027600849257,123.02715050404186,-13.548735416170974,120614.0057206361,-69106.88882507125,60.0,0.0,60.0,29.10009799999989,3282.199951,3307.199951,3330.3999019999997,3355.399902,3259.0,3234.0,3210.800049,0.5560181793545789,-6691143.0,-1
2014-11-28,3279.0,3359.6999509999996,3276.0,3263.449951,3213.37915,275680.0,3325.8700196,3313.8209295818187,-65.10009799999989,37.61709297314143,-4.020322990597512,102.03921328842898,-8.763052884229047,-392389.9750518191,-83801.57518341165,56.00000000000001,0.0,60.0,106.35009799999989,3299.716634,3323.4332679999998,3383.416584999999,3407.1332189999994,3239.733317,3216.0166830000003,3156.0333660000006,-0.1499409360466651,-6966823.0,-1
2014-12-01,3341.0,3432.0,3335.0,3346.199951,3254.6245120000003,510490.0,3327.5350098,3317.5172807454546,16.64990200000011,60.333455318381134,-2.5742588958895873,78.06365782211788,30.144096168664817,-104818.24996560487,-84756.87862112364,52.0,0.0,60.0,104.40014699999983,3371.0666503333337,3407.1333006666673,3468.066650333334,3504.1333006666673,3310.1333006666673,3274.0666503333337,3213.1333006666673,0.1154634123711346,-6456333.0,+1
2014-12-02,3395.0,3395.0,3352.050049,3389.149902,3223.606689,165773.0,3332.3300049,3328.719988418182,47.949951000000056,67.43518813360691,-1.2856315031503116,62.47627628792452,35.228639054373076,34755.6537398507,-79324.49057743677,96.0,0.0,60.0,48.199951000000056,3378.7333169999997,3405.4165849999995,3421.683268,3448.3665359999995,3362.4666339999994,3335.7833659999997,3319.5166829999994,0.8637926734770924,-6290560.0,+1
2014-12-03,3365.850098,3414.6999509999996,3365.850098,3356.850098,3256.881104,286735.0,3331.5550049,3333.1781871636367,-7.75,58.367507301105725,-2.2547225322532287,49.99436260850689,37.4757737572637,38796.49971562849,-73955.35445775594,92.0,0.0,56.00000000000001,83.6999509999996,3379.1333823333334,3392.416666666667,3427.983235333333,3441.2665196666667,3343.5668136666673,3330.2835293333337,3294.7169606666675,-0.18423801602842188,-6577295.0,-1
2014-12-04,3392.0,3415.0,3384.1999509999996,3391.5,3271.62207,199285.0,3336.3650147000003,3344.077277181818,48.10009799999989,64.30809498810572,-1.215121512151215,42.73399873348353,54.534197087821624,157512.5540148875,-63434.08552182416,88.0,0.0,52.0,168.55004899999994,3396.8999836666662,3409.600016333333,3427.7000326666666,3440.4000653333333,3378.7999673333325,3366.099934666666,3347.999918333332,0.237014200854041,-6378010.0,+1
2014-12-05,3411.0,3417.0,3390.0,3406.850098,3274.74292,140056.0,3343.5000245,3356.8927468727275,71.35009799999989,66.734420882921,-0.7545725172517285,31.85498317783913,61.81918652340284,140665.41194705223,-54156.83532630031,84.0,0.0,96.0,48.800048999999944,3404.616699333333,3419.2333986666663,3431.6166993333336,3446.2333986666663,3392.2333986666663,3377.616699333333,3365.2333986666663,0.6240777037036996,-6237954.0,+1
2014-12-08,3430.0,3440.0,3366.100098,3410.100098,3245.693604,203336.0,3349.0050294000002,3369.0018511454546,55.050048999999944,67.2778480881918,-0.8949387009877315,22.472011839556217,62.40991969490221,19284.246167908575,-50818.60424261643,80.0,0.0,92.0,48.84985299999971,3405.4000653333333,3444.7000326666666,3479.2999673333334,3518.5999346666667,3370.8001306666665,3331.500163333333,3296.9002286666664,0.5953999776616745,-6034618.0,+1
2014-12-09,3390.0,3390.0,3319.800049,3379.850098,3204.112061,221590.0,3351.680029400001,3374.610045436363,26.75,57.236160501668614,-1.8003562406465163,16.61619773683924,15.548410881776768,-252664.08761633214,-59993.39922127904,96.0,0.0,88.0,58.14990200000011,3363.216715666667,3406.633382333334,3433.4166666666674,3476.833333333334,3336.433431333334,3293.016764666667,3266.233480333334,0.8554144005029276,-6256208.0,-1
2014-12-10,3323.050049,3345.0,3303.199951,3336.550049,3191.4841309999997,236136.0,3356.450024500001,3371.8591399090906,47.699951000000056,45.91689928614092,-3.096376863214608,8.945139641141395,-29.84950366621642,130411.16222383706,-51338.64617632437,92.0,60.0,84.0,27.0,3328.25,3353.300049,3370.050049,3395.100098,3311.5,3286.449951,3269.699951,0.7978482991730448,-6492344.0,-1
2014-12-11,3325.0,3352.0,3286.75,3323.399902,3208.481689,156314.0,3360.3900147000004,3365.850026727273,39.39990200000011,42.941053566957336,-3.4899759952110117,6.915689327957352,-41.852050591902376,138191.8274209694,-42723.62440973837,88.0,56.00000000000001,80.0,73.89990200000011,3320.7166340000003,3354.6832680000007,3385.9666340000003,3419.9332680000007,3289.4332680000007,3255.4666340000003,3224.1832680000007,0.5616843218390821,-6648658.0,-1
2014-12-12,3352.0,3394.399902,3342.300049,3341.100098,3245.165527,241538.0,3368.1550294000003,3362.3427691454544,77.65014699999983,48.15907627452224,-2.960188626159836,11.149447942140796,16.680346148558474,224207.77796656717,-30590.378525289234,84.0,52.0,96.0,90.30004899999994,3359.2666830000003,3376.2333170000006,3411.366536000001,3428.333170000001,3324.1334640000005,3307.16683,3272.0336110000003,-0.023031754043529674,-6407120.0,+1
2014-12-15,3374.0,3379.899902,3346.300049,3379.3000490000004,3235.033936,135240.0,3371.4650392000003,3364.3691363454545,33.100098000000344,57.77488281092391,-1.8168198443579648,17.76660458284141,32.576417063864426,-318749.4292125926,-43688.51752458701,80.0,48.0,32.0,76.65014699999983,3368.5,3390.699951,3402.099853,3424.299804,3357.100098,3334.900147,3323.5002449999997,0.9821471540366647,-6271880.0,+1
2014-12-16,3345.0,3383.6999509999996,3301.5,3368.75,3178.472412,217196.0,3369.4250490000004,3363.875492854546,-20.39990200000011,54.55046704119556,-2.1325950314277162,27.860286573360554,0.7766132543985698,-176498.6809048736,-49725.34327870765,76.0,44.0,31.999999999999993,65.25,3351.3166503333327,3401.1333006666655,3433.516601333333,3483.333251666665,3318.933349666666,3269.116699333333,3236.7333986666663,0.8181270083725516,-6489076.0,-1
2014-12-17,3290.0,3315.0,3250.75,3309.850098,3132.473145,267012.0,3364.725049,3353.0436835818186,-47.0,40.12487471048134,-3.895537324154448,26.972298634523668,-112.3394706071635,-185617.737147797,-55902.270415282655,72.0,40.0,32.0,71.0,3291.866699333333,3332.9833986666663,3356.1166993333336,3397.2333986666663,3268.7333986666663,3227.616699333333,3204.4833986666663,0.9198458832684807,-6756088.0,-1
2014-12-18,3300.0,3399.25,3270.050049,3261.949951,3250.927246,283235.0,3351.7700441000006,3334.3573021272728,-129.55004899999994,32.1476092662366,-5.32924420832086,20.026168392223553,-67.64336431553627,-114781.60791844578,-58578.60399710005,68.0,36.0,32.0,38.79980400000022,3310.4166666666665,3350.783284333333,3439.616617666666,3479.983235333333,3221.583333333333,3181.2167156666665,3092.383382333333,-0.06269428074318609,-7039323.0,-1
2014-12-19,3401.0,3462.0,3350.25,3385.3000490000004,3226.0551760000003,473560.0,3349.6150392000004,3340.4536666545455,-21.55004899999949,57.345192916735364,-2.2807002973535417,22.12762230198632,91.42776793066545,206149.63821215552,-46545.50182551479,64.0,32.0,32.0,82.1999509999996,3399.1833496666673,3448.1166993333345,3510.9333496666677,3559.8666993333345,3336.3666993333345,3287.4333496666673,3224.6166993333345,0.31364697091722954,-6565763.0,+1
2014-12-22,3381.9499509999996,3412.5,3358.100098,3359.399902,3258.8017579999996,194933.0,3344.5450196000006,3342.232732618182,-50.70019599999978,52.61165018539205,-3.0508503716919386,16.820191508472362,47.72988516529194,54822.800949527154,-41937.85160690895,96.0,28.000000000000004,32.0,118.0,3376.6666666666665,3395.233235333333,3431.066568666666,3449.6331373333333,3340.833333333333,3322.2667646666664,3286.433431333333,0.02389349892579254,-6760696.0,-1
2014-12-23,3395.0,3424.0,3385.100098,3393.5,3263.79541,202035.0,3345.9100098000004,3351.1336381454544,13.649902000000111,57.89191906201484,-2.0368718406184954,9.822245821201705,90.77479392511468,-229585.86529317958,-50467.30693785759,92.0,24.0,32.0,129.19995100000006,3400.866699333333,3416.6333006666664,3439.7666013333337,3455.5332026666665,3377.7333986666663,3361.966797333333,3338.833496666666,0.21593632806581586,-6558661.0,+1
2014-12-24,3400.0,3420.0,3332.800049,3398.6999509999996,3231.913086,403056.0,3352.125,3360.7318092727273,62.149901999999656,58.70159139575597,-1.8822494498959383,2.6735399065246384,48.431577056122805,-51411.029105048954,-50510.20340078703,88.0,20.0,32.0,200.05004899999994,3383.8333333333335,3434.866617666667,3471.033284333334,3522.066568666667,3347.666666666667,3296.6333823333334,3260.466715666667,0.7557332457675304,-6155605.0,+1
2014-12-26,3367.0,3388.6999509999996,3326.0,3365.5,3200.799316,210882.0,3356.3350097999996,3363.1636274545453,42.10009799999989,51.41800654061657,-2.869461790068391,-0.11868467593512833,-5.01308666531101,353119.72254046827,-32163.38826504662,84.0,16.0,68.0,54.39990200000011,3360.0666503333327,3394.1333006666655,3422.766601333333,3456.833251666665,3331.433349666666,3297.366699333333,3268.7333986666663,0.6299845433691049,-6366487.0,-1
2014-12-29,3335.050049,3380.0,3335.050049,3333.100098,3214.3396,211257.0,3355.5350098000004,3358.9390980363632,-8.0,45.11471126533676,-3.832884388938451,0.8185887311674378,-37.28920858110781,-155449.34528966123,-37767.29549589478,80.0,12.0,68.0,64.60009799999989,3349.3833823333334,3363.716715666667,3394.3333333333335,3408.666666666667,3318.766764666667,3304.4334313333334,3273.816813666667,-0.043380492227901496,-6577744.0,-1
2014-12-30,3350.0,3368.649902,3339.449951,3347.199951,3214.387451,109577.0,3352.325,3357.4236327999997,-32.100098000000344,48.29732701858209,-3.413620249776983,3.5921255937191745,-32.83982403573088,-374278.4,-53063.255034795344,76.0,8.0,68.0,87.19995100000006,3351.7666013333333,3364.0832516666665,3380.9665523333338,3393.2832026666665,3334.8833006666664,3322.566650333333,3305.6833496666663,0.2654114042862601,-6468167.0,+1
2014-12-31,3305.0,3341.899902,3299.75,3347.25,3197.630127,281626.0,3350.1749999999997,3356.5009055272726,-21.5,48.309603300308915,-3.4121320249776987,5.369451056430535,-85.8581617667497,-726017.2510670134,-83652.07350061709,72.0,4.0,68.0,72.6999509999996,3329.633300666667,3359.5166013333337,3371.7832026666674,3401.666503333334,3317.3666993333336,3287.4833986666667,3275.2167973333335,1.1269302595294262,-6186541.0,+1
2015-01-01,3320.25,3360.0,3320.25,3329.800049,3208.1455079999996,299232.0,3352.1699951,3352.796368981818,19.949951000000056,44.097362602369266,-3.9310125185845988,1.2435271709000517,-59.38876907518361,554430.048297599,-54648.34027132596,68.0,0.0,68.0,44.949951000000056,3336.6833496666663,3353.1166993333327,3376.433349666666,3392.8666993333327,3313.3666993333327,3296.9333496666663,3273.6166993333327,0.24025280503144514,-6485773.0,-1
2015-01-02,3360.0,3383.0,3350.5,3340.75,3226.247314,233924.0,3360.05,3350.7200062363636,78.80004899999994,47.41700209208818,-3.6054118346714246,-5.575577102184525,1.576947455768599,-242479.7693500337,-63186.13262027046,64.0,56.00000000000001,68.0,35.54980400000022,3358.0833333333335,3365.666666666667,3390.583333333334,3398.166666666667,3333.166666666667,3325.5833333333335,3300.666666666667,-0.3,-6251849.0,+1
2015-01-05,3382.0,3469.350098,3376.0500490000004,3359.600098,3310.946533,536747.0,3357.4800049000005,3350.638205872727,-25.69995100000051,52.9649180429919,-3.256338267799739,-4.2296779322468865,120.39253505138385,-502499.0565465172,-83154.90215329708,60.0,52.0,68.0,47.449951000000056,3401.666748333333,3427.283447666666,3494.9667973333326,3520.5834966666653,3333.9833986666663,3308.3666993333336,3240.683349666667,-0.17631235113285526,-5715102.0,+1
2015-01-06,3439.0,3439.0,3382.5,3447.8000490000004,3260.482422,422743.0,3366.3200196000003,3367.060032072727,88.40014700000029,70.03414472842286,-0.6394009041608915,5.329470390254755,163.5634038236774,33320.127553596845,-77860.58255444092,96.0,48.0,68.0,39.75,3423.1000163333338,3463.7000326666675,3479.6000163333338,3520.2000326666675,3407.2000326666675,3366.6000163333338,3350.7000326666675,1.1557530796460247,-5292359.0,+1
2015-01-07,3400.0,3458.9499509999996,3382.0500490000004,3395.25,3301.29541,369241.0,3366.495019600001,3372.320028509091,1.75,56.050403658914306,-2.1985875605021463,2.4143051611281408,110.40077187889182,30164.09804399595,-72950.36974089571,92.0,44.0,7.999999999999993,53.199951000000056,3412.0833333333335,3442.1166176666666,3488.9832353333322,3519.0165196666658,3365.2167156666674,3335.1834313333343,3288.316813666668,0.17165107700657067,-5661600.0,-1
2015-01-08,3465.0,3509.5500490000004,3444.0,3437.75,3337.5471190000003,422022.0,3370.4000245,3385.275479490909,39.0500490000004,62.95323880631283,-2.1052337003836885,6.838961685486538,208.83140755500423,-230581.187176375,-80115.4069793326,88.0,40.0,8.0,128.6000979999999,3463.7666830000003,3483.5333660000006,3529.316732000001,3549.083415000001,3417.983317,3398.216634,3352.4332679999998,-0.09534699203657288,-5239578.0,+1
2015-01-09,3500.0,3507.6999509999996,3429.9499509999996,3475.5,3330.536865,194054.0,3381.4000245000007,3404.3845659454546,110.0,68.08985708686238,-0.9983741188605085,5.739013630525733,182.55650898841068,-343501.9807170497,-92087.52409864176,96.0,36.0,48.0,79.39990200000011,3471.049967333333,3512.1499836666662,3548.7999673333334,3589.8999836666662,3434.3999836666662,3393.299967333333,3356.6499836666662,0.5858527202572399,-5045524.0,+1
2015-01-12,3470.0,3483.649902,3445.149902,3468.1999509999996,3325.447021,152803.0,3394.9100098000004,3420.1663707636367,135.0998529999997,66.0465487737276,-1.2124172759794265,5.949512090395729,148.30837420544418,-997021.1239821806,-133220.86997827791,92.0,32.0,48.0,76.8999019999992,3465.6665850000004,3486.1832680000007,3504.166585,3524.6832680000007,3447.6832680000007,3427.1665850000004,3409.1832680000007,0.5987025714285582,-5198327.0,-1
2015-01-13,3483.8000490000004,3515.0,3462.100098,3462.899902,3330.584961,237771.0,3406.4800049000005,3432.528169345454,115.69995100000006,64.42690042161345,-1.5251785128805588,11.810479132964247,147.29408613476454,397483.43858463736,-109097.94662085279,88.0,28.000000000000004,48.0,114.3000490000004,3480.0,3497.899902,3532.899902,3550.799804,3445.0,3427.100098,3392.100098,0.015119196251067163,-5436098.0,-1
2015-01-14,3471.850098,3531.0,3461.3000490000004,3468.25,3376.439453,429069.0,3418.580004900001,3443.7590775454546,121.0,65.41475102722478,-1.8283799533799532,23.198873828300293,136.69548709623086,-172787.57735690867,-111992.92986372758,96.0,24.0,60.0,77.75,3486.8500163333338,3512.399983666667,3556.5499673333334,3582.0999346666667,3442.7000326666675,3417.150065333334,3373.000081666668,0.09971242304029225,-5007029.0,+1
2015-01-15,3550.350098,3638.649902,3540.0,3516.0,3481.881348,670686.0,3437.2000000000003,3461.471803927273,186.19995100000006,73.10582976297007,-3.4650291807305447,32.9521428447224,207.82046743836256,207108.3495145631,-97488.32612362826,96.0,20.0,60.0,38.5,3564.883300666667,3589.7666013333337,3663.5332026666674,3688.416503333334,3491.1166993333336,3466.2333986666667,3392.4667973333335,-0.24328458025229435,-4336343.0,+1
2015-01-16,3615.25,3625.0,3592.0500490000004,3625.8000490000004,3473.046387,379075.0,3465.7050049000004,3495.762721927273,285.0500490000004,83.08573685982802,-0.3630261002010168,43.8678334214801,207.20872136057883,-291137.4251320171,-106290.55797319814,96.0,16.0,60.0,52.89990200000011,3614.283366,3636.516683,3647.2333169999993,3669.4666339999994,3603.5667320000002,3581.3334150000005,3570.6167810000006,1.024280734135247,-3957268.0,+1
2015-01-19,3627.6999509999996,3642.5,3615.1999509999996,3616.600098,3482.313232,192537.0,3491.4050049,3523.1981933999996,257.0,80.20821848081664,-0.7309129956257969,57.6813885086558,171.38106081626592,167141.78495217688,-93861.81500989794,92.0,12.0,72.0,69.6999509999996,3624.766683,3634.333415,3652.0667320000002,3661.6334640000005,3607.0333659999997,3597.4666339999994,3579.7333169999993,0.051287343843238804,-4149805.0,-1
2015-01-20,3618.0,3636.0,3584.5,3626.25,3462.4350590000004,333315.0,3509.2499999999995,3547.7154652363643,178.4499509999996,81.00443140634539,-0.45858614364329053,73.08417652963635,130.14731629983694,-105572.39768339768,-94394.1142265428,96.0,8.0,76.0,170.3999020000001,3615.5833333333335,3646.666666666667,3667.083333333334,3698.166666666667,3595.166666666667,3564.0833333333335,3543.666666666667,0.8106796116504854,-3816490.0,+1
2015-01-21,3623.0,3690.0,3592.0,3605.5500490000004,3490.4277340000003,402419.0,3530.2800048999998,3565.2245650545456,210.3000490000004,73.66903423934232,-2.3517112503480813,89.57582371876242,118.38599284102459,-817535.1693635614,-127264.16243565205,92.0,4.0,80.0,109.0,3629.1833496666673,3666.3666993333345,3727.1833496666677,3764.3666993333345,3568.3666993333345,3531.1833496666673,3470.3666993333345,0.13826580612245307,-4218909.0,-1
2015-01-22,3648.0,3648.0,3592.100098,3634.6999509999996,3454.4643549999996,318883.0,3549.9750000000004,3584.2100098,196.9499509999996,77.04642207694555,-1.5399623781676526,95.39402227492292,96.59089890694497,-755657.0729350353,-155827.47675524934,96.0,0.0,80.0,27.3000490000004,3624.9333496666663,3657.766601333333,3680.833251666666,3713.666503333333,3601.8666993333327,3569.0334476666662,3545.9667973333326,0.7620738404872271,-3900026.0,+1
2015-01-23,3634.0,3639.75,3575.0,3597.25,3463.539063,337571.0,3562.15,3592.8054643454548,121.75,64.73721160626368,-2.582846003898635,105.0057545337936,69.05777216619947,262528.05741315417,-136811.3159803264,92.0,0.0,88.0,51.5,3604.0,3633.0,3668.75,3697.75,3568.25,3539.25,3503.5,0.3436293436293436,-4237597.0,-1
2015-01-27,3644.9499509999996,3704.6999509999996,3585.149902,3606.6999509999996,3541.516357,1278436.0,3576.0000000000005,3600.9054554363634,138.5,66.30459283147863,-2.7179188876440152,107.22901646903756,73.41751127359866,25007.553341059305,-129455.9127810223,88.0,28.000000000000004,88.0,98.0,3632.1832679999993,3679.2166339999985,3751.7333169999993,3798.766682999998,3559.666584999999,3512.633219,3440.1165359999995,0.18025964171708186,-2959161.0,+1
2015-01-28,3692.0,3758.5,3692.0,3687.899902,3577.911865,672705.0,3598.5000000000005,3621.2508921636363,225.0,76.61160067923903,-1.9292279819647464,114.90303053713933,102.51724738530216,-153140.86707539114,-130532.50161933718,96.0,24.0,96.0,55.89990200000011,3712.799967333334,3733.5999346666677,3779.2999673333343,3800.0999346666677,3667.0999346666677,3646.299967333334,3600.5999346666677,-0.06165560902255472,-2286456.0,+1
2015-01-29,3745.0,3745.0,3677.0,3725.8000490000004,3542.380371,603103.0,3624.2550049,3644.3963556181816,257.5500490000004,79.91961229471725,-0.893563355649668,124.16984877958475,87.12052344201842,63137.655312516894,-121729.31261518307,96.0,20.0,92.0,64.75,3715.9333496666673,3754.8666993333345,3783.9333496666677,3822.8666993333345,3686.8666993333345,3647.9333496666673,3618.8666993333345,0.7176477794117706,-1683353.0,+1
2015-01-30,3700.0,3741.0,3626.5500490000004,3688.8000490000004,3502.575928,284786.0,3641.5350098000004,3656.1318181818187,172.8000490000004,68.9365203306483,-1.9046304413171087,136.90129632298658,61.69276463326077,76055.61550682581,-112739.0885582578,92.0,16.0,60.0,119.55004899999949,3685.450032666667,3744.3500163333338,3799.899983666667,3858.7999673333334,3629.900065333334,3571.0000816666675,3515.4501143333346,0.5439058685136546,-1968139.0,-1
2015-02-02,3647.350098,3725.0,3620.0,3647.350098,3523.7985840000006,319679.0,3643.6900147000006,3657.189106945455,21.55004899999949,58.53784159583326,-3.0372974996584263,149.82538327535894,44.230928856289125,43082.36521386857,-105656.29516634089,88.0,12.0,72.0,151.8000490000004,3664.116699333333,3708.2333986666663,3769.1166993333336,3813.2333986666663,3603.2333986666663,3559.116699333333,3498.2333986666663,0.26047712380952276,-2287818.0,-1
2015-02-03,3708.0,3708.0,3600.0,3669.4499509999996,3464.643311,220676.0,3648.9750000000004,3661.872731727273,52.84985299999971,62.05874244003203,-2.433393878945222,156.05360770929246,36.05781853252952,99790.05000064004,-96317.82488285,84.0,8.0,76.0,68.0,3659.1499836666662,3718.2999673333325,3767.1499836666662,3826.2999673333325,3610.2999673333325,3551.1499836666662,3502.2999673333325,0.6430551018518481,-2067142.0,+1
2015-02-04,3620.0,3634.0,3550.5,3607.850098,3416.3400880000004,203545.0,3647.1350098000003,3654.3954768181816,-18.39990200000011,48.745722138077554,-4.1166799289520455,144.10387629740399,4.994071616963166,318743.1059781108,-77451.41884084728,80.0,4.0,76.0,114.4499509999996,3597.450032666666,3644.4000653333323,3680.9500326666657,3727.9000653333323,3560.9000653333323,3513.950032666666,3477.4000653333323,0.6868275209580825,-2270687.0,-1
2015-02-05,3579.0,3597.0,3508.0,3557.5500490000004,3382.8732909999994,379633.0,3642.3350098000005,3638.1073021272728,-48.0,40.54978186456568,-5.491185981691477,132.58784396861165,-18.094511654919287,-71457.76390994544,-77178.97997905912,76.0,0.0,76.0,105.0,3554.1833496666673,3600.3666993333345,3643.1833496666677,3689.3666993333345,3511.3666993333345,3465.1833496666673,3422.3666993333345,0.5567421235955101,-2650320.0,-1
2015-02-06,3529.75,3533.5,3490.0,3522.6999509999996,3363.571289,198214.0,3631.1350098000003,3616.355473254546,-112.0,35.74512283731144,-6.443504549801897,118.27527246015279,-39.565457457774016,-469931.24434145144,-95031.35571274838,72.0,0.0,76.0,108.0,3515.3999836666662,3540.7999673333325,3558.8999836666662,3584.2999673333325,3497.2999673333325,3471.8999836666662,3453.7999673333325,0.7517230114942437,-2848534.0,-1
2015-02-09,3490.0,3497.1999509999996,3400.0,3502.600098,3275.8955079999996,286868.0,3621.6700196,3592.9854892909098,-94.64990200000011,33.13256511488295,-6.992755895614159,104.50695748954604,-67.43165658717461,-563065.9019073569,-116305.65335902026,68.0,0.0,76.0,118.9499509999996,3466.6000163333333,3533.2000326666666,3563.7999673333325,3630.3999836666662,3436.000081666667,3369.4000653333337,3338.8001306666674,1.0555570959084157,-3135402.0,-1
2015-02-10,3393.0,3478.0,3360.0,3411.3000490000004,3259.137939,547537.0,3602.1300294000002,3554.736403727273,-195.3999019999992,23.95585805950182,-9.487633583822916,84.20283082085098,-95.72724069057692,-182912.48331537945,-119333.23655134845,64.0,0.0,76.0,99.85009799999989,3416.4333496666673,3472.8666993333345,3534.4333496666677,3590.8666993333345,3354.8666993333345,3298.4333496666673,3236.8666993333345,0.4347461779661051,-3682939.0,-1
2015-02-11,3406.0,3470.8000490000004,3406.0,3393.850098,3317.620605,341769.0,3572.7250490000006,3516.867325290909,-294.0498040000002,22.57685161883377,-9.96447334335292,68.56824166944261,-90.03712624083752,66035.67041470952,-110907.3771106105,60.0,96.0,72.0,67.5500490000004,3423.550049,3441.100098,3488.350098000001,3505.9001470000003,3376.3000489999995,3358.7499999999995,3311.499999999999,-0.18749834587316494,-4024708.0,-1
2015-02-12,3468.0,3559.75,3468.0,3454.75,3410.914307,436882.0,3545.6200441000005,3495.417316381818,-271.0500490000004,37.14664292092595,-8.30031425058068,57.66193460300474,-52.31316473067619,57584.196391516794,-103248.66919535342,56.00000000000001,92.0,68.0,122.6999509999996,3494.1666666666665,3520.333333333333,3585.916666666666,3612.083333333333,3428.583333333333,3402.4166666666665,3336.833333333333,-0.1444141689373297,-3587826.0,+1
2015-02-13,3565.0,3627.0,3531.3000490000004,3551.899902,3473.382324,321186.0,3531.9300294000004,3496.5591087272724,-136.9001470000003,53.31687086033474,-5.645582675228853,33.492269759639385,-11.75480389697949,-192029.54458098105,-107284.16354554752,52.0,88.0,64.0,142.6000979999999,3570.0666503333337,3608.833251666667,3665.7666013333337,3704.5332026666665,3513.1333006666673,3474.366699333334,3417.4333496666677,0.21525458252324287,-3266640.0,+1
2015-02-16,3620.0,3650.0,3561.5,3616.9499509999996,3430.312988,260901.0,3528.8900147,3512.017276290909,-30.40014700000029,61.05732751644461,-3.868016095094969,6.479865327974949,11.192478702441921,114689.49323883408,-97194.45183896332,48.0,84.0,-36.0,64.8000490000004,3609.4833169999997,3657.4666339999994,3697.983317,3745.9666339999994,3568.9666339999994,3520.9833169999997,3480.4666339999994,0.6265531186440633,-3005739.0,+1
2015-02-18,3575.0,3584.0,3547.0500490000004,3572.100098,3423.446289,161803.0,3519.1550294000003,3519.873655072727,-97.34985299999971,53.9419988960255,-5.093589342806397,-16.095829706312998,-13.081573182576207,-50893.826824651034,-95089.87796779396,44.0,80.0,-35.99999999999999,165.8999020000001,3567.716715666667,3588.3833823333334,3604.666666666667,3625.333333333333,3551.433431333334,3530.7667646666673,3514.4834803333342,0.6779453915919877,-3167542.0,-1
2015-02-19,3575.0,3615.0,3562.149902,3564.9499509999996,3452.447754,214789.0,3514.8650147000003,3528.2000044545453,-42.90014700000029,52.809925512434695,-4.938289879319814,-35.209064477851825,-4.05125159406849,-188901.027977574,-99354.02116336754,40.0,76.0,-36.0,172.25,3580.699951,3599.25,3633.5500490000004,3652.100098,3546.399902,3527.849853,3493.549804,0.052980961359797206,-3382331.0,-1
2015-02-20,3610.0,3614.0,3542.0,3595.149902,3406.5451659999994,240749.0,3518.625,3542.7972566909093,37.59985299999971,57.188631902466135,-4.0046704557935175,-58.517312379516625,-0.15949746857976554,-8513.719731716603,-95224.9165405345,36.0,72.0,-36.0,98.10009799999989,3583.7166340000003,3625.4332680000007,3655.7166340000003,3697.4332680000007,3553.4332680000007,3511.7166340000003,3481.4332680000007,0.7381930833333349,-3141582.0,+1
2015-02-23,3561.0,3575.0,3532.850098,3547.350098,3405.152832,163132.0,3521.0900147000007,3548.0200017818183,24.65014700000029,48.901812038338846,-4.899335410921128,-75.6983861509616,-28.102318084794174,412196.56202531647,-72160.30381284887,32.0,68.0,-36.0,69.8999019999992,3551.7333986666667,3570.6166993333336,3593.8833006666673,3612.7666013333337,3528.4667973333335,3509.5834966666666,3486.3168953333334,0.34401028975108794,-3304714.0,-1
2015-02-24,3573.850098,3600.0,3553.1999509999996,3545.899902,3445.869629,143983.0,3525.4199951000005,3552.530890381818,43.29980400000022,48.65500688514719,-4.491551620947628,-83.97446350804375,-12.780929694672867,-378654.0,-86091.83549554298,28.000000000000004,64.0,-36.0,52.85009799999989,3566.3666176666666,3579.5332843333335,3613.166666666667,3626.333333333334,3532.733235333333,3519.566568666666,3485.9331863333327,-0.15598378967507978,-3448697.0,-1
2015-02-25,3595.0,3615.0,3564.100098,3588.3000490000004,3437.8027340000003,173339.0,3543.1199951000003,3563.9636274545455,177.0,56.125217022612325,-1.7375373415939062,-79.81401312061234,14.965050035185964,-4605.94457207461,-82387.93135305918,24.0,60.0,-36.0,72.0,3589.1333823333334,3614.166666666667,3640.0332843333335,3665.066568666667,3563.266764666667,3538.2334803333333,3512.3668626666667,0.4754419959394118,-3275358.0,+1
2015-02-26,3567.3000490000004,3581.899902,3483.149902,3579.899902,3358.049561,429598.0,3561.7249755000003,3570.650883254546,186.04980400000022,54.31866192126215,-1.9740945649112895,-73.28780575847168,-22.7219590016433,-47026.14929877236,-80780.57761934267,20.0,56.00000000000001,-36.0,62.29980400000022,3548.3165686666666,3613.483235333333,3647.066568666666,3712.233235333333,3514.733235333333,3449.5665686666666,3415.983235333333,0.979746835443038,-3704956.0,-1
2015-02-27,3497.0,3618.850098,3496.850098,3496.850098,3461.330322,378654.0,3565.9349853000003,3558.855450981818,42.10009799999989,39.730100328683534,-4.312866854407212,-54.68859645125531,-25.507323279035493,9182.709096245226,-76691.33730443269,16.0,52.0,-36.0,52.64990200000011,3537.516764666667,3578.183431333334,3659.516764666667,3700.183431333334,3456.183431333334,3415.516764666667,3334.183431333334,0.0,-4083610.0,-1
2015-03-03,3718.0,3734.350098,3689.5500490000004,3711.4499509999996,3561.4423829999996,206296.0,3581.8899902000003,3585.312717472727,159.5500489999995,66.5308454056557,-0.629929618404535,-27.816427717583792,193.72783669820652,21549.98866928348,-72225.8224773804,12.0,48.0,-36.0,69.10009799999989,3711.7833659999997,3734.016682999999,3756.583414999999,3778.8167319999984,3689.2166339999994,3666.983317,3644.416585,0.48883656354928207,-3877314.0,+1
2015-03-04,3750.0,3789.6999509999996,3647.25,3708.649902,3532.3930659999996,340907.0,3591.0599853000003,3608.3599741636363,91.69995100000051,66.08840398183119,-2.196061724769549,-5.258894118062926,189.0432823914602,-368767.8532257497,-85705.00572221621,8.0,44.0,-36.00000000000001,105.15014700000029,3715.199951,3783.149902,3857.649901999999,3925.5998529999997,3640.6999510000005,3572.7500000000005,3498.250000000001,0.4310278913328674,-4218221.0,-1
2015-03-05,3677.0,3711.25,3641.350098,3678.399902,3532.7294920000004,152837.0,3601.689965700001,3624.239959018182,106.29980400000022,61.029244315095326,-3.015689448551422,2.365771122629667,145.2442084895651,110759.36283494315,-76774.80713309601,96.0,40.0,-36.0,122.0,3677.0,3712.649902,3746.899902,3782.549804,3642.75,3607.100098,3572.850098,0.5300408575680143,-4371058.0,-1
2015-03-09,3632.3000490000004,3690.899902,3623.0,3678.75,3525.5749509999996,218786.0,3613.0699706000005,3638.2508743454546,113.8000490000004,61.0690422344632,-3.00620349725091,2.0786388122241988,134.4768965599575,-62498.43209914328,-76125.88099391693,92.0,36.0,28.0,0.0,3664.2166340000003,3705.4332680000007,3732.1165360000005,3773.333170000001,3637.5333660000006,3596.3167320000002,3569.6334640000005,0.8210615679533663,-4152272.0,+1
2015-03-10,3689.0,3689.0,3640.25,3671.3000490000004,3501.999756,182667.0,3620.684985300001,3648.8381613272727,76.15014700000029,59.575220103274184,-3.2080608982564027,13.175035431048855,130.22991747787145,-52119.066562208216,-75034.66215407001,88.0,32.0,28.0,0.0,3666.8500163333338,3693.4500326666675,3715.6000163333338,3742.2000326666675,3644.7000326666675,3618.1000163333338,3595.9500326666675,0.6369240820512903,-4334939.0,-1
2015-03-11,3642.0500490000004,3672.0,3615.350098,3646.75,3511.314453,198508.0,3630.6249755000003,3653.5772549090907,99.39990200000011,54.50570313910388,-3.8732477009209907,27.875252387902037,81.74244465629859,13903.085911492604,-70992.03723477799,84.0,28.000000000000004,-36.0,0.0,3644.700032666666,3674.0499673333325,3701.349934666666,3730.6998693333326,3617.4000653333323,3588.050130666666,3560.7501633333322,0.5542798997251583,-4533447.0,-1
2015-03-12,3667.399902,3719.9499509999996,3662.100098,3656.4499509999996,3538.92334,308505.0,3641.6799804,3658.272705,110.55004899999949,56.20470353316871,-3.610426254344945,37.1571000172371,105.32902153739043,-70814.55785625413,-70983.96999028587,80.0,24.0,-36.0,142.4499509999996,3679.5,3696.899902,3737.3498529999997,3754.749755,3639.0500490000004,3621.6501470000003,3581.2001960000007,-0.09766916780238519,-4224942.0,+1
2015-03-13,3705.0,3717.1999509999996,3625.100098,3685.1999509999996,3505.7924799999996,363024.0,3651.3699706,3666.185426927273,96.8999019999992,61.16468010059229,-2.831441227610107,52.01627673384701,78.87603177196381,89397.24690744877,-63693.91466488775,76.0,20.0,56.0,69.89990200000011,3675.8333333333335,3726.566568666667,3767.9331863333327,3818.666421666667,3634.4667156666674,3583.733480333334,3542.3668626666677,0.652551019815416,-3861918.0,+1
2015-03-16,3651.0,3677.0,3637.8000490000004,3650.6999509999996,3502.287354,182829.0,3658.4499755,3666.0636051818183,70.80004899999949,52.87345019676469,-3.766223259691912,68.88456601118924,40.82084371215688,87471.77377542043,-56822.74699783545,72.0,16.0,56.0,67.89990200000011,3655.1666666666665,3672.5332843333326,3694.3666176666657,3711.7332353333322,3633.333333333333,3615.966715666667,3594.1333823333334,0.3290795440024742,-4044747.0,-1
2015-03-17,3665.0,3688.9499509999996,3623.5500490000004,3647.0500490000004,3516.211914,185250.0,3673.4699706,3663.990891272728,150.1999510000005,52.01277694566889,-3.8651178338501353,77.06019614724664,29.571747009885424,-44309.08523201228,-56253.94418945454,68.0,12.0,56.0,48.75,3653.1833496666673,3682.816650333334,3718.583251666666,3748.2165523333333,3617.416748333335,3587.783447666668,3552.0168463333357,0.35932775556758917,-4229997.0,-1
2015-03-18,3663.0,3678.0,3642.3000490000004,3661.5500490000004,3519.429199,177261.0,3668.4799804000004,3661.8236328,-49.8999019999992,55.34479572599001,-3.4722384290621306,84.37520568826403,32.28872806333832,-100200.63771503085,-58251.52117071744,64.0,8.0,56.0,56.64990200000011,3660.6166993333336,3678.933349666667,3696.316650333333,3714.6333006666664,3643.233398666667,3624.916748333334,3607.5334476666676,0.5392164263754932,-4052736.0,+1
2015-03-19,3671.0,3695.0,3648.0,3664.899902,3509.922363,252139.0,3664.104980400001,3661.172709454545,-43.75,56.15630708491597,-3.381473721974737,102.3212933412592,36.923510345772264,394733.8415517458,-37661.27738278435,60.0,4.0,56.0,73.1999509999996,3669.299967333334,3690.5999346666677,3716.2999673333343,3737.5999346666677,3643.5999346666677,3622.299967333334,3596.5999346666677,0.3595723829787258,-3800597.0,+1
2015-03-20,3640.0,3672.8000490000004,3610.0,3655.0,3480.008789,206403.0,3661.7649902000003,3659.517258472727,-23.39990200000011,52.87941444535197,-3.6497128671622976,89.9730117828858,11.04909992247126,-116828.93320501121,-41259.80719752682,56.00000000000001,0.0,56.0,92.09985299999971,3645.9333496666673,3681.8666993333345,3708.733398666667,3744.666748333335,3619.066650333334,3583.133300666667,3556.2666013333337,0.7165599504548111,-4007000.0,-1
2015-03-23,3625.0500490000004,3639.1999509999996,3583.0500490000004,3623.850098,3451.727051,192986.0,3656.2750000000005,3652.623641709091,-54.89990200000011,43.63512398379382,-4.493723553849521,70.62759100320181,-18.595561480965756,-112443.89628415846,-44495.44761453904,52.0,0.0,56.0,47.3999019999992,3615.366699333333,3647.683349666666,3671.516601333332,3703.833251666665,3591.5334476666667,3559.216797333334,3535.3835456666675,0.7266272521722312,-4199986.0,-1
2015-03-24,3625.0,3635.0,3567.0500490000004,3594.399902,3444.9094240000004,227226.0,3648.5849853000004,3641.373623890909,-76.90014700000029,36.646402890578074,-5.291680483185384,52.5478767913487,-34.567894226698066,-285082.87352288247,-55431.239714133415,48.0,0.0,56.0,65.3999019999992,3598.8166503333337,3630.583251666667,3666.7666013333337,3698.5332026666665,3562.6333006666673,3530.866699333334,3494.6833496666677,0.4024999664826818,-4427212.0,-1
2015-03-25,3590.0,3628.899902,3573.3000490000004,3587.3000490000004,3471.269775,201854.0,3642.6399902000003,3630.2309082000006,-59.4499509999996,35.083357060024085,-5.484051932890364,37.041919315266114,-43.67748317767842,163759.35331882065,-45468.03092873191,44.0,32.0,56.0,35.6999509999996,3596.5,3619.6999509999996,3652.0998529999997,3675.2998039999993,3564.100098,3540.9001470000003,3508.500245,0.2517992268792522,-4629066.0,-1
2015-03-26,3605.0,3622.9499509999996,3537.9499509999996,3614.75,3420.085205,489101.0,3638.4699951,3625.16000089091,-41.6999509999996,45.46077777534582,-2.905313589627122,28.46332186643167,-56.75387924352435,-2531.5173042183915,-43516.37121643697,40.0,28.000000000000004,56.0,47.0,3591.8833006666664,3645.816650333333,3676.8833006666664,3730.816650333333,3560.816650333333,3506.8833006666664,3475.816650333333,0.9035299882352988,-4139965.0,+1
2015-03-27,3570.0,3619.75,3545.600098,3561.4499509999996,3466.756592,204071.0,3626.0949951000002,3611.156356509091,-123.75,33.472527121458555,-4.3773043578309325,25.530242681787968,-82.00408244585238,127358.6325689966,-35749.32558188767,36.0,24.0,56.00000000000001,62.8000490000004,3575.6000163333333,3605.5999346666667,3649.749918333334,3679.749836666667,3531.4500326666666,3501.450114333333,3457.3001306666665,0.21375420024155511,-4344036.0,-1
2015-03-30,3629.0,3674.0,3600.4499509999996,3610.0500490000004,3515.635986,152167.0,3622.0300049,3608.2390935818185,-40.6499019999992,47.921444982802726,-3.035112428705293,19.2874458847009,-20.277216581926307,-309063.8281713599,-48172.71207534807,32.0,20.0,52.0,71.9499509999996,3628.1666666666665,3655.8833823333334,3701.7167156666665,3729.433431333334,3582.333333333333,3554.616617666666,3508.7832843333326,0.13052469890265805,-4191869.0,+1
2015-03-31,3659.850098,3727.6999509999996,3659.850098,3660.9499509999996,3550.5913090000004,294635.0,3623.4199951,3615.315447418182,13.899901999999202,58.74833027403187,-1.8395017747776305,9.339157914794214,49.51667148894035,-196548.328124576,-54917.05826568484,28.000000000000004,16.0,48.0,67.9499509999996,3682.8333333333335,3705.816568666667,3750.6831863333327,3773.666421666667,3637.9667156666674,3614.983480333334,3570.1168626666677,0.016210101442662175,-3897234.0,+1
2015-04-01,3699.9499509999996,3757.5500490000004,3600.0,3697.350098,3500.030762,694487.0,3627.0000000000005,3628.757284309091,35.80004899999949,64.78866729553954,-1.6454592719444987,6.472256611389639,57.95781019222495,-12272.593670023734,-52978.67350961346,24.0,12.0,12.0,55.59985299999971,3684.966715666667,3769.933431333334,3842.516764666667,3927.4834803333342,3612.3833823333334,3527.4166666666665,3454.833333333333,0.6178995095076082,-3202747.0,+1
2015-04-06,3646.0,3670.899902,3619.0,3644.6999509999996,3484.906006,262771.0,3624.9800049000005,3631.9754572181814,-20.19995100000051,52.0650573426331,-3.0845579939748635,-0.33364285544848826,-1.2435307971041842,61351.76814066983,-47781.835248372605,20.0,8.0,11.999999999999996,85.0,3644.8666176666666,3670.733235333333,3696.7665196666667,3722.6331373333333,3618.833333333333,3592.9667156666665,3566.933431333333,0.49518303522036605,-3465518.0,-1
2015-04-07,3640.0,3650.0,3578.0,3628.9499509999996,3457.008789,306684.0,3622.3750000000005,3632.6972656,-26.0500490000004,48.759822706100955,-3.5150564097148638,-10.067905198175595,-48.90760424899909,-145130.83685977373,-52206.789870656794,16.0,4.0,12.0,74.14990200000011,3618.9833169999997,3659.9666339999994,3690.983317,3731.9666339999994,3587.9666339999994,3546.9833169999997,3515.9666339999994,0.7076382083333278,-3772202.0,-1
2015-04-08,3615.0,3664.899902,3606.0,3599.899902,3484.6660159999997,256031.0,3619.9799804000004,3628.6108841454547,-23.950195999999778,42.9562371237541,-4.309088160297033,-18.988999764416803,-36.55612610486324,-74737.48101313582,-53230.91219610675,12.0,0.0,12.0,112.5500490000004,3623.5999346666667,3641.1998693333335,3682.499836666667,3700.0997713333336,3582.2999673333334,3564.7000326666666,3523.4000653333333,-0.10356720118141924,-4028233.0,-1
2015-04-09,3639.0,3667.0,3625.0,3628.6999509999996,3513.955322,238584.0,3623.4099853,3630.196333345454,34.30004899999949,49.792200496193374,-3.521889717901213,-27.00188089811263,2.062848803321481,77776.4259764446,-47276.033183868676,8.0,0.0,12.000000000000004,117.6499019999992,3640.2333169999997,3655.4666339999994,3682.233317,3697.4666339999994,3613.4666339999994,3598.2333169999997,3571.4666339999994,0.08809407142856192,-3789649.0,+1
2015-04-10,3660.0,3688.350098,3633.399902,3659.1999509999996,3521.061768,201302.0,3630.5999755000003,3636.703599836363,71.8999019999992,56.205295594265564,-2.6882261191666093,-35.574043652242835,48.621281636057304,166254.6949710708,-37570.090988170195,4.0,64.0,12.0,157.5500490000004,3660.3166503333327,3687.2333986666654,3715.266846333333,3742.183594666665,3632.2832026666656,3605.366454333333,3577.333006666666,0.4695169604126543,-3588347.0,+1
2015-04-13,3661.0,3680.0,3642.75,3666.600098,3519.717285,218690.0,3635.7849853000002,3643.249076654545,51.85009799999989,57.71728172049898,-2.4859561788654516,-26.481041781003114,60.28923991273237,488414.45109674596,-13661.70269550582,0.0,60.0,12.0,78.35009799999989,3663.116699333333,3683.4833986666663,3700.3666993333336,3720.7333986666663,3646.2333986666663,3625.866699333333,3608.9833986666663,0.6402710872483192,-3369657.0,+1
2015-04-15,3655.0,3729.0,3650.399902,3665.1999509999996,3534.169678,232802.0,3646.1599853,3648.5972522363627,103.75,57.2855119828339,-2.5242267226942285,-15.900529924540933,102.84368809346601,298134.7131243294,510.8616690384252,72.0,56.00000000000001,12.0,72.0,3681.533284333333,3712.666666666666,3760.1333823333325,3791.266764666666,3634.066568666666,3602.933186333333,3555.4664706666663,0.1882955540335269,-3602459.0,-1
2015-04-16,3676.25,3718.6999509999996,3662.25,3680.25,3531.913086,206305.0,3653.1799803999997,3654.7954367272723,70.1999509999996,60.91212012310969,-2.1128602305475908,-9.94954602065718,106.4086708154731,-378637.98983421474,-16723.17704621438,68.0,52.0,12.0,58.89990200000011,3687.0666503333327,3711.8833006666655,3743.516601333333,3768.333251666665,3655.433349666666,3630.616699333333,3598.9833986666663,0.31886653010558197,-3396154.0,+1
2015-04-17,3666.149902,3682.899902,3636.350098,3677.899902,3502.047607,99056.0,3654.8749755,3659.2899679272723,16.94995100000051,59.9943545180952,-2.1770960061560793,4.100183175075472,54.350583120112184,-25905.634062309884,-17140.56145628101,64.0,48.0,8.0,67.10009799999989,3665.7166340000003,3695.083170000001,3712.2664380000006,3741.632974000001,3648.5333660000006,3619.16683,3601.9835620000003,0.8925881621327563,-3495210.0,-1
2015-04-20,3627.0,3648.399902,3584.600098,3646.8000490000004,3464.835693,175033.0,3649.8199705999996,3657.8217994727265,-50.55004899999949,48.773367208212434,-3.0271555265526993,11.174572030314266,-31.982494241293868,-1337127.3521838896,-77139.96106830487,60.0,44.0,-60.0,59.65014700000029,3626.6000163333338,3668.5999346666677,3690.399820333334,3732.399738666668,3604.8001306666674,3562.8002123333335,3541.000326666667,0.9749238571328572,-3670243.0,-1
2015-04-21,3605.0,3607.25,3470.0,3608.0500490000004,3351.615234,482786.0,3646.1549804000006,3650.227268272727,-36.6499019999992,38.43768426377142,-4.0863182954368265,8.988049261258311,-189.80629375924286,-1276551.947894403,-131658.68777127142,56.00000000000001,40.0,-60.0,37.25,3561.7666830000003,3653.5333660000006,3699.016683,3790.7833660000006,3516.2833660000006,3424.5166830000003,3379.0333660000006,1.0058291366120247,-4153029.0,-1
2015-04-22,3491.0500490000004,3508.100098,3386.100098,3490.149902,3325.4951170000004,422446.0,3632.2749755000004,3621.8627085636363,-138.8000489999995,22.040518380165224,-7.3089104541043355,-1.1116203537371803,-416.0309773032386,142300.56859324148,-119205.9942938228,52.0,96.0,15.999999999999993,78.60009799999989,3461.450032666666,3536.7999673333325,3583.4500326666666,3658.7999673333325,3414.7999673333325,3339.450032666666,3292.7999673333325,0.8528672459016412,-4575475.0,-1
2015-04-23,3490.0,3535.5500490000004,3480.0,3462.9499509999996,3355.7448729999996,234616.0,3618.5799804000007,3591.076340472727,-136.9499510000005,19.792899476731705,-8.052373045450738,-3.7493308326406805,-228.38826482532585,210033.8770071488,-104240.54559105755,48.0,96.0,16.0,56.4499509999996,3492.8333333333335,3505.666666666667,3548.3833823333334,3561.2167156666674,3450.1166176666666,3437.283284333333,3394.566568666666,-0.3069313044170362,-4810091.0,-1
2015-04-24,3486.0,3565.0,3434.100098,3494.4499509999996,3400.8312990000004,332449.0,3605.154980400001,3568.5072442181818,-134.25,29.41175876262622,-7.191376213970738,-6.120523677824622,-177.8476203581759,-486432.603096619,-121612.91184936216,44.0,92.0,16.0,46.54980400000022,3497.8500163333333,3561.5999346666667,3628.749918333334,3692.499836666667,3430.7000326666666,3366.950114333333,3299.8001306666665,0.46103818320658224,-4477642.0,+1
2015-04-27,3563.1999509999996,3684.0,3520.1999509999996,3541.399902,3503.5839840000003,1804129.0,3593.3749755,3556.9154117818184,-117.80004899999949,41.4810041238463,-5.168046776859501,-3.806228491069305,-42.771318559441575,-174375.9940982902,-124011.23377082906,40.0,88.0,16.0,93.29980400000022,3581.8666176666666,3643.5332843333335,3745.666666666667,3807.333333333334,3479.733235333333,3418.066568666666,3315.9331863333327,0.12942579156371595,-2673513.0,+1
2015-04-28,3664.0,3838.8000490000004,3660.0,3648.399902,3670.869629,1129937.0,3591.5549559,3566.9199438727273,-18.200195999999778,59.63145427421175,-5.091185210581302,-1.8943859966739183,123.96040100884893,457395.5638668531,-97583.65204886477,36.0,84.0,16.000000000000007,176.8000490000004,3715.733317,3771.4666340000003,3894.5333660000006,3950.2666830000007,3592.666585,3536.9332679999998,3413.8665359999995,-0.06487748781321566,-1543576.0,+1
2015-04-29,3839.0,3873.0,3746.649902,3822.600098,3616.7082520000004,703698.0,3607.294970600001,3608.9281515272723,157.4001470000003,74.49297196654325,-1.335450503444624,0.4378414990501369,214.1578817210328,545763.1231613243,-68340.6168002498,96.0,80.0,-44.0,221.9499510000005,3814.0833333333335,3881.516764666667,3940.433431333334,4007.8668626666667,3755.166666666667,3687.7332353333336,3628.816568666667,0.6011091182533143,-839878.0,+1
2015-04-30,3760.0,3793.0,3709.9499509999996,3766.1999509999996,3577.959717,592304.0,3615.8899657,3637.819966145454,85.9499509999996,65.48656125464987,-2.8298900105988447,-0.05586306947952835,114.96947882059952,-797774.0091938197,-101496.68010362468,96.0,76.0,-48.0,55.5500490000004,3756.3833006666664,3802.816650333333,3839.433349666667,3885.8666993333336,3719.766601333333,3673.333251666666,3636.7165523333324,0.6773024300081958,-1432182.0,-1
2015-05-04,3797.0,3840.0,3726.75,3725.850098,3608.593506,478823.0,3620.6849853000003,3657.812717472727,47.95019599999978,59.54387044106039,-3.899043508214099,-3.3406492869803515,105.69528816203173,-344339.392100598,-112534.98519845054,92.0,72.0,-48.0,130.8999020000001,3764.200032666666,3801.6500653333323,3877.4500326666657,3914.9000653333323,3688.4000653333323,3650.950032666666,3575.1500653333323,-0.007946154525387293,-1911005.0,-1
2015-05-05,3753.0,3805.0,3736.5500490000004,3757.75,3642.492676,458196.0,3631.7799804,3682.7336292363634,110.9499509999996,62.6368018660152,-3.0537890832008476,-10.005672248215888,95.11610451412429,323832.2703868836,-92700.10993761756,88.0,68.0,-48.0,189.5500490000004,3766.4333496666673,3796.316650333334,3834.8833006666673,3864.7666013333337,3727.8666993333345,3697.9833986666677,3659.416748333335,0.3097146263844619,-1452809.0,+1
2015-05-06,3788.0,3788.0,3623.5500490000004,3793.0500490000004,3490.283936,430929.0,3650.2799804000006,3712.0554598909093,185.0,65.95967334988664,-2.1184406730259564,-16.23563544552553,61.548664270334555,-82835.03860920698,-92251.69760435792,84.0,64.0,-48.0,297.4001470000003,3734.8666993333336,3846.183349666667,3899.316650333333,4010.6333006666664,3681.733398666667,3570.416748333334,3517.2834476666676,1.0307087291257413,-1021880.0,+1
2015-05-07,3626.0,3626.0,3520.0,3634.5500490000004,3402.943848,469950.0,3664.7199951000002,3709.1954723636363,144.4001470000003,45.15446504683125,-6.318228696343392,-20.615605773319658,-39.61509824561925,7656.345901437794,-87710.42289809829,80.0,60.0,16.0,224.6000979999999,3593.5166830000003,3667.0333660000006,3699.516683,3773.0333660000006,3561.0333660000006,3487.5166830000003,3455.0333660000006,1.0806608396226454,-1491830.0,-1
2015-05-08,3561.4499509999996,3620.0,3561.4499509999996,3543.600098,3467.236572,495595.0,3672.7850098000004,3687.1736728909095,80.65014700000029,37.353534905580275,-8.728137307896136,-25.49777526410344,-50.610930691742794,-61041.13793103448,-86498.182671953,76.0,56.00000000000001,20.0,112.65014700000029,3575.016683,3588.583415,3633.5667320000002,3647.1334640000005,3530.0333659999997,3516.4666339999994,3471.4833169999993,-0.30486486868695173,-1987425.0,-1
2015-05-11,3633.899902,3674.399902,3616.149902,3610.5500490000004,3506.7531740000004,288810.0,3684.3950196000005,3675.858225472727,116.1000980000008,45.36983392839646,-6.954158744038145,-9.00107553701855,-8.819087506508295,-53965.6854528922,-85019.43279792891,72.0,52.0,20.0,113.25,3633.699951,3651.25,3691.9499509999996,3709.5,3593.0,3575.449951,3534.75,-0.09613481545063883,-1698615.0,+1
2015-05-12,3650.0,3652.9499509999996,3555.0,3651.6999509999996,3435.4499509999996,332314.0,3695.4250245000003,3669.9136675454547,110.30004899999949,49.91501639678161,-5.863806279809231,17.310398689126032,-16.824849284753093,-77029.52855670042,-84656.25533231761,68.0,48.0,20.0,79.14990200000011,3619.8833006666664,3684.766601333333,3717.833251666666,3782.7165523333324,3586.816650333333,3521.933349666667,3488.8666993333336,0.9872383805480412,-1366301.0,+1
2015-05-13,3620.0,3632.0,3544.399902,3577.4499509999996,3461.042725,337505.0,3688.3300294,3648.463654181819,-70.94995100000051,42.54536976824348,-7.831214864864876,41.94086004277142,-39.47081913781882,-220654.17635435722,-90837.97901677707,64.0,44.0,20.0,164.4499509999996,3584.6166176666666,3624.833333333333,3672.2167156666665,3712.433431333333,3537.233235333333,3497.0165196666667,3449.6331373333333,0.3772832423086962,-1703806.0,-1
2015-05-14,3604.9499509999996,3653.5,3552.0,3604.100098,3501.759521,287801.0,3666.4800294000006,3633.1491212,-218.5,45.85604428168148,-7.125063645998943,59.284317972163535,-25.74336179901427,12661.3246726659,-86133.4652115205,60.0,40.0,20.0,273.0500490000004,3603.200032666666,3654.4000653333323,3704.7000326666657,3755.9000653333323,3552.9000653333323,3501.700032666666,3451.4000653333323,0.5133014581280777,-1416005.0,+1
2015-05-15,3640.0,3684.0,3626.0,3646.5,3525.4792479999996,208258.0,3654.5100343,3629.516388581818,-119.6999509999996,51.03551943347475,-6.001589825119237,62.97962538262709,14.142145763642711,-107494.0422358504,-87104.40053104285,56.00000000000001,36.0,19.999999999999993,73.1000980000008,3652.1666666666665,3678.333333333333,3710.166666666666,3736.333333333333,3620.333333333333,3594.1666666666665,3562.333333333333,0.35344827586206895,-1207747.0,+1
2015-05-18,3675.0,3706.399902,3652.0,3671.1999509999996,3550.8310549999997,183483.0,3649.0450196,3632.5509188909095,-54.65014700000029,53.99374828871508,-5.347113116057244,40.90365817785005,37.15534350699235,15997.50691872402,-82417.95019133607,52.0,32.0,20.0,130.79980400000022,3676.533284333333,3701.066568666666,3730.9331863333337,3755.4664706666663,3646.666666666666,3622.133382333333,3592.266764666666,0.3529409115479576,-1024264.0,+1
2015-05-19,3695.0,3729.899902,3685.0,3697.600098,3559.61792,175567.0,3643.0300294,3641.3791149636363,-60.14990200000011,57.18393108146372,-4.647586168521466,27.477343051509706,58.214917373722955,-71951.09482758622,-81942.1840383336,48.0,28.000000000000004,20.0,97.9499509999996,3704.1666666666665,3723.333333333333,3749.066568666667,3768.233235333333,3678.433431333333,3659.2667646666664,3633.533529333333,0.2806264031489391,-848697.0,+1
2015-05-20,3707.100098,3749.9499509999996,3707.0,3706.75,3564.563477,218115.0,3634.4000245000007,3652.964564163636,-86.3000490000004,58.33920320261534,-4.4051404345522,20.825546160641352,68.47192554635947,21683.837463328895,-77231.9103327226,44.0,24.0,20.0,107.30004899999949,3721.2333169999997,3735.4666339999994,3764.183267999999,3778.416584999999,3692.516683,3678.283366,3649.5667320000002,-0.005820728410144224,-630582.0,+1
2015-05-21,3711.899902,3729.899902,3691.4499509999996,3711.899902,3551.311279,198709.0,3642.1350098,3667.0554509818176,77.34985299999971,59.05665260390677,-3.4242207431168104,9.588467701437366,53.210565643417254,65216.54255406278,-70756.98065475155,40.0,20.0,20.0,101.5,3711.083251666667,3730.716552333334,3749.5332026666674,3769.1665033333347,3692.2666013333337,3672.6333006666664,3653.816650333333,0.5318589612767058,-431873.0,+1
2015-05-22,3703.0,3728.8000490000004,3694.600098,3698.100098,3555.584717,135158.0,3657.5850098,3677.230921563636,154.5,56.07110055973783,-3.793100828655443,-8.22082827701388,41.053500739793186,-289641.589003669,-80706.28103615309,36.0,16.0,20.000000000000007,79.89990200000011,3707.166748333333,3719.7333986666663,3741.3666993333336,3753.933349666667,3685.533447666666,3672.9667973333326,3651.3334966666653,0.10233932791307063,-567031.0,-1
2015-05-25,3696.1999509999996,3717.0,3681.0,3702.5500490000004,3546.173828,81113.0,3666.7850098,3685.406383236364,92.0,56.88214231061248,-2.7644347274689585,-3.9568500942796163,24.319283844841568,-467697.5695334855,-98296.79415288365,32.0,12.0,20.0,59.89990200000011,3700.1833496666673,3719.3666993333345,3736.1833496666677,3755.3666993333345,3683.3666993333345,3664.1833496666673,3647.3666993333345,0.5986124722222333,-485918.0,+1
2015-05-26,3696.0,3730.0,3672.0,3692.75,3578.535889,252919.0,3670.8900147000004,3690.1272905454543,41.0500490000004,54.333092969817955,-2.5820005421523446,13.287554898934559,16.879642506952845,288779.99690380157,-80702.39455632797,28.000000000000004,8.0,19.999999999999996,58.69995100000051,3698.25,3724.5,3756.25,3782.5,3666.5,3640.25,3608.5,0.3577586206896552,-738837.0,-1
2015-05-27,3700.0,3750.0,3699.0,3726.4499509999996,3574.166504,283565.0,3685.7900147,3700.2290971454545,149.0,61.22720498559212,-0.645030101342109,21.421996279245832,62.26191539531428,370810.37604117737,-60179.08679847764,24.0,4.0,20.0,52.34985299999971,3725.1499836666662,3751.2999673333325,3776.1499836666662,3802.2999673333325,3700.2999673333325,3674.1499836666662,3649.2999673333325,0.5382343333333255,-455272.0,+1
2015-05-28,3726.0,3738.9499509999996,3696.0500490000004,3721.899902,3561.6823729999996,317937.0,3697.5699951,3706.7945312,117.79980400000022,59.82031498243021,-0.7696548342919718,21.950993252690296,61.86581321788587,-16460.55472133568,-58191.88079465525,20.0,0.0,20.0,38.44995100000051,3718.9666340000003,3741.8832190000003,3761.8665359999995,3784.7831209999995,3698.983317000001,3676.066732000001,3656.083415000002,0.6025620524727584,-773209.0,-1
2015-05-29,3720.0,3788.9499509999996,3693.0500490000004,3708.899902,3635.4343259999996,432656.0,3703.8099853000003,3708.854514272727,62.39990200000011,55.60793389749533,-2.169407446252907,25.604937466307092,88.90114988648715,-35282.2929852052,-57150.53589406767,16.0,4.0,20.0,34.19995100000051,3730.299967333334,3767.5498856666673,3826.1998693333326,3863.4497876666665,3671.649983666668,3634.4000653333346,3575.750081666669,0.16527496555731458,-1205865.0,-1
2015-06-01,3785.899902,3898.9499509999996,3774.399902,3785.6999509999996,3728.728027,571376.0,3715.2599853000006,3723.7435989454543,114.5,70.00544524802285,-2.980302410830358,26.66331334208735,229.1170451781038,-5659.171812026456,-54810.01934454493,12.0,0.0,20.0,36.0,3819.6832679999993,3864.9666339999985,3944.2333169999993,3989.516682999998,3740.416584999999,3695.133219,3615.8665359999995,0.09072697353976582,-634489.0,+1
2015-06-02,3880.0,3887.3000490000004,3815.0500490000004,3882.850098,3679.320068,329350.0,3733.7849853000002,3754.2145285272727,185.25,79.64238041727144,-0.4236859223833423,27.064186280843842,243.184559526691,181639.89346451036,-44062.296033556275,96.0,28.000000000000004,20.000000000000004,58.0,3861.733398666667,3908.416748333334,3933.983398666667,3980.666748333334,3836.166748333334,3789.483398666667,3763.916748333334,0.9384089826989549,-305139.0,+1
2015-06-03,3805.0,3820.0,3752.0,3831.399902,3627.271729,277700.0,3746.2499755,3771.9626952000003,124.64990200000011,66.57221703607766,-1.7776562815576804,26.4618804279944,130.45537893135372,-255440.69505081026,-53670.40508106327,92.0,24.0,20.0,57.25,3801.133300666667,3850.2666013333337,3869.1333006666664,3918.2666013333337,3782.2666013333337,3733.133300666667,3714.2666013333337,1.1676456176470604,-582839.0,-1
2015-06-04,3799.0,3813.0,3747.0,3777.1999509999996,3622.326172,193996.0,3752.7799804000006,3777.5899634727266,65.30004899999949,55.50095759995522,-3.2039895674931222,28.048443866760408,84.82176425699099,38293.33259322145,-49490.23518625093,88.0,20.0,20.0,42.8999019999992,3779.0666503333327,3811.1333006666655,3845.0666503333323,3877.1333006666655,3745.1333006666655,3713.0666503333327,3679.1333006666655,0.4575750151515091,-776835.0,-1
2015-06-05,3769.0,3799.899902,3751.0,3772.0500490000004,3610.226074,253728.0,3760.1749755,3781.0936123090914,73.94995100000051,54.507142929369095,-3.3395150893133225,39.60763203088527,64.24144142141127,-139021.61997902457,-53559.843586411895,84.0,16.0,12.0,95.8999019999992,3774.3166503333337,3797.6333006666673,3823.2165523333333,3846.5332026666674,3748.733398666667,3725.4167483333335,3699.833496666667,0.4304722123983061,-1030563.0,-1
2015-06-08,3786.0,3804.5500490000004,3716.0,3759.4499509999996,3575.703125,303682.0,3765.8649657,3780.9617896727273,56.8999019999992,51.88434903329169,-3.67110098287713,47.3206161665662,42.2408245142535,-141286.1148146539,-57547.40136997157,80.0,12.0,12.0,190.0500489999995,3760.0,3804.0,3848.5500490000004,3892.5500490000004,3715.4499509999996,3671.4499509999996,3626.899901999999,0.49068240493011367,-1334245.0,-1
2015-06-09,3710.0,3726.9499509999996,3675.8000490000004,3723.5,3545.741455,209963.0,3768.9399657000004,3773.2590686363637,30.75,44.78927311629457,-4.617164785389554,54.11209866948775,-13.350686826235135,-71050.11736608035,-58161.16118804378,76.0,8.0,68.0,101.6000980000008,3708.75,3741.6999509999996,3759.899901999999,3792.849852999999,3690.5500490000004,3657.600098000001,3639.400147000001,0.9325521483892647,-1544208.0,-1
2015-06-10,3702.9499509999996,3748.899902,3694.149902,3692.3000490000004,3593.9968259999996,239272.0,3765.5249755,3759.324538327273,-34.1499019999992,39.39464641886602,-5.43822694153161,62.05063511499793,-17.912711868276173,-354024.5422985957,-71609.49669447554,72.0,4.0,68.0,130.8500979999999,3711.783284333333,3729.416666666666,3766.5332843333335,3784.166666666666,3674.666666666666,3657.033284333333,3619.916666666666,-0.03378726940638743,-1783480.0,-1
2015-06-11,3752.0500490000004,3778.9499509999996,3691.350098,3742.5500490000004,3554.480225,226654.0,3767.5899902,3755.1472789636364,20.65014700000029,50.47892656927876,-4.115841103613505,75.45574734107595,3.008194922492334,-251559.23923449317,-79789.03044711119,68.0,0.0,68.0,84.39990200000011,3737.616699333333,3783.8833006666664,3825.2165523333324,3871.483153666666,3696.2834476666667,3650.0168463333334,3608.683594666667,0.5844753072816307,-1556826.0,+1
2015-06-12,3701.100098,3755.0,3695.5,3701.399902,3588.475342,173412.0,3766.8399902,3743.1127174727276,-7.5,43.04085100933727,-5.198753971694074,73.95102356733241,-24.742980505427127,-315651.84433325793,-90510.06744295782,64.0,12.0,68.0,48.89990200000011,3717.299967333334,3739.0999346666677,3776.7999673333343,3798.5999346666677,3679.5999346666677,3657.799967333334,3620.0999346666677,0.09915801680672455,-1730238.0,-1
2015-06-15,3737.5,3789.899902,3731.0,3736.8000490000004,3617.860596,175936.0,3761.9500000000007,3737.6509099818186,-48.8999019999992,50.30879518336201,-4.267158886061845,68.32221610145689,12.4462470916631,-435810.04442363424,-106205.52094350733,60.0,8.0,68.0,88.5500490000004,3752.5666503333337,3774.1333006666673,3811.4665523333333,3833.0332026666674,3715.233398666667,3693.6667483333335,3656.333496666667,0.098472982179162,-1554302.0,+1
2015-06-16,3767.399902,3810.5500490000004,3744.6999509999996,3767.399902,3639.179443,228783.0,3750.404980400001,3738.6418012545455,-115.45019599999978,55.91880511850151,-3.4618889905479047,69.5935481443853,33.91393753574336,-101729.76187463703,-106002.0773494501,56.00000000000001,4.0,68.0,83.6499019999992,3774.2166340000003,3803.733317000001,3840.066732000001,3869.583415000002,3737.8832190000003,3708.3665359999995,3672.0331209999995,0.34472159783270534,-1325519.0,+1
2015-06-17,3805.0,3824.899902,3793.0,3789.600098,3657.569336,291820.0,3746.225000000001,3745.7681862727272,-41.79980400000022,59.725112161296835,-2.877665611654255,63.53723672467913,63.293169600877505,73047.7890734347,-97863.44705682617,52.0,0.0,68.0,54.75,3802.5,3812.0,3834.399902,3843.899902,3780.100098,3770.600098,3748.200196,-0.1065803274254604,-1033699.0,+1
2015-06-18,3813.0,3891.9499509999996,3812.0,3808.75,3707.8413090000004,232645.0,3749.3800049000006,3757.1363680909094,31.5500490000004,62.91250515142867,-2.3737141847424192,39.07811129846914,95.67858288668218,-34870.53115567013,-95000.13269745617,48.0,0.0,68.0,87.59985299999971,3837.5666503333327,3863.1333006666655,3917.516601333333,3943.083251666665,3783.183349666666,3757.616699333333,3703.2333986666663,-0.04065043141802571,-801054.0,+1
2015-06-19,3879.0,3949.5,3862.0,3861.100098,3781.064697,309290.0,3758.285009800001,3777.449112290909,89.05004899999949,70.32126489053934,-2.295803194390342,23.276643479371614,141.61275833673076,-84196.51273965003,-94509.05906297333,44.0,0.0,52.0,59.5,3890.866699333333,3919.7333986666663,3978.3666993333336,4007.2333986666663,3832.2333986666663,3803.366699333333,3744.7333986666663,-0.010284594285715555,-491764.0,+1
2015-06-22,3955.0500490000004,3994.899902,3955.0500490000004,3937.350098,3822.645996,230791.0,3776.075024500001,3810.006401054545,177.9001470000003,77.78086331428581,-1.4771889793794866,18.957909480110175,209.99131894696055,814477.1320361117,-53191.50491912711,96.0,0.0,52.0,88.5,3962.4333496666673,3969.816650333334,4002.2832026666665,4009.666503333334,3929.9667973333344,3922.5834966666675,3890.1169443333347,-0.44416602992238485,-260973.0,+1
2015-06-23,3982.0,4028.5,3955.3000490000004,3980.649902,3857.6972659999997,330957.0,3801.7900147000005,3847.2018333272727,257.1499020000001,80.92268355799823,-1.2177146710777424,18.187543096202717,219.81322419229355,-267387.8455207723,-62927.7022198719,96.0,20.0,52.00000000000001,73.75,3988.1499836666667,4020.999918333333,4061.349934666666,4094.1998693333326,3947.7999673333334,3914.950032666667,3874.6000163333338,0.34630969903244674,69984.0,+1
2015-06-24,4024.0,4035.649902,3987.0500490000004,4017.149902,3850.1586909999996,306048.0,3834.275000000001,3886.358176472727,324.8498529999997,83.22922903441236,-0.4699427294919252,22.292565838100018,210.05900336670706,-412584.39596484386,-78821.18830023282,96.0,16.0,52.0,57.5,4013.283284333333,4039.5165196666658,4061.8831373333333,4088.1163726666655,3990.916666666666,3964.6834313333334,3942.3168136666663,0.619340412408241,376032.0,+1
2015-06-25,3984.0,4043.6999509999996,3983.600098,4009.3000490000004,3871.477539,240888.0,3860.9500000000007,3918.180912654545,266.75,80.80485968396017,-0.8720537031283879,32.824322918194866,170.18758646679552,157808.63352621428,-68065.28730744717,96.0,12.0,48.0,102.34985299999971,4012.200032666666,4040.7999673333325,4072.2998856666663,4100.899820333332,3980.7001143333327,3952.1001796666665,3920.600261333333,0.4276208628996253,135144.0,-1
2015-06-26,4026.0,4077.399902,4006.149902,4031.5,3908.4013670000004,291925.0,3893.9600098000005,3949.1900035636363,330.1000979999999,82.47102410222399,-1.1537277078889319,50.217250182853604,160.26649339040986,-67081.47818999446,-68020.56871119664,96.0,8.0,44.0,140.75,4038.3499346666667,4070.5499673333334,4109.599934666667,4141.799967333333,3999.2999673333334,3967.0999346666667,3928.0499673333334,0.35579084912280545,427069.0,+1
2015-06-29,4020.0,4025.75,3961.100098,4069.9499509999996,3834.7937009999996,344044.0,3927.275,3981.18817469091,333.1499019999992,85.06224063074258,-0.18725998349877573,62.70466874428439,120.54158961160175,197239.51172090461,-55963.29232723046,96.0,4.0,96.0,133.79980400000022,4018.9333496666663,4076.766601333333,4083.583251666666,4141.416503333333,4012.1166993333327,3954.2834476666662,3947.4667973333326,1.683681639610212,771113.0,+1
2015-06-30,3985.25,4060.0,3985.25,3993.3000490000004,3863.6513670000004,340789.0,3949.8650147000003,3993.1927290545455,225.9001470000003,63.47809857065135,-2.1139114988848027,81.21237198676772,99.14572655141528,98188.16123538234,-48956.40807400231,92.0,0.0,76.0,91.14990200000011,4012.8500163333338,4040.4500326666675,4087.6000163333338,4115.2000326666675,3965.7000326666675,3938.1000163333338,3890.9500326666675,0.10769296321070768,430324.0,-1
2015-07-01,4034.899902,4089.850098,4026.0,4023.350098,3871.6694340000004,380963.0,3973.2400147000003,4006.553653290909,233.75,67.23857012658114,-1.6663116470680326,97.11704668832499,102.71452956595634,278002.23447483964,-34094.65159373585,88.0,36.0,80.0,55.0,4046.4000653333333,4066.8001306666665,4110.250163333333,4130.650228666666,4002.9500326666666,3982.5499673333334,3939.0999346666667,-0.041501925337688844,811287.0,+1
2015-07-02,4031.5,4049.0,3981.149902,4031.6999509999996,3834.889893,322025.0,3995.5350098,4017.182732618182,222.9499509999996,68.28552510202299,-1.4570867251852437,113.13674671074023,73.11511676765222,5200.94061071485,-32308.48831162661,96.0,32.0,84.0,60.09985299999971,4020.6166176666666,4060.083333333333,4088.4667156666665,4127.933431333333,3992.233235333333,3952.7665196666667,3924.3831373333333,0.7450254382830748,1133312.0,+1
2015-07-03,3993.399902,4020.0,3977.100098,3993.399902,3840.171387,279389.0,4008.7649902000003,4016.7945311999997,132.29980400000022,58.40687634923414,-2.416783232432996,126.78764960059061,51.63988076449187,-41111.49093108754,-32708.624794348358,92.0,28.000000000000004,88.0,71.25,3996.8333333333335,4016.566568666667,4039.733235333334,4059.466470666667,3973.666666666667,3953.9334313333334,3930.766764666667,0.37994967913913136,853923.0,-1
2015-07-06,3984.899902,4005.0,3975.0500490000004,3998.899902,3829.65625,332811.0,4014.919970600001,4015.0008787999996,61.54980400000022,59.38055170406238,-2.278967983427369,138.87156104166434,42.040644147257225,-372740.83298807923,-48164.634258399536,88.0,24.0,92.0,70.39990200000011,3992.983317,4010.916585,4022.9332679999998,4040.8665359999995,3980.9666340000003,3963.0333660000006,3951.0166830000007,0.7963236066730136,1186734.0,+1
2015-07-07,3989.0,4003.8000490000004,3955.6999509999996,3987.9499509999996,3814.483398,287981.0,4015.6499755000004,4010.0972388727273,7.30004899999949,56.350249930904724,-2.553344387730002,149.7989055616099,29.96308710001801,-55633.44269760989,-48504.125551105586,84.0,20.0,92.0,84.6999509999996,3982.4833169999997,4009.266683,4030.583415,4057.3667810000006,3961.166584999999,3934.383218999999,3913.0664869999982,0.6704768044339424,898753.0,-1
2015-07-08,3950.0,3969.0,3907.0,3972.149902,3792.2524409999996,252360.0,4011.1499755000004,4002.1881345999996,-45.0,51.93742937980136,-2.9492512399547355,156.94275940540547,9.777601499427863,-757479.6123529546,-80730.28404342814,80.0,16.0,52.0,96.55004899999949,3949.383300666667,3991.7666013333337,4011.3833006666664,4053.7666013333337,3929.7666013333337,3887.383300666667,3867.7666013333337,1.0508048709677438,646393.0,-1
2015-07-09,3950.0,3967.899902,3928.5,3949.0,3779.432129,128065.0,4005.1199706,3990.8881390545453,-60.3000490000004,45.86527194498355,-3.5293256960612576,154.75839744936366,4.823221537547791,-394497.34539988026,-94992.42319655576,76.0,12.0,64.0,67.85009799999989,3948.4666340000003,3968.4332680000007,3987.8665360000005,4007.833170000001,3929.0333660000006,3909.0667320000002,3889.6334640000005,0.5203058626897078,518328.0,-1
2015-07-10,3949.6999509999996,3962.0,3918.899902,3935.649902,3778.231689,184572.0,3995.5349608000006,3978.257217490909,-95.85009799999989,42.55476875257535,-3.863843346992077,143.56227142362968,-4.917572065194452,-136587.50749820683,-96883.10884670187,72.0,8.0,64.0,54.59985299999971,3938.8499346666667,3958.7999673333334,3981.9500326666666,4001.9000653333333,3915.6998693333335,3895.749836666667,3872.5997713333336,0.3886302068269089,333756.0,-1
2015-07-13,3958.6999509999996,4040.0,3940.0,3934.399902,3875.078857,335198.0,3981.9799559000003,3967.1417522545453,-135.5500489999995,42.22549414205919,-3.895164994493356,132.43871441858664,6.140599916443977,21184.352368921467,-91516.40606398099,68.0,4.0,64.0,29.9499509999996,3971.4666340000003,4002.9332680000007,4071.4666340000003,4102.933268000001,3902.9332680000007,3871.4666340000003,3802.9332680000007,-0.05600097999999889,-1442.0,-1
2015-07-14,4049.6999509999996,4058.9499509999996,4020.149902,4035.25,3889.867432,251002.0,3986.1749510000004,3976.827214818182,41.9499509999996,66.41637880479264,-1.36813201847302,119.28632877799646,38.68334018766505,42843.904988407405,-85409.11919775417,64.0,0.0,64.0,48.1000980000008,4038.1166176666666,4056.083333333333,4076.916666666666,4094.8833823333325,4017.2832843333335,3999.316568666667,3978.483235333334,0.3891772920183706,249560.0,+1
2015-07-15,4071.0,4179.950195,4071.0,4050.649902,3987.338379,551469.0,3988.9049314000004,3988.5499331818182,27.299804000000222,68.72376118086441,-3.168386939846009,98.08430468787128,73.59759669490303,-128294.79890252413,-87358.46827530744,60.0,4.0,64.0,80.9499509999996,4100.533365666667,4130.066731333334,4209.4835606666675,4239.016926333335,4021.116536333334,3991.583170666667,3912.1663413333335,-0.18678349313647236,801029.0,+1
2015-07-16,4166.0,4190.0,4156.0,4152.149902,4012.306885,321651.0,4000.949926500001,4018.230836927273,120.44995100000051,79.45734274033255,-0.9252040576876043,87.25081687773445,111.82393234146636,-246496.3472460833,-94592.00822875026,96.0,0.0,64.0,43.64990200000011,4166.049967333333,4176.099934666667,4200.0499673333325,4210.099934666667,4142.099934666667,4132.049967333333,4108.099934666667,-0.11323817647058497,1122680.0,+1
2015-07-17,4186.0,4228.950195,4164.100098,4178.149902,4026.5668950000004,241023.0,4019.4249265000003,4050.449014290909,184.75,81.34917805627836,-1.2300461410285901,75.93357768335454,121.88833433377285,3201.8994572352553,-90146.8306065276,96.0,0.0,64.0,43.10009799999989,4190.400065000001,4216.700032000002,4255.250162000001,4281.550129000002,4151.849935000001,4125.549968,4086.9998380000006,0.21665047008333885,1363703.0,+1
2015-07-20,4208.0,4219.0,4161.100098,4193.0,4010.289551,207897.0,4038.8349363,4082.0081185636363,194.1000979999999,82.41636208884061,-0.8704752673173664,61.039433948116766,114.26352153258522,177107.38073855708,-77998.91190867835,96.0,0.0,64.0,104.35009799999989,4191.033366,4220.966633999999,4248.933268,4278.8665359999995,4163.066731999999,4133.133464,4105.166829999999,0.550949153592696,1571600.0,+1
2015-07-21,4176.950195,4194.950195,4141.450195,4176.049805,3988.0104979999996,146004.0,4057.644921700001,4106.9562765090905,188.09985400000005,76.64079504203775,-1.2808965605455853,53.12026358597495,93.1817705566142,-388967.263066923,-92133.83696170946,92.0,0.0,64.0,124.55004899999949,4170.816731666667,4200.183268333333,4224.316731666667,4253.683268333333,4146.683268333333,4117.316731666667,4093.183268333333,0.6467216822429777,1425596.0,-1
2015-07-22,4139.799805,4199.0,4134.0,4152.850098,4024.790527,305466.0,4075.7149413000006,4124.266308563637,180.70019599999978,69.00399954696908,-1.8426395817589383,46.00170421969506,84.71495104420245,-514223.9834106411,-111319.75270988522,88.0,0.0,56.0,144.70019500000035,4161.950032666667,4189.900065333333,4226.9500326666675,4254.900065333333,4124.900065333333,4096.950032666667,4059.9000653333333,0.290001507692306,1120130.0,-1
2015-07-23,4198.899902,4245.5,4193.049805,4191.149902,4065.987793,229845.0,4099.9299315,4145.254483236364,242.1499020000001,73.948724214537,-1.3107463644037114,43.08369040744583,115.34917994887823,-411461.25071368495,-124962.54807403167,84.0,0.0,96.0,139.3500979999999,4209.899902333334,4226.7499996666675,4262.350097333335,4279.200194666668,4174.299804666667,4157.449707333333,4121.849609666667,-0.036222992116607525,1349975.0,+1
2015-07-24,4237.950195,4261.899902,4205.399902,4234.049805,4066.132324,226189.0,4129.769921800001,4169.639914781818,298.39990299999954,78.40181354405811,-0.6690071261771228,45.39507025532703,121.4996628914302,-199872.31037473917,-128367.53726959875,96.0,0.0,96.0,76.80029300000024,4233.783203,4262.166504,4290.283203,4318.666504,4205.666504,4177.283203,4149.166504,0.5070779292035317,1576164.0,+1
2015-07-27,4241.549805,4241.549805,4166.600098,4234.200195,4012.258789,220316.0,4159.7499511000005,4188.627237181818,299.80029300000024,78.41673667933618,-0.6653945002783246,55.50242122512145,94.47949850317825,-904565.4908767757,-163649.2624343563,96.0,48.0,96.0,57.89990200000011,4214.116699333333,4261.6333006666655,4289.066406333332,4336.583007666665,4186.683593666666,4139.166992333333,4111.733886666666,0.9019394432055708,1796480.0,+1
2015-07-28,4207.899902,4242.0,4151.600098,4178.100098,4030.36084,940179.0,4174.0349609,4191.963627527273,142.8500979999999,60.44162869854035,-2.0130151090046606,72.65836185986973,68.59862773435384,-83246.86349412793,-159994.60793699458,92.0,44.0,92.0,53.5,4190.566731999999,4229.533365999999,4280.966633999999,4319.933267999999,4139.133463999999,4100.166829999999,4048.7335619999985,0.29314191070693824,856301.0,-1
2015-07-29,4224.899902,4309.5,4171.200195,4196.950195,4104.064453,819323.0,4188.664990200001,4196.130033727273,146.30029300000024,63.67029047535466,-2.6730745754660883,95.35900639835882,81.12588424689348,-92091.86492550831,-156908.1196182273,88.0,40.0,88.0,65.0,4225.8834633333345,4280.566731666669,4364.183268333335,4418.866536666668,4142.266926666669,4087.583658333335,4003.9671216666693,0.18618970576278154,1675624.0,+1
2015-07-30,4310.0,4318.0,4281.049805,4273.700195,4125.910645,294361.0,4200.8200195,4211.590980054546,121.55029300000024,73.73957481513881,-1.0500072292012241,110.46171837611428,104.62551245382727,133038.627157419,-143728.72203725783,96.0,36.0,84.0,92.64990200000011,4290.916666666667,4300.783528333334,4327.866861666668,4337.733723333335,4263.833333333334,4253.966471666667,4226.883138333334,-0.19890585151172363,1969985.0,+1
2015-07-31,4297.0,4359.0,4284.200195,4296.450195,4159.521973,297226.0,4212.6500488,4228.978284690909,118.30029300000024,76.01339628607299,-1.4683052816901325,125.27947227700952,97.9652690519807,22340.289737423067,-136180.13059281296,96.0,32.0,96.0,70.75,4313.2167966666675,4342.233398333335,4388.016601666667,4417.033203333334,4267.433593333335,4238.416991666668,4192.633788333335,0.16377048041769704,2267211.0,+1
2015-08-03,4380.0,4439.0,4380.0,4331.450195,4251.32666,341893.0,4226.495068300001,4250.578311272728,138.45019500000035,79.20907411692725,-2.478106105990775,129.7300183060761,113.09507021000569,-187621.68189615625,-138518.38292482487,96.0,28.000000000000004,48.0,74.94970699999976,4383.483398333334,4386.9667966666675,4442.483398333334,4445.9667966666675,4327.9667966666675,4324.483398333334,4268.9667966666675,-0.8228780508474517,2609104.0,+1
2015-08-04,4449.0,4453.950195,4411.450195,4427.049805,4262.61084,313075.0,4251.5950683,4287.042808854546,251.0,85.35731557792636,-0.6176968460141183,136.222568791884,114.70610818335274,-14933.561344864524,-132900.8910347309,96.0,24.0,48.0,90.39990200000011,4430.816731666667,4450.183268333333,4473.316731666667,4492.683268333333,4407.683268333333,4388.316731666667,4365.183268333333,0.3670496470588071,2922179.0,+1
2015-08-05,4457.0,4484.0,4422.25,4438.799805,4294.156738000001,198485.0,4280.190039000001,4321.080033709091,285.94970699999976,85.94668228953572,-1.030791220068423,137.12069479513684,104.13283231318073,0.0,-126859.94144214486,96.0,20.0,48.0,138.29980499999965,4448.349934999999,4474.449869999999,4510.099934999998,4536.199869999999,4412.699869999999,4386.599934999999,4350.949869999999,0.26801303643724134,3120664.0,+1
2015-08-06,4461.0,4478.350098,4430.049805,4471.649902,4275.382813,184121.0,4308.240039000001,4355.890917890909,280.5,87.56168464435103,-0.28164419612314456,144.02487980017304,94.57724364797427,157684.18222672355,-113926.11763881362,96.0,16.0,60.0,121.04980499999965,4460.016601666666,4489.983398333333,4508.316894666666,4538.283691333333,4441.683105333333,4411.716308666666,4393.382812333332,0.8612804274292964,3304785.0,+1
2015-08-07,4450.700195,4468.200195,4430.100098,4452.100098,4276.199707,144268.0,4330.045068300001,4382.047292254545,218.05029300000024,81.15732547767551,-0.7274778107183606,155.64636503030306,78.44142006008762,-172762.0978870664,-116600.4803774102,92.0,12.0,64.0,85.29980499999965,4450.133463666666,4470.166829333332,4488.233560666667,4508.266926333333,4432.066732333332,4412.033366666666,4393.966635333331,0.5774263514342164,3160517.0,-1
2015-08-10,4470.0,4507.950195,4446.0,4452.950195,4318.644531,241899.0,4351.9200683,4404.393678927273,218.75,81.22622040855371,-1.2474624925991027,161.1797537975217,74.71809346701548,68621.06796116504,-108181.31908917401,88.0,8.0,68.0,142.54980499999965,4468.9667966666675,4491.933593333335,4530.916991666669,4553.883788333335,4429.983398333335,4407.016601666667,4368.033203333334,0.11219004233966189,3402416.0,+1
2015-08-11,4510.0,4534.0,4465.049805,4497.149902,4325.510254,216773.0,4383.8250487000005,4430.799103236363,319.0498040000002,84.60349060358479,-0.8308928523111587,163.4313873750034,75.09064485792663,-129948.71832830465,-109170.74632732966,96.0,4.0,72.0,122.5,4498.733235666667,4532.4166663333335,4567.683430666667,4601.366861333334,4463.466471333333,4429.783040666666,4394.516276333333,0.46555483998269037,3619189.0,+1
2015-08-12,4504.299805,4504.299805,4504.299805,4504.299805,4325.510254,0.0,4414.560009700001,4452.703604381818,307.3496099999993,85.10366581620349,-0.66967745208569,166.28947884137415,67.38363775764584,-77512.01063717331,-107731.71288684946,96.0,0.0,76.0,61.75,4504.299805,4504.299805,4504.299805,4504.299805,4504.299805,4504.299805,4504.299805,,3619189.0,+1
2015-08-13,4477.0,4522.700195,4430.149902,4504.299805,4314.515625,261773.0,4437.6199707000005,4469.019930799999,230.5996099999993,85.10366581620349,-0.66967745208569,177.46588719245392,54.54248835761885,153411.04250203024,-95861.5876417543,92.0,4.0,80.0,48.30029300000024,4485.716634,4541.283366000001,4578.2669270000015,4633.833659000001,4448.733073,4393.166341,4356.18278,0.8011849622129165,3619189.0,-1
2015-08-14,4509.5,4589.0,4490.5,4492.850098,4391.003906,181419.0,4457.259961000001,4479.061772127272,196.39990299999954,79.59109228328307,-2.1414232071269512,186.34680966682936,62.12721526226701,459040.42113045236,-70638.76906090316,88.0,0.0,80.0,41.54980400000022,4524.116699333333,4557.733398666665,4622.616699333332,4656.233398666665,4459.233398666665,4425.616699333333,4360.733398666665,0.02385886294416131,3437770.0,-1
2015-08-17,4584.950195,4587.0,4535.5,4572.5,4369.204102000001,157066.0,4481.3649415,4500.014506490908,241.04980499999965,86.57246897721114,-0.3674832962138085,187.49818206572672,68.62150846091424,1803102.5463312017,14531.290730602102,96.0,0.0,80.0,61.95019500000035,4565.0,4594.5,4616.5,4646.0,4543.0,4513.5,4491.5,0.7184466019417476,3594836.0,+1
2015-08-18,4555.0,4648.0,4536.0,4549.799805,4450.062988000001,172443.0,4493.6399415000005,4512.457208945455,122.75,77.81865562211604,-2.1587204880193522,186.23504713549846,63.84263070719683,156610.9354138257,20989.456398090482,92.0,0.0,92.0,81.04980499999965,4577.933268333333,4619.866536666666,4689.933268333334,4731.866536666666,4507.866536666666,4465.933268333333,4395.866536666666,0.12321254464285403,3422393.0,-1
2015-08-19,4627.0,4687.0,4605.700195,4634.0,4486.409668,255128.0,4513.159960999999,4537.977219581819,195.20019500000035,84.51847003703789,-1.1551874455100262,189.81178746463593,75.25894354092597,127551.46505346113,25833.184064293182,96.0,0.0,96.0,7.14990299999954,4642.233398333334,4678.766601666667,4723.533203333333,4760.066406666667,4597.4667966666675,4560.933593333334,4516.166991666668,0.34809191731763406,3677521.0,+1
2015-08-20,4630.0,4692.399902,4601.25,4671.850098,4450.207031,279387.0,4533.1799806,4566.829971763636,200.20019599999978,86.61539247585213,-0.4473767675018386,183.22837294783403,70.98862008184345,-410341.75178384664,6007.050616457106,96.0,16.0,88.0,92.55029300000024,4655.166666666667,4709.083333333334,4746.316568666667,4800.233235333334,4617.933431333334,4564.016764666667,4526.783529333334,0.7745493571677105,3956908.0,+1
2015-08-21,4611.0,4613.850098,4529.0,4634.149902,4386.058105,310480.0,4551.384961000001,4585.188139290909,182.04980400000022,74.94848265937671,-1.268123856898188,181.06169903596765,45.159690328839496,-189464.2735042735,-2878.0095709315437,96.0,12.0,88.0,98.5,4592.333333333333,4655.666666666666,4677.183431333333,4740.516764666666,4570.816568666666,4507.483235333333,4485.966470666666,1.2392431414752196,3646428.0,-1
2015-08-24,4350.0,4452.549805,4207.549805,4567.350098,4073.429932,930804.0,4562.8249513,4588.090891472728,114.39990299999954,58.76537971421646,-2.7223800815938675,174.84986030810705,-14.88375825662366,119608.99396822242,2689.5814990794734,92.0,8.0,96.0,94.14990200000011,4409.149902666667,4610.750000333334,4654.149902666667,4855.750000333334,4365.750000333334,4164.149902666667,4120.750000333334,1.468572624489797,2715624.0,-1
2015-08-25,4299.0,4369.0,4062.100098,4241.799805,4032.329102,915511.0,4537.2899416,4529.722683054545,-255.35009700000046,26.540246774250207,-9.809729320623834,164.19900204343958,-80.31459554864362,350590.99295257364,18503.282019826976,88.0,4.0,92.0,112.0,4224.299967666666,4386.499837333332,4531.199869666666,4693.399739333332,4079.599935333332,3917.400065666666,3772.7000333333317,0.5855319790880862,1800113.0,-1
2015-08-26,4197.0,4256.399902,4111.399902,4199.0,4064.25708,612412.0,4506.7599611,4468.215420945455,-305.29980499999965,24.502045280295818,-10.741496767681172,150.646638030159,-92.68346322457096,112547.54725463045,22778.021348716287,84.0,96.0,96.0,137.20019500000035,4188.933268,4266.466633999999,4333.933268,4411.466633999999,4121.466633999999,4043.9332679999998,3976.4666339999994,0.604138606896551,1187701.0,-1
2015-08-27,4255.0,4272.899902,4186.0,4207.049805,4061.069092,795947.0,4477.0349611,4413.7226652909085,-297.25,25.739674302809703,-10.56624956143434,128.64611607171173,-79.31628769588431,-599029.1763120614,-5485.942181537498,80.0,92.0,80.0,91.14990200000011,4221.983235666667,4257.966471333333,4308.883137666668,4344.866373333333,4171.066569333333,4135.0833336666665,4084.166667333333,0.24223048030594585,1983648.0,+1
2015-08-28,4250.0,4292.0,4175.0,4203.75,4063.0981450000004,372560.0,4448.1249513,4364.034490545455,-289.1000979999999,25.541633449247286,-10.638087526131535,106.3987665952136,-76.59365010736823,341502.2612074805,10286.248881716036,76.0,88.0,84.0,142.8500979999999,4223.583333333333,4272.166666666666,4340.583333333332,4389.166666666666,4155.166666666666,4106.583333333333,4038.166666666666,0.24572649572649571,1611088.0,-1
2015-08-31,4199.0,4233.0,4142.350098,4205.850098,4025.7597659999997,298281.0,4411.4599611,4319.984517218181,-366.6499020000001,25.959962058444148,-10.592367622687345,85.22216668605961,-82.87827355468521,-168530.16401434442,2158.2301136560523,72.0,84.0,84.0,426.60009700000046,4193.733398666666,4245.116699333333,4284.383300666667,4335.766601333333,4154.466797333333,4103.083496666666,4063.8168953333325,0.7004971720763683,1909369.0,+1
2015-09-01,4170.0,4199.450195,4046.1999509999996,4167.200195,3923.5988770000004,605386.0,4373.2000001,4275.573650654545,-382.5996099999993,23.19291723667071,-11.43379018167619,62.98087849456169,-95.68486406873281,-347991.20143508347,-13757.653138666361,68.0,80.0,84.0,505.25,4137.616780333334,4229.033609666668,4290.867024333335,4382.283853666669,4075.783365666667,3984.366536333333,3922.5331216666664,0.7895598782863938,1303983.0,-1
2015-09-02,4083.0,4089.9499509999996,4010.0,4061.4499509999996,3893.216553,392078.0,4315.9449952,4218.891823545454,-572.5500490000004,17.35339346022505,-13.736011766040232,21.199355860620017,-113.39263839721804,-1023897.3015637079,-59673.091703735576,64.0,96.0,-12.0,145.0,4053.799967333333,4097.599934666666,4133.749918333333,4177.549885666665,4017.6499836666662,3973.8500163333333,3937.7000326666666,0.6435269860265438,911905.0,-1
2015-09-03,4059.0,4162.299805,4040.0500490000004,4030.0,4002.6225590000004,514445.0,4251.7599854,4166.901824418182,-641.8500979999999,15.973315487859963,-14.42068873018407,-20.589427975773106,-93.36372372085093,232708.66441050856,-46383.011880279446,60.0,96.0,-12.0,86.89990200000011,4077.4499513333335,4114.849853666667,4199.699707333332,4237.099609666666,3992.6000976666674,3955.2001953333342,3870.350341666668,-0.08220915385712885,397460.0,-1
2015-09-04,4137.0,4139.700195,4051.1999509999996,4143.25,3925.3862299999996,316141.0,4202.6699952,4147.172736163637,-490.8999020000001,36.84267360302286,-11.955194707974288,-70.40281175076598,-74.83834387972949,-360106.6658730932,-60643.177970945246,56.00000000000001,92.0,-12.0,117.0,4111.383382,4171.566813,4199.883626000002,4260.067057000001,4083.0665689999996,4022.8831379999992,3994.566324999999,1.040110680372809,713601.0,+1
2015-09-07,4067.899902,4128.5,4045.0,4063.3000490000004,3931.4726560000004,300049.0,4152.2649903,4121.832745945454,-504.0500489999995,30.643211131697683,-13.695734454256531,-130.87653684755423,-77.33607860872918,11707.838709677419,-57354.49539453496,52.0,88.0,-12.0,90.64990200000011,4078.9333496666673,4112.8666993333345,4162.433349666668,4196.3666993333345,4029.3666993333345,3995.4333496666673,3945.8666993333345,0.21916226347305867,413552.0,-1
2015-09-08,4106.0,4155.850098,4077.0,4069.600098,3998.8066409999997,292997.0,4135.0450196,4106.802765527273,-172.19970699999976,31.688343612150263,-13.558580077663793,-189.36680375733886,-63.900355437049704,-742221.7958965693,-88484.82723570234,48.0,84.0,-12.0,159.6501470000003,4100.816731999999,4124.633463999999,4179.666829999998,4203.4835619999985,4045.7833659999988,4021.9666339999994,3966.933267999999,-0.09384772102629627,706549.0,+1
2015-09-09,4210.0,4319.0,4187.649902,4139.299805,4159.027344,589734.0,4129.0750001,4107.576362872727,-59.70019500000035,42.708919983321536,-12.041191901431803,-236.16592324525027,-27.770982926916105,-509006.43399514776,-107599.44572486523,44.0,80.0,-32.0,157.20019500000035,4215.316569,4242.983235999999,4346.666666999999,4374.333333999999,4111.633137999999,4083.9664709999997,3980.2830399999993,-0.3681009587065592,1296283.0,+1
2015-09-10,4255.0,4317.950195,4225.149902,4305.149902,4155.453125,321362.0,4138.8850098,4139.5899814,98.10009700000046,60.29551446984014,-6.837440652498045,-236.13907716698122,-6.171663415734921,-621252.0,-130947.28910112103,40.0,76.0,-36.0,122.24975599999925,4282.749999666667,4340.350097333333,4375.550292666668,4433.150390333333,4247.549804333333,4189.949706666666,4154.7495113333325,0.8620662436917068,1617645.0,+1
2015-09-11,4329.0,4360.0,4308.600098,4301.450195,4171.200195,281728.0,4148.6550293,4169.1472878,97.70019500000035,59.82284094012505,-3.470721980174965,-228.25314627185253,9.010060544657094,-497832.4937448762,-147623.88931227807,36.0,72.0,-35.99999999999999,109.70019500000035,4323.350097666666,4338.100097333333,4374.749999666666,4389.499999333333,4286.700195333333,4271.950195666666,4235.300293333333,-0.13910343642288509,1335917.0,-1
2015-09-14,4330.0,4347.0,4285.0,4317.75,4172.890625,207396.0,4159.8450195000005,4199.891827927273,111.89990200000011,61.36258086250533,-1.2002341920374706,-221.96596003714694,10.793765693013341,233983.90945522668,-130278.08027731479,32.0,68.0,-36.0,98.25,4316.583333333333,4348.166666666666,4378.583333333332,4410.166666666666,4286.166666666666,4254.583333333333,4224.166666666666,0.5282258064516129,1543313.0,+1
2015-09-15,4375.5,4419.100098,4320.0,4319.5,4178.204102000001,734807.0,4175.075000000001,4228.9200062,152.29980499999965,61.54514809645482,-2.305504403615786,-214.820074336385,27.128046471783186,79038.74513849098,-120763.67912201073,28.000000000000004,64.0,-36.0,92.55004899999949,4352.866699333333,4385.733398666665,4451.966797333333,4484.833496666665,4286.6333006666655,4253.766601333333,4187.533202666666,-0.005045403688702715,2278120.0,+1
2015-09-16,4377.0,4377.0,4330.100098,4325.0,4207.765136999999,418079.0,4201.4300049,4256.179097109091,263.5500490000004,62.19297617136624,-2.1781925387229744,-204.6879813270425,31.132161096600182,-860506.6450557295,-154388.3593918607,24.0,60.0,-36.0,249.3999020000001,4344.033366,4357.966633999999,4390.933268,4404.8665359999995,4311.066731999999,4297.133464,4264.166829999999,-0.108744321043568,2696199.0,+1
2015-09-18,4379.299805,4478.299805,4355.600098,4355.600098,4251.479492,621252.0,4233.990014700001,4284.2100231272725,325.6000979999999,65.8826804493203,-2.8018110762800306,-187.29425891704523,57.084708872041986,10795.027654026992,-146880.02361701874,20.0,56.00000000000001,-36.0,178.6503900000007,4396.500000333333,4437.399902666667,4519.199707333332,4560.099609666667,4314.700195666667,4273.800293333334,4192.0004886666675,0.0,3317451.0,+1
2015-09-21,4397.950195,4509.0,4387.100098,4400.850098,4337.845215,642858.0,4259.7500245,4314.548220090909,257.6000979999999,70.75287127506203,-2.4523787301587325,-152.41185734518058,75.39429168053282,-602133.836996337,-167573.37877070007,16.0,52.0,-36.0,54.85009799999989,4432.316731999999,4477.533365999999,4554.216633999999,4599.433267999999,4355.633463999999,4310.416829999999,4233.7335619999985,0.11279746557958667,3960309.0,+1
2015-09-22,4508.0,4519.899902,4440.5,4490.25,4321.228515999999,924289.0,4302.4450196,4356.457306545455,426.9499509999996,77.93360507991969,-0.6706757143853584,-108.571768671276,95.2891771464704,-445117.80129450205,-180189.034340008,12.0,48.0,-36.0,62.0,4483.549967333333,4526.599934666667,4562.9498693333335,4605.999836666667,4447.200032666667,4404.150065333333,4367.8001306666665,0.6265750806594186,4884598.0,+1
2015-09-23,4459.0,4523.0,4413.25,4473.049805,4344.993652,880695.0,4342.789990300001,4387.476358436364,403.44970699999976,73.90544904105137,-1.1290731238698088,-72.53204561147322,86.63448787322314,567573.8180105316,-146199.81377850613,8.0,44.0,-36.0,101.35009799999989,4469.766601666666,4526.2832033333325,4579.516601666666,4636.0332033333325,4416.5332033333325,4360.016601666666,4306.7832033333325,0.5448729384965799,4003903.0,-1
2015-09-24,4499.5,4604.0,4484.75,4497.649902,4411.651855,1098076.0,4378.625000000001,4415.632706018182,358.35009700000046,75.95630032710747,-2.3607124972253026,-23.036205967257956,109.26049560346094,2172305.539091379,-40813.206829538525,4.0,40.0,-36.0,57.5,4528.799967333333,4572.849934666667,4648.0499673333325,4692.099934666667,4453.599934666667,4409.549967333333,4334.349934666667,0.10817527882599674,5101979.0,+1
2015-09-28,4570.0,4615.0,4516.75,4566.649902,4382.283691,684352.0,4404.775000000001,4449.8190518363635,261.5,80.83186014318942,-1.0706399025686424,36.81234720479824,120.12889927734103,428875.91735255125,-19463.701184833022,0.0,36.0,-36.00000000000001,153.29980499999965,4566.133300666667,4615.516601333335,4664.383300666668,4713.766601333335,4517.266601333335,4467.883300666667,4419.016601333335,0.5078870432569986,5786331.0,+1
2015-09-29,4509.950195,4740.0,4467.0,4536.25,4523.376465,1222175.0,4428.2549805,4473.723597290908,234.79980499999965,73.2780179491711,-4.390217625511743,93.19242338296954,117.52643260173691,-646820.542562422,-47979.92124753365,96.0,32.0,-36.0,153.3999020000001,4581.083333333333,4695.166666666666,4854.083333333332,4968.166666666666,4422.166666666666,4308.083333333333,4149.166666666666,0.25366300366300365,4564156.0,-1
2015-09-30,4710.0,4763.450195,4657.549805,4682.299805,4526.564941,835777.0,4464.7099610000005,4519.913565381818,364.54980499999965,82.39703274593859,-1.7397632434148154,131.5847917885285,156.77012570125407,-99031.87865944688,-50300.46476626343,96.0,28.000000000000004,-36.0,119.04980400000022,4701.099934999999,4744.650064999999,4807.000325,4850.550455,4638.749674999998,4595.199544999999,4532.8492849999975,0.233710187469563,5399933.0,+1
2015-10-01,4720.0,4721.899902,4570.0,4685.600098,4424.887207,1087189.0,4501.319970800001,4560.075408472728,366.1000979999999,82.55227767278188,-1.6690090738550687,169.3182366392366,120.32463333290887,288816.6369237294,-34886.051053041076,96.0,24.0,-36.0,109.75,4659.166666666667,4748.333333333334,4811.066568666667,4900.233235333334,4596.433431333334,4507.266764666667,4444.533529333334,0.7610281275889158,6487122.0,+1
2015-10-05,4570.0,4570.0,4389.0,4580.350098,4264.231445,1949365.0,4526.854980600001,4574.444522509091,255.3500979999999,62.325917748570035,-3.925437926130551,184.53178119270797,49.41740295041711,106946.448348447,-28439.119262048036,92.0,20.0,-36.0,130.95019500000035,4513.116699333333,4637.233398666665,4694.116699333332,4818.233398666665,4456.233398666665,4332.116699333333,4275.233398666665,1.0571828618784525,4537757.0,-1
2015-10-06,4449.0,4449.0,4338.049805,4414.049805,4206.219727000001,1159174.0,4532.6999513,4553.934490581818,58.44970699999976,43.08169824087018,-7.490708988050428,194.40674581862277,2.591011831166953,-549556.5191054102,-52126.27380043988,88.0,16.0,-36.0,117.35009799999989,4400.3665366666655,4462.683268333331,4511.316731666665,4573.633463333332,4351.733073333331,4289.416341666665,4240.782878333331,0.684992036291597,3378583.0,-1
2015-10-07,4352.25,4437.899902,4345.049805,4354.0,4216.363281,801302.0,4528.0149415,4521.443590345455,-46.85009799999989,38.171116177850855,-8.778101981642026,203.81560881151654,-9.545407688959838,123618.37828807591,-44137.88052367075,84.0,12.0,64.0,273.0,4378.983235666667,4412.9166663333335,4471.833332666668,4505.766763333334,4320.066569333333,4286.133138666666,4227.216472333333,0.09639402961528737,2577281.0,-1
2015-10-08,4380.0,4407.0,4332.200195,4364.5,4205.978027,726218.0,4515.439941500001,4491.713600981819,-125.75,39.56101418172361,-8.552995065262998,210.13964438573385,-18.529623798812235,-1154907.8365501831,-94627.42397953241,80.0,8.0,68.0,227.20019500000035,4367.900065000001,4403.599935000001,4442.699870000001,4478.399740000001,4328.800130000001,4293.100260000001,4254.000325000002,0.4318167005916633,3303499.0,+1
2015-10-09,4390.0,4397.200195,4262.75,4353.75,4131.205566,816648.0,4503.509961,4462.3154298,-119.29980499999965,38.53761875297327,-8.78346167012724,210.8158333809506,-33.588783280292766,-1014394.7388686683,-136435.02920185367,76.0,4.0,72.0,151.8999020000001,4337.900065000001,4413.050130000001,4472.350260000001,4547.500325000002,4278.599935000001,4203.44987,4144.149740000001,0.6768305542435231,2486851.0,-1
2015-10-12,4310.899902,4322.649902,4216.5,4276.350098,4088.2155759999996,837794.0,4481.379980600001,4421.013636527272,-221.29980400000022,31.720563639742792,-10.442819124151896,194.68125016475096,-57.90067645279677,67238.65787082302,-127177.13433489525,72.0,0.0,72.0,296.6000979999999,4271.833333333333,4327.166666666666,4377.983235333333,4433.316568666666,4221.016764666666,4165.683431333333,4114.866862666666,0.5638262200185529,1649057.0,-1
2015-10-13,4231.0,4288.0,4229.149902,4231.850098,4128.790039,605082.0,4447.900000200001,4375.644566963637,-334.7998040000002,28.389127578010743,-11.396843674520154,172.08105118588992,-64.93156966659511,-364125.1700386933,-137947.4995941794,68.0,0.0,72.0,242.30029300000024,4249.666666666667,4270.183431333334,4308.516764666668,4329.033529333334,4211.333333333334,4190.816568666667,4152.483235333334,0.045882608385797136,1043975.0,-1
2015-10-14,4270.899902,4295.600098,4242.0,4273.850098,4105.507813,656029.0,4421.6600100000005,4343.9991302,-262.3999020000001,35.73893092912289,-10.496416009004045,143.6600648227859,-56.95710535280912,181377.30791499038,-123432.73561646334,64.0,4.0,72.0,92.85009700000046,4270.483398666666,4298.966797333333,4324.083496666666,4352.5668953333325,4245.366699333333,4216.883300666666,4191.766601333333,0.5942171598268338,1700004.0,+1
2015-10-15,4269.899902,4389.149902,4261.0,4249.75,4228.825195,982419.0,4378.405029500001,4312.742764745454,-432.54980499999965,33.46486399230494,-11.013092079976648,110.11754458653286,-47.748594449946005,319179.9866659983,-103313.97551268002,60.0,0.0,72.0,74.79980499999965,4299.966634,4338.933268000001,4428.116536000001,4467.083170000001,4210.783366000001,4171.816732,4082.6334640000005,-0.08778781586582868,717585.0,-1
2015-10-16,4410.0,4461.0,4381.049805,4377.399902,4296.063477000001,929525.0,4347.5850099,4312.560014290909,-308.2001959999998,52.09426151635161,-8.276437240423792,76.55609599506715,-10.052793185361836,-463527.5609880596,-119687.3203070427,56.00000000000001,0.0,72.0,134.45019500000035,4406.483235666667,4431.9166663333335,4486.433430666667,4511.866861333334,4351.966471333333,4326.533040666666,4272.016276333333,-0.04565220885326826,1647110.0,+1
2015-10-19,4465.0,4478.0,4408.100098,4447.0,4307.60791,594941.0,4334.2500001,4330.6354670363635,-133.3500979999999,59.26905660731765,-6.784297865142075,22.084345558419955,2.6840689367420176,-1134278.7688317595,-165805.11342187578,52.0,0.0,72.0,137.25,4444.366699333333,4480.6333006666655,4514.266601333332,4550.533202666666,4410.733398666665,4374.466797333333,4340.833496666665,0.5565086772224667,2242051.0,+1
2015-10-20,4467.899902,4516.700195,4441.649902,4458.950195,4355.717285,675597.0,4338.7400391,4353.308229745455,44.9003900000007,60.44276691064579,-6.528100574991775,-32.21331571425435,14.694142287120977,-420705.7356321839,-177391.50534054372,48.0,76.0,68.0,58.85009799999989,4472.433430666667,4503.216959333334,4547.483723666667,4578.267252333334,4428.1666663333335,4397.383137666667,4353.116373333333,0.2305159954538776,2917648.0,+1
2015-10-21,4489.0,4524.700195,4450.0,4508.75,4322.822754,316565.0,4354.2150391,4384.219131727273,154.75,65.25677809537294,-5.460454809293989,-63.896272175939885,27.241285673168097,569932.3919604779,-143422.2372813572,44.0,72.0,60.0,63.75,4494.483398333334,4538.9667966666675,4569.183593333335,4613.666991666668,4464.266601666667,4419.783203333333,4389.566406666667,0.7864771972817437,3234213.0,+1
2015-10-23,4500.799805,4508.0,4371.100098,4474.700195,4232.207031,621558.0,4365.2350586,4406.125523709091,110.20019500000035,59.5403173287841,-5.3472866001933985,-75.40131827293226,5.428586338661392,120871.66439020174,-131408.87811445157,40.0,68.0,60.0,128.1499020000001,4451.266764333333,4531.433430666667,4588.1666663333335,4668.333332666667,4394.533528666667,4314.366862333333,4257.633626666667,0.7567580070291093,2612655.0,-1
2015-10-26,4400.0,4452.0,4375.799805,4380.899902,4236.3125,535165.0,4367.9500488,4408.973677054546,27.14990200000011,46.5724593766223,-4.229481055692236,-80.32482309115494,-32.042815513486396,-315924.04316852335,-139795.9310714659,36.0,64.0,56.00000000000001,211.25,4402.899902333334,4429.9999996666675,4479.100097333335,4506.200194666668,4353.799804666667,4326.699707333333,4277.599609666667,0.06693023554599088,2077490.0,-1
2015-10-27,4409.0,4518.0,4376.600098,4385.149902,4344.365723,1290318.0,4378.8300292,4412.100923090909,108.79980400000022,47.17396234945727,-3.1531799907652855,-86.68744665055874,-7.8436008872352465,30003.892225859498,-132077.75728521412,32.0,60.0,52.0,100.60009799999989,4426.583333333333,4476.566568666666,4567.983235333332,4617.966470666666,4335.166666666666,4285.183431333333,4193.766764666666,0.060465416729922596,3367808.0,+1
2015-10-28,4530.0,4559.0,4472.0,4497.0,4342.627441,989227.0,4405.345019400001,4433.586372327273,265.1499020000001,60.6326825127939,-1.390134529147982,-88.55305361136016,73.6957125863333,-215403.3508748191,-135865.28426656433,28.000000000000004,56.00000000000001,-28.0,75.05029300000024,4509.333333333333,4546.666666666666,4596.333333333332,4633.666666666666,4459.666666666666,4422.333333333333,4372.666666666666,0.28735632183908044,4357035.0,+1
2015-10-29,4501.5,4512.549805,4419.25,4495.200195,4288.865723,907407.0,4427.4800291,4449.923676981818,221.35009700000046,60.347219409582664,-1.4304889013452837,-77.16313986220757,44.37793417686868,-71408.67625771438,-132935.43844797686,24.0,52.0,-28.0,74.70019500000035,4475.666666666667,4532.083333333334,4568.966471666667,4625.383138333334,4438.783528333334,4382.366861666667,4345.483723333335,0.8140445202431091,3449628.0,-1
2015-10-30,4446.0,4467.899902,4400.100098,4439.549805,4297.994629,738321.0,4446.4600096,4452.118181690909,189.79980499999965,51.668430346219765,-2.6782554932735505,-56.5257290606105,20.388520243122468,245317.01990401835,-115742.14488650372,20.0,48.0,-28.0,137.6499020000001,4435.849934999999,4471.599771999999,4503.6497389999995,4539.399575999999,4403.799967999998,4368.050130999999,4336.000163999998,0.5818557676066384,2711307.0,-1
2015-11-02,4470.0,4525.049805,4425.200195,4449.0,4343.158203,603730.0,4453.6200194,4452.579998127273,71.60009799999989,52.99302986473053,-2.4663677130044843,-33.89642755900877,61.27841915867379,-122476.04114804276,-116048.23108021037,16.0,44.0,-28.0,98.9003900000007,4466.416666666667,4507.633138333334,4566.266276666666,4607.482748333333,4407.783528333334,4366.567056666668,4307.933918333335,0.2383565143619471,3315037.0,+1
2015-11-03,4519.899902,4521.200195,4465.049805,4495.75,4330.40625,320901.0,4458.495019400001,4460.2399946,48.75,59.351934686367805,-1.4181614349775784,-5.66709426669604,99.76858362069616,-938126.3844295349,-153415.4198688533,12.0,40.0,-28.0,141.3999020000001,4494.0,4522.950195,4550.150390000002,4579.100585000001,4466.799805,4437.849609999999,4410.649414999999,0.5467494526752168,3635938.0,+1
2015-11-04,4487.75,4536.549805,4455.100098,4482.549805,4367.116211,660804.0,4460.8549804,4464.613591981818,23.599609999999302,56.84656990362562,-1.7141299327354336,8.14871655816387,103.18558027196917,625152.7159158359,-118025.95915133374,8.0,36.0,-28.000000000000004,173.8500979999999,4491.399902666667,4527.699707333334,4572.849609666667,4609.149414333334,4446.250000333334,4409.950195666667,4364.800293333335,0.33701418962746965,2975134.0,-1
2015-11-05,4518.950195,4555.0,4496.399902,4520.549805,4372.961426,406256.0,4462.0349609,4475.467196454545,11.799804999999651,62.15317421755214,-0.8621119955157028,18.522109671680482,149.36522302055894,19093.493891647417,-111793.25674028347,4.0,32.0,-28.0,93.29980499999965,4523.983235666667,4551.566569333333,4582.5833336666665,4610.166667333333,4492.966471333333,4465.383137666667,4434.366373333333,0.4121136964651422,3381390.0,+1
2015-11-06,4532.950195,4535.350098,4481.049805,4526.600098,4369.290527,361975.0,4467.2249512,4487.206312290909,51.89990299999954,62.989295829436955,-0.7264552017937245,26.092165153893802,130.1764962138695,-3842.7278807095618,-106886.41451938948,0.0,28.000000000000004,-28.0,95.10009700000046,4514.3333336666665,4547.616862333333,4568.633626666667,4601.9171553333335,4493.316569333333,4460.033040666666,4439.016276333333,0.8388590647199645,3743365.0,+1
2015-11-09,4440.0,4639.0,4440.0,4522.799805,4471.113281,729714.0,4481.414941499999,4497.310831163636,141.89990299999954,61.996644442638924,-2.559475660792959,36.15001237580509,130.9559161501297,500192.7165354331,-79291.90856232923,0.0,24.0,-28.0,99.8496099999993,4533.933268333333,4627.866536666666,4732.933268333334,4826.866536666666,4428.866536666666,4334.933268333333,4229.866536666666,0.416079422110551,3013651.0,-1
2015-11-10,4649.5,4729.950195,4629.75,4628.200195,4552.744629,909977.0,4505.7199708,4523.9990590727275,243.05029300000024,74.73712513646828,-2.19717327363742,54.24411570090342,239.3921601589743,-1892144.9225910346,-161694.3182909719,96.0,20.0,-28.0,72.20019500000035,4662.6334633333345,4695.516926666669,4762.833658333335,4795.717121666669,4595.316731666669,4562.433268333334,4495.116536666668,-0.015467085667843716,3923628.0,+1
2015-11-13,4734.450195,4737.25,4602.399902,4712.700195,4462.998047,983107.0,4527.2899903,4561.631827109091,215.70019500000035,80.71709219718085,-0.5292902495553204,82.3970252733452,196.11740506569922,-654449.901324594,-184092.2993379716,96.0,16.0,-28.0,81.44970699999976,4684.116699000001,4765.833496000002,4818.966797000002,4900.683594000002,4630.983398000002,4549.266601000001,4496.133300000002,0.8179474441316337,4906735.0,+1
2015-11-16,4600.0,4664.0,4572.899902,4619.799805,4489.178223,644299.0,4539.7499513,4578.451793418182,124.5996099999993,62.07675506197819,-2.53220923839811,99.51639924641677,102.81263635577346,-195266.49708112207,-184600.2174172061,96.0,12.0,-28.0,72.45019500000035,4618.899902333334,4664.899902666667,4710.000000333334,4756.000000666667,4573.799804666667,4527.799804333334,4482.699706666667,0.5148172617772552,4262436.0,-1
2015-11-17,4645.399902,4676.149902,4618.0,4646.899902,4475.025879,638262.0,4560.484961,4597.9336026363635,207.35009700000046,64.8119288803241,-1.9479350617150841,99.38776032093847,100.99626438073477,1592961.0129554444,-103801.9796729392,92.0,8.0,-28.000000000000004,54.30029300000024,4647.016601333334,4676.033202666667,4705.166503333334,4734.1831046666675,4617.883300666667,4588.866699333334,4559.733398666667,0.4969896939809126,4900698.0,+1
2015-11-18,4634.5,4652.0,4525.0,4632.25,4379.385742,725994.0,4578.809961000001,4610.981791545455,183.25,62.021730390928916,-2.2637848326416212,100.28025261669973,57.429864755450915,734122.6985047722,-65714.49430120006,88.0,4.0,-24.0,199.0,4603.083333333333,4681.166666666666,4730.083333333332,4808.166666666666,4554.166666666666,4476.083333333333,4427.166666666666,0.844488188976378,4174704.0,-1
2015-11-19,4580.899902,4661.5,4571.049805,4533.25,4492.510742,1030684.0,4582.559961,4602.698162272728,37.5,46.43449051006733,-4.398210531989435,106.4545888029179,40.5914256759767,-232225.3054183907,-73283.16753380439,84.0,0.0,76.0,207.1503900000007,4588.599934999999,4606.150064999999,4679.050129999999,4696.600259999999,4515.699869999999,4498.149739999999,4425.249674999998,-0.4179073909127504,3144020.0,-1
2015-11-20,4666.0,4766.0,4631.0,4650.350098,4577.089355,917455.0,4599.3399903,4615.023641727273,167.80029300000024,60.1150618204071,-2.4780351832012024,110.3939423437987,94.53719784394528,-1626618.2033663394,-143889.30552623456,80.0,0.0,80.0,134.8500979999999,4682.450032666667,4733.900065333333,4817.4500326666675,4868.900065333333,4598.900065333333,4547.450032666667,4463.900065333333,0.14333405925925843,4061475.0,+1
2015-11-23,4730.0,4790.0,4702.350098,4737.899902,4575.495117,1034126.0,4621.075,4640.216352945455,217.35009700000046,67.31614864332792,-1.1106394798550392,108.27731049881731,117.76161989188564,-664767.2120040464,-167565.57400251224,96.0,0.0,84.0,139.80029300000024,4743.416666666667,4784.483235333334,4831.066568666668,4872.133137333334,4696.833333333334,4655.766764666667,4609.183431333334,0.4055886337442816,5095601.0,+1
2015-11-24,4724.049805,4724.049805,4621.0,4736.25,4482.415527,1287988.0,4642.0399902,4661.157262036364,209.6499020000001,67.05290517711734,-1.1458111276913239,111.56800485318126,72.47706711321965,-1123497.0,-211017.00245696714,96.0,0.0,84.0,58.14990200000011,4693.766601666666,4766.5332033333325,4796.816406666665,4869.583008333332,4663.483398333333,4590.716796666667,4560.433593333333,1.118391247804888,3807613.0,-1
2015-11-26,4659.950195,4659.950195,4577.950195,4639.899902,4450.197265999999,1436728.0,4653.7499999,4660.768155090909,117.10009700000046,53.069186233054545,-3.199746280110848,106.72408965931754,28.528591424808553,-97549.81088840355,-205859.40284021152,92.0,16.0,84.0,127.0,4625.933430666667,4673.9166663333335,4707.933430666667,4755.9166663333335,4591.9166663333335,4543.933430666667,4509.9166663333335,0.7554842317073142,2370885.0,-1
2015-11-27,4680.0,4680.0,4556.399902,4606.549805,4424.597656,1231876.0,4651.5849609,4652.186301472728,-21.650390000000698,48.98885669822245,-3.9106841824770915,108.76286154870559,17.970112070682983,433790.64310928993,-176784.4007515834,88.0,12.0,84.0,90.45019500000035,4614.316569,4672.233235999999,4737.916666999999,4795.833333999999,4548.633137999999,4490.716471,4425.033039999999,0.4057432300741346,1139009.0,-1
2015-11-30,4586.0,4700.0,4492.100098,4580.049805,4400.397461,10567769.0,4638.3199219,4639.179909490909,-132.6503900000007,45.76286881389744,-4.475595715199325,115.82673340617112,3.3816539939898687,16254.620123266957,-168009.8998027224,84.0,8.0,80.0,232.75,4590.716634333333,4689.333170666666,4798.616536333334,4897.233072666666,4481.433268666666,4382.816732333333,4273.533366666666,0.42303871312070035,-9428760.0,-1
2015-12-01,4609.0,4616.0,4531.350098,4555.0,4401.556640999999,1506622.0,4631.8399414000005,4624.030832781818,-64.79980499999965,42.696238489354975,-5.009592837348113,108.89572672855138,-12.596769406545206,276283.50856580056,-147814.7448768713,80.0,4.0,96.0,139.6499020000001,4567.450032666667,4603.549967333333,4652.099934666668,4688.1998693333335,4518.900065333333,4482.8001306666665,4434.250163333333,0.27938487158555814,-10935382.0,-1
2015-12-02,4600.0,4627.350098,4556.200195,4556.200195,4462.031738000001,1123497.0,4622.7699707,4610.278151618182,-90.69970699999976,42.90774354959595,-4.9840077808569525,92.6423605120799,-9.975888047903856,616419.5682315219,-113076.82155374752,76.0,0.0,96.0,116.89990200000011,4579.916829333334,4603.633463666668,4651.066732333334,4674.7833666666675,4532.483560666668,4508.766926333335,4461.333657666669,0.0,-9811885.0,+1
2015-12-03,4609.0,4644.700195,4600.5,4618.799805,4470.001465,567288.0,4621.4249512,4609.55630330909,-13.450195000000349,53.28459248576076,-3.649545832445115,87.73721796117661,11.124290499228232,144022.24926519772,-101390.50015288156,72.0,0.0,76.0,158.29980499999965,4621.333333333333,4642.166666666666,4665.533528333333,4686.366861666666,4597.966471666666,4577.133138333333,4553.766276666665,0.4140209109937073,-9244597.0,+1
2015-12-04,4610.0,4634.0,4579.149902,4627.049805,4444.208496,581041.0,4630.8049316999995,4610.579004,93.79980499999965,54.541022147444245,-3.4736771477297026,73.08536247387747,2.502927474518535,258095.03976996453,-85050.24833820033,68.0,0.0,76.0,123.60009799999989,4613.399902333334,4647.649902666667,4668.250000333334,4702.500000666667,4592.799804666667,4558.549804333334,4537.949706666667,0.8732874643177417,-8663556.0,+1
2015-12-07,4622.0,4640.0,4558.0,4600.350098,4409.285156,493623.0,4625.8049316999995,4605.041761509091,-50.0,49.563216088310256,-4.042845917714775,59.373257666670725,-14.251164973527459,-408959.4936708861,-99773.39585332792,64.0,8.0,76.0,207.8999020000001,4599.450032666667,4640.900065333333,4681.4500326666675,4722.900065333333,4558.900065333333,4517.450032666667,4476.900065333333,0.5164646097560962,-9157179.0,-1
2015-12-08,4540.0,4579.799805,4520.0,4564.200195,4388.370117,577670.0,4608.434961000001,4593.840900290909,-173.69970699999976,43.37827553379004,-4.813468450223826,65.3059898059646,-62.221468046881384,-356539.45025436423,-111444.5801442883,60.0,4.0,76.0,84.64990200000011,4554.666666666667,4589.333333333334,4614.466471666667,4649.133138333334,4529.533528333334,4494.866861666667,4469.733723333335,0.7391361058786162,-9734849.0,-1
2015-12-09,4538.799805,4542.0,4470.0,4542.549805,4327.07373,607147.0,4589.0649415,4581.861781018181,-193.70019500000035,39.93452949371707,-5.27499882754211,54.5833176108481,-107.71173629493015,-142288.36692763845,-112846.57045262288,56.00000000000001,0.0,76.0,72.35009799999989,4518.183268333333,4566.366536666666,4590.183268333334,4638.366536666666,4494.366536666666,4446.183268333333,4422.366536666666,1.0076361805555507,-10341996.0,-1
2015-12-10,4495.0,4519.799805,4406.049805,4479.100098,4345.428711,506406.0,4572.9849611,4561.868173109091,-160.79980400000022,31.482824556222397,-6.627582647623111,25.36570899723847,-155.94628166199342,-59265.70524997585,-110411.0765797745,52.0,0.0,72.0,88.5,4468.316569333333,4530.5833336666665,4582.066569333333,4644.3333336666665,4416.8333336666665,4354.566569333333,4303.0833336666665,0.6422003780219802,-10848402.0,-1
2015-12-11,4519.75,4528.0,4412.0,4498.100098,4328.66748,532721.0,4562.139990399999,4548.252743454545,-108.44970699999976,36.15174700379782,-6.222551737369433,-4.962040436766074,-122.76311426290466,150763.75690607735,-98539.49323950481,48.0,96.0,68.0,54.85009799999989,4479.366699333333,4546.733398666665,4595.366699333332,4662.733398666665,4430.733398666665,4363.366699333333,4314.733398666665,0.7422422241379301,-10315681.0,+1
2015-12-14,4478.899902,4590.0,4471.5,4480.75,4421.457031,484617.0,4552.210009899999,4533.454563381819,-99.29980499999965,33.72999470875432,-6.592410999786826,-21.513941585088105,-82.31639617843737,-221447.73284388136,-104126.23140334176,44.0,92.0,56.0,82.0,4514.083333333333,4556.666666666666,4632.583333333332,4675.166666666666,4438.166666666666,4395.583333333333,4319.666666666666,0.07805907172995781,-10800298.0,-1
2015-12-15,4605.0,4634.0,4563.100098,4576.799805,4463.191406,581111.0,4554.3899904,4537.9254352181815,21.79980499999965,53.58920263433035,-3.183749499104043,-33.02968395415883,-4.038284247592213,150637.39506544927,-92546.06656384798,40.0,88.0,56.0,80.35009799999989,4591.299967666666,4619.499837333332,4662.199869666666,4690.399739333332,4548.599935333332,4520.400065666666,4477.700033333332,0.19322603577082154,-10219187.0,+1
2015-12-16,4655.0,4657.149902,4604.0,4620.0,4462.611328,357572.0,4560.7699709,4549.854527872727,63.79980499999965,59.83552182211332,-1.7387524451206258,-37.975541340018026,45.086384974381374,-263393.7084386067,-100311.86846724822,36.0,84.0,56.00000000000001,94.20019500000035,4627.049967333333,4650.099934666667,4680.1998693333335,4703.249836666667,4596.950032666667,4573.900065333333,4543.8001306666665,0.30103536221007454,-9861615.0,+1
2015-12-17,4650.0,4679.0,4573.850098,4619.399902,4508.354492,443534.0,4560.8299805999995,4560.514515345454,0.60009700000046,59.70672274365057,-1.7517952184307735,-39.14563610298592,40.92221223278658,166784.05758931252,-88171.14455558323,32.0,80.0,52.0,136.5,4624.083333333333,4674.316568666666,4729.233235333332,4779.466470666666,4569.166666666666,4518.933431333333,4464.016764666666,0.43318921971035385,-10305149.0,-1
2015-12-18,4684.700195,4702.0,4611.5,4666.75,4463.625977000001,682206.0,4564.800000100001,4579.772700690909,39.70019500000035,66.3092596456536,-0.7658049098414078,-39.33542609601591,86.98515597100376,-174458.161950861,-92093.28170991501,28.000000000000004,76.0,-48.0,116.0,4660.083333333333,4708.666666666666,4750.583333333332,4799.166666666666,4618.166666666666,4569.583333333333,4527.666666666666,0.6104972375690608,-9622943.0,+1
2015-12-21,4626.899902,4660.0,4616.25,4620.450195,4481.643066,274072.0,4566.8100098,4589.890917945455,20.10009700000046,55.96295886373836,-1.7716664132087692,-42.69467503027954,47.253479089799505,66366.91714415468,-84890.5453983647,24.0,72.0,-48.0,118.5,4632.233398333334,4648.2167966666675,4675.983398333334,4691.9667966666675,4604.4667966666675,4588.483398333334,4560.7167966666675,0.09600445714286512,-9897015.0,-1
2015-12-22,4630.0,4644.950195,4602.049805,4639.100098,4460.486328,207127.0,4574.3000001,4603.034570345455,74.89990299999954,58.94057753721808,-1.3664979795785381,-41.780996087800304,49.12034149278048,218306.30938672053,-71108.87018085773,20.0,68.0,-48.0,153.25,4628.700032666667,4655.350260333334,4671.600422666667,4698.250650333334,4612.449870333333,4585.799642666666,4569.549480333332,0.8636353422428009,-9689888.0,+1
2015-12-23,4635.0,4656.0,4620.0,4617.200195,4477.633789,227939.0,4581.765039100001,4610.834605781819,74.6503900000007,53.993946260915756,-1.8422725396480482,-43.69320083783987,54.49722427162673,-172504.5060891911,-75717.76272214661,16.0,64.0,-48.0,80.35009700000046,4631.066731666667,4642.133463333334,4667.066731666666,4678.133463333334,4606.133463333334,4595.066731666667,4570.133463333334,-0.07777236111110142,-9917827.0,-1
2015-12-24,4633.25,4634.350098,4586.149902,4634.950195,4442.324219,162732.0,4597.350048800001,4620.504634127273,155.85009700000046,57.34205214395479,-1.4566544644796797,-38.46769232374845,38.01940146316263,-98142.86576811328,-76737.08558787257,12.0,60.0,-48.0,105.14990200000011,4618.483398333334,4650.816894666667,4666.683594333333,4699.017090666667,4602.616698666668,4570.283202333334,4554.416502666668,1.0124500946012847,-9755095.0,+1
2015-12-28,4598.399902,4645.950195,4588.0,4598.399902,4482.512207,272134.0,4607.3800292,4620.695516527273,100.29980400000022,48.88863126411577,-2.2507081903106645,-31.61355673748767,27.99739135710995,229506.43108504402,-62816.92573910092,8.0,56.00000000000001,-48.0,90.5,4610.783365666667,4633.566731333334,4668.7335606666675,4691.516926333335,4575.616536333334,4552.833170666667,4517.666341333334,0.17946276108303083,-10027229.0,-1
2015-12-29,4641.950195,4655.899902,4612.799805,4640.0,4479.518066,253128.0,4623.3050292,4626.626420309091,159.25,57.17889790795122,-1.346947642841625,-20.289654385343965,54.19857512391494,38633.11908368076,-58205.56006533727,4.0,52.0,-48.0,50.5,4636.233235666667,4659.6666663333335,4679.333332666668,4702.766763333334,4616.566569333333,4593.133138666666,4573.466472333333,0.6310935912742855,-9774101.0,+1
2015-12-30,4637.0,4642.899902,4575.0,4636.899902,4431.504883,265170.0,4629.3150389,4629.098215363637,60.10009700000046,56.392394695020805,-1.414297154029978,-3.0143141707103496,31.332552383436646,346272.1868750433,-39820.207931680336,0.0,48.0,-48.0,42.9003900000007,4618.266601333334,4661.533202666667,4686.166503333334,4729.4331046666675,4593.633300666667,4550.366699333334,4525.733398666667,0.9116346294579337,-10039271.0,-1
2015-12-31,4587.0,4637.0,4566.299805,4587.200195,4465.075195,422019.0,4626.035058400001,4621.440971018182,-32.79980499999965,44.95411975974609,-2.494021399087544,22.525372249403517,5.931453995012711,1577341.2726852044,33687.13209637235,0.0,44.0,-48.0,36.0,4596.833333333333,4627.366861666666,4667.5335283333325,4698.067056666667,4556.666666666666,4526.133138333333,4485.966471666666,0.29561997672001605,-10461290.0,-1
2016-01-01,4621.0,4668.0,4602.350098,4621.950195,4481.063477000001,243597.0,4626.2900877,4620.698268581818,2.550293000000238,52.695085465702114,-1.7390789702367946,37.05045535448062,60.393112139236955,115477.99138653411,37404.89842774394,64.0,40.0,-48.0,48.20019599999978,4630.766764333333,4659.183430666667,4696.4166663333335,4724.833332666667,4593.533528666667,4565.116862333333,4527.883626666667,0.2985548554208112,-10217693.0,+1
2016-01-04,4635.0,4657.0,4571.75,4638.5,4425.176758,405501.0,4623.465087700001,4622.918252636364,-28.25,56.08848301626543,-1.3795350858135997,40.66725466692969,54.52190688088781,59139.27595628416,38392.82467904137,60.0,36.0,-48.00000000000001,57.95019500000035,4622.416666666667,4673.083333333334,4707.666666666668,4758.333333333334,4587.833333333334,4537.166666666667,4502.583333333334,0.782991202346041,-9812192.0,+1
2016-01-05,4599.950195,4600.75,4557.25,4580.649902,4411.941895,509285.0,4619.4850584,4615.133673418182,-39.80029300000024,43.50217005564438,-2.636326265479033,41.00208635062245,-26.15324328695063,-297002.1357493565,23147.599205021037,56.00000000000001,32.0,-48.0,57.5,4579.549967333333,4601.849934666667,4623.0499673333325,4645.349934666667,4558.349934666667,4536.049967333333,4514.849934666667,0.537928781609198,-10321477.0,-1
2016-01-06,4592.0,4593.0,4468.0,4566.950195,4328.71582,593742.0,4612.2700681,4605.581880072728,-72.14990299999954,40.988861692027534,-2.933951879209204,32.48332886817843,-99.6506451134455,32346.089246799667,23565.712388738306,52.0,28.000000000000004,-48.0,67.89990200000011,4542.650065000001,4617.300130000001,4667.650065000002,4742.300130000001,4492.300130000001,4417.650065000001,4367.300130000001,0.7916015600000028,-10915219.0,-1
2016-01-07,4449.700195,4449.700195,4251.850098,4480.799805,4123.041992,1200069.0,4598.6300291,4581.678195872728,-136.4003900000007,28.88152044983481,-4.805565826634811,25.980778454380925,-376.9624088621527,425736.6372683391,41846.208974177156,48.0,24.0,-44.0,70.70019500000035,4394.116699333333,4536.3833006666655,4591.966796333333,4734.233397666666,4338.533203666665,4196.266602333332,4140.683106666665,1.1571877419903374,-12115288.0,-1
2016-01-08,4286.299805,4325.0,4195.799805,4267.899902,4071.696289,994652.0,4561.9249998,4521.5454454909095,-367.05029300000024,15.67717538850816,-9.430808125135778,10.743087864650079,-458.5023024688507,-671370.2616279069,9427.278492260099,44.0,96.0,24.0,80.79980499999965,4262.899902333334,4329.9999996666675,4392.100097333335,4459.200194666668,4200.799804666667,4133.699707333333,4071.5996096666668,0.5580494441204231,-13109940.0,-1
2016-01-11,4190.0,4300.0,4117.0,4214.75,4127.38916,865799.0,4523.560009600001,4458.4227182545455,-383.6499020000001,13.85281825188639,-9.920113810461807,-0.5114121116594106,-369.80281095908964,287905.13260184636,22085.362769970114,40.0,96.0,24.0,85.25,4210.583333333333,4304.166666666666,4393.583333333332,4487.166666666666,4121.166666666666,4027.583333333333,3938.166666666666,0.5341530054644809,-13975739.0,-1
2016-01-12,4310.0,4324.799805,4260.0,4272.399902,4124.104004,481142.0,4486.7999998,4412.757244145455,-367.6000979999999,24.804435979542617,-8.658351893193258,-13.94547552606764,-205.57194240518274,389776.5321922609,38798.59774371255,36.0,96.0,24.000000000000007,81.25,4285.733235666667,4311.466471333333,4350.533040666665,4376.266276333333,4246.6666663333335,4220.933430666667,4181.866861333334,0.1913570881887712,-13494597.0,+1
2016-01-13,4298.0,4310.0,4221.350098,4269.0,4145.599609000001,431206.0,4450.010009600001,4373.157244181818,-367.8999020000001,24.591699738289833,-8.732764281024293,-25.749570532067082,-174.79254773020145,749062.6525606095,71083.32750812055,32.0,92.0,23.999999999999996,125.0,4266.783366,4312.216633999999,4355.433268,4400.8665359999995,4223.566731999999,4178.133464,4134.916829999999,0.5375065389243189,-13925803.0,-1
2016-01-14,4239.0,4289.0,4212.700195,4291.25,4104.059082,402026.0,4420.4149901,4344.291787890909,-295.95019500000035,29.17829111631002,-8.245786824250382,-46.83740182619658,-142.28150901380488,919404.0873391541,109643.36204589887,28.000000000000004,88.0,24.0,315.10009700000046,4264.316731666667,4315.933268333333,4340.6165366666655,4392.233073333333,4239.633463333334,4188.016926666667,4163.333658333334,1.0294889351289955,-13523777.0,+1
2016-01-15,4265.0,4340.0,4254.0,4248.25,4128.307129,592183.0,4383.0449706,4312.989062418182,-373.70019500000035,25.6934734108509,-9.1869117968921,-72.32569865226651,-108.78520725435254,-1494381.9353650964,36733.12125448262,24.0,84.0,-52.0,285.0,4280.75,4307.5,4366.75,4393.5,4221.5,4194.75,4135.5,-0.06686046511627906,-14115960.0,-1
2016-01-18,4279.0,4289.25,4172.850098,4273.350098,4092.4182130000004,396124.0,4346.529980400001,4293.044540127273,-365.1499020000001,31.225715315375965,-8.637555307507116,-96.82723790320597,-105.29338087870674,-223348.67582505033,24911.22138722998,20.0,80.0,-56.0,183.0,4245.150065333332,4317.450032666665,4361.549967333332,4433.849934666665,4201.050130666665,4128.750163333332,4084.6502286666646,0.863402788775543,-13719836.0,+1
2016-01-19,4241.0,4244.950195,4165.0,4236.200195,4055.6599119999996,499001.0,4312.0850097,4272.9845791454545,-344.44970699999976,27.703333682971973,-9.450641387612162,-128.52019568461947,-100.31870258515367,-1103599.8992666688,-26384.738642497417,16.0,76.0,-60.0,110.04980499999965,4215.3834633333345,4265.766926666669,4295.333658333335,4345.717121666669,4185.816731666669,4135.433268333334,4105.866536666668,0.8905568648081476,-14218837.0,-1
2016-01-20,4169.850098,4189.950195,4028.5,4198.149902,3921.1838380000004,679992.0,4275.2049804,4252.269105018182,-368.80029300000024,24.444558253193577,-10.283433968045522,-167.91357914195942,-111.2837139631179,816351.3365581622,11921.44659389957,12.0,72.0,-60.0,88.64990200000011,4138.866699000001,4249.233398000002,4300.316894000001,4410.6835930000025,4087.783203000002,3977.4165040000007,3926.3330080000014,1.0507878420338839,-14898829.0,-1
2016-01-21,4084.9499509999996,4084.9499509999996,3870.0,4058.9499509999996,3759.61084,1212801.0,4233.019995000001,4212.950008763636,-421.84985400000005,16.33408501516672,-13.330051411687469,-200.52887644525617,-134.49255544752134,1704961.3441786491,88877.805575031,8.0,96.0,-60.0,76.29980499999965,4004.6333006666664,4139.266601333333,4219.583251666666,4354.216552333332,3924.316650333333,3789.683349666667,3709.3666993333336,0.8790416100164635,-16111630.0,-1
2016-01-22,3942.9499509999996,4119.899902,3930.149902,3891.6999509999996,3965.623047,1063413.0,4195.399999900001,4150.891818945453,-376.1999510000005,11.187882687694184,-16.790259960509005,-236.61635696064332,-116.63928738132086,1428412.9889480583,149765.76845562801,4.0,96.0,-60.0,86.0,3980.583251666667,4031.0166013333337,4170.333251666667,4220.766601333334,3841.2666013333337,3790.833251666667,3651.5166013333337,-0.20263478787879058,-17175043.0,-1
2016-01-25,4125.950195,4172.0,4073.899902,4104.950195,3942.8237299999996,608634.0,4184.4200194000005,4134.446399872727,-109.79980499999965,39.315862690608554,-11.013490420392062,-259.4419458035036,-61.24297353598255,405485.08572827274,161389.37378620368,0.0,92.0,-60.0,116.39990200000011,4116.950032333334,4160.000162666668,4215.050130333334,4258.100260666668,4061.900064666668,4018.849934333334,3963.7999666666683,0.3165164320223235,-16566409.0,+1
2016-01-27,4131.0,4179.0,4092.0,4081.350098,3972.3854979999996,886550.0,4165.315039,4115.7064141636365,-191.04980400000022,37.787634574312094,-11.385178059635072,-252.45504397246623,-50.972517543851794,1229050.5747280938,209919.42837447493,32.0,88.0,-60.0,108.35009799999989,4117.450032666667,4142.900065333333,4204.4500326666675,4229.900065333333,4055.9000653333333,4030.4500326666666,3968.9000653333333,-0.12241266666666795,-17452959.0,-1
2016-01-28,4080.0,4139.899902,4031.0,4111.950195,3964.0283200000003,1677354.0,4149.6100585,4106.003715254546,-157.04980499999965,41.20668306524155,-7.763118230673671,-240.45132445254876,-48.210908288125765,4433.884964972447,200579.1764013151,28.000000000000004,84.0,-60.0,207.70019500000035,4094.2833656666667,4157.566731333333,4203.183267666667,4266.466633333333,4048.666829333333,3985.3834636666666,3939.766927333333,0.7433449756456187,-15775605.0,+1
2016-01-29,3925.0,4124.0,3923.0,4103.299805,3956.831543,2147231.0,4130.815039,4097.583669163636,-187.95019500000035,40.4810105361789,-5.581235439754783,-235.5961860756479,-52.211814110137105,1365673.254219491,253537.9981203266,24.0,80.0,-88.0,328.1499020000001,4050.0999349999997,4177.1998699999995,4251.099935,4378.1998699999995,3976.1998699999995,3849.0999349999997,3775.1998699999995,0.8970139552238788,-17922836.0,-1
2016-02-01,4100.899902,4119.0,3933.649902,4095.850098,3814.241455,1904034.0,4115.5750488,4091.2264071636364,-152.3999020000001,39.78479838649396,-5.756894647488803,-232.46415973418334,-46.475815545864414,-433155.09876031254,222324.67553484105,20.0,76.0,-92.0,189.75,4049.5,4165.350098,4234.850098,4350.700196,3980.0,3864.149902,3794.649902,0.8751017547344371,-19826870.0,-1
2016-02-02,3952.600098,3985.0,3851.5500490000004,3948.25,3743.429199,902619.0,4083.065039000001,4060.803671018182,-325.1000979999999,28.556933398263425,-9.237208205611884,-235.99085715419005,-71.14282742149359,1486369.2969141817,279781.24923390546,16.0,72.0,-92.0,280.3000490000004,3928.2666830000003,4004.983317,4061.7166339999994,4138.433268,3871.5333660000006,3794.8167320000007,3738.083415000001,0.7246158599188987,-20729489.0,-1
2016-02-03,3870.0,3870.0,3784.649902,3874.9499509999996,3698.4111329999996,1101308.0,4046.9400146000007,4022.9645641090906,-361.25024400000075,24.58174075335255,-10.965575312426324,-239.25141644258292,-83.50621860728064,-25612.51445854387,265899.7145206115,12.0,96.0,-56.0,87.0,3843.199951,3901.75,3928.5500490000004,3987.100098,3816.399902,3757.849853,3731.049804,1.0579958443632906,-21830797.0,-1
2016-02-04,3864.0,3881.899902,3774.0,3828.350098,3665.8544920000004,597800.0,4009.9600342000003,3983.22094290909,-369.7998040000002,22.30422239295406,-12.064369299693471,-246.37623609669208,-76.9888717659116,1274642.2015604118,311751.64574969583,8.0,96.0,-56.0,108.89990200000011,3828.0833333333335,3882.166666666667,3935.983235333333,3990.066568666667,3774.266764666667,3720.1834313333334,3666.3668626666667,0.5037085019780633,-22428597.0,-1
2016-02-05,3784.6999509999996,3790.0,3693.3000490000004,3794.649902,3597.022949,1245857.0,3983.5300293,3944.073646145455,-264.3000489999995,20.703593091807903,-12.858997830700304,-251.55603153004722,-85.31273289026186,323436.0287700081,312282.75406880095,4.0,96.0,-56.0,201.0,3759.3166503333337,3825.333251666667,3856.0166013333337,3922.0332026666665,3728.6333006666673,3662.616699333334,3631.9333496666677,1.0480858775202495,-23674454.0,-1
2016-02-08,3749.0,3789.0,3715.0500490000004,3723.399902,3605.8625490000004,559505.0,3966.7000244,3896.7772593636364,-168.3000489999995,17.61907616558139,-13.503969882465244,-258.4848844724547,-80.38447975607046,-2256645.477178423,195513.28901210317,0.0,96.0,-56.0,185.3500979999999,3742.483317,3769.916585,3816.4332679999998,3843.8665359999995,3695.9666340000003,3668.5333660000006,3622.0166830000007,0.11291221815684174,-24233959.0,-1
2016-02-09,3685.0,3689.0,3620.0,3732.5500490000004,3532.973389,657011.0,3929.4600098000005,3854.204536563637,-372.40014599999995,19.398485024513548,-12.359052132800642,-245.4130473743753,-86.87600173467784,172369.67191360207,194461.30641671672,0.0,92.0,-56.0,244.3000489999995,3680.5166830000003,3741.0333660000006,3749.516683,3810.0333660000006,3672.0333660000006,3611.5166830000003,3603.0333660000006,1.6311601304347885,-23576948.0,+1
2016-02-10,3639.850098,3718.0,3600.0,3657.100098,3553.695313,795377.0,3887.035009800001,3804.6845525999997,-424.25,16.091549335033505,-13.025093721533326,-209.92941644814073,-82.10700611575581,-42538.821367513585,183688.57333561487,0.0,96.0,-84.0,163.6000979999999,3658.366699333333,3716.7333986666663,3776.3666993333336,3834.7333986666663,3598.7333986666663,3540.366699333333,3480.7333986666663,0.4838991355932194,-24372325.0,-1
2016-02-11,3651.100098,3664.3000490000004,3518.5,3678.5500490000004,3421.248535,1066224.0,3843.6949952000004,3766.778196090909,-433.40014599999995,20.535278192322565,-12.265930171568618,-206.84904315914036,-82.1569147563049,564790.3034060575,201011.37924790848,0.0,96.0,-88.0,107.89990200000011,3620.450032666667,3722.400065333334,3766.250081666667,3868.2001143333346,3576.6000163333338,3474.6499836666667,3430.7999673333334,1.0977365926674,-23306101.0,+1
2016-02-12,3570.0,3588.0,3461.0,3541.4499509999996,3429.17041,1211696.0,3787.5100098000007,3711.824551690909,-561.849854,14.767503380056354,-15.62622669117648,-206.4834643256263,-95.21123653974743,953799.7222222221,235229.03120128775,0.0,96.0,-92.0,135.0500489999995,3530.1499836666662,3599.2999673333325,3657.1499836666662,3726.2999673333325,3472.2999673333325,3403.1499836666662,3345.2999673333325,0.633464181102359,-24517797.0,-1
2016-02-15,3605.9499509999996,3724.899902,3604.399902,3549.649902,3585.2854,1182286.0,3732.8899902000003,3668.5772593636366,-546.2001959999998,16.388181516240138,-15.425247499999998,-217.87895048238852,-65.16890346195387,2941729.6162079917,358251.78506523365,20.0,96.0,-96.0,79.59985299999971,3626.3165686666666,3648.233235333333,3746.816568666666,3768.733235333333,3527.733235333333,3505.8165686666666,3407.233235333333,-0.45435684647302904,-23335511.0,+1
2016-02-16,3725.25,3748.9499509999996,3651.1999509999996,3711.25,3579.4404299999997,753873.0,3709.1899902000005,3664.6427156909094,-237.0,41.627520396840545,-11.464460784313726,-240.35201138202137,-40.704911271581494,-61709.58155880799,339162.63203686744,16.0,92.0,-92.0,103.39990200000011,3703.799967333333,3756.3999836666662,3801.5499673333334,3854.1499836666662,3658.6499836666662,3606.049967333333,3560.8999836666662,0.6143227519181627,-22581638.0,+1
2016-02-17,3679.899902,3755.0,3661.5,3705.1999509999996,3621.898682,652019.0,3692.2149902,3663.9172540181817,-169.75,41.091687392428994,-10.757503564610706,-268.52928947496775,-34.37720242561457,-426565.8311828773,304356.79279960506,12.0,88.0,-96.0,132.5500490000004,3707.2333169999997,3752.9666339999994,3800.733317,3846.4666339999994,3659.4666339999994,3613.7333169999997,3565.9666339999994,0.4673791550802096,-23233657.0,-1
2016-02-18,3781.25,3796.850098,3622.100098,3749.149902,3529.2539060000004,1243826.0,3684.2949706000004,3674.2690561636364,-79.20019599999978,46.82855456229014,-9.313045913043476,-274.4544584276505,-26.460184271163964,527458.6277695718,314497.78529824025,8.0,84.0,-96.0,145.8000490000004,3722.700032666666,3823.2999673333325,3897.4500326666666,3998.0499673333325,3648.5499673333325,3547.950032666666,3473.7999673333325,0.7270375050071544,-21989831.0,+1
2016-02-19,3640.0,3640.0,3559.0,3653.25,3457.6689450000003,718677.0,3670.1549803999997,3668.624516054545,-141.3999020000001,37.6075041112071,-11.585820895522387,-274.3082530337383,-47.2969927877246,-58406.224338947985,297547.6030420039,4.0,80.0,-96.0,217.5500490000004,3617.4166666666665,3675.833333333333,3698.416666666666,3756.833333333333,3594.833333333333,3536.4166666666665,3513.833333333333,1.1635802469135803,-22708508.0,-1
2016-02-22,3539.0,3545.0,3491.5500490000004,3579.149902,3401.299561,1291463.0,3655.7299804000004,3652.078138163636,-144.25,31.991221054039954,-10.443903705609879,-269.3098171921811,-60.39631181395602,1745655.8189462472,363370.70376492606,0.0,76.0,-76.0,183.4499510000005,3538.5666503333337,3585.583251666667,3592.0166013333337,3639.0332026666665,3532.1333006666673,3485.116699333334,3478.6833496666677,1.6389136259451458,-23999971.0,-1
2016-02-23,3530.0,3568.4499509999996,3480.0,3520.8000490000004,3369.0329590000006,796836.0,3634.5549804,3627.5454233636365,-211.75,28.169007778458294,-9.54558308056441,-264.7783611010309,-57.28722467643846,-1481430.9281432398,279516.0841327342,0.0,72.0,-76.0,199.3000489999995,3523.0833333333335,3566.166666666667,3611.5332843333326,3654.6166176666666,3477.7167156666674,3434.633382333334,3389.2667646666678,0.46127836746908524,-24796807.0,-1
2016-02-24,3499.9499509999996,3530.0,3480.0,3487.399902,3371.2548829999996,605914.0,3617.5849608000003,3600.7899545636365,-169.70019599999978,26.108727417948202,-10.42850750006443,-250.42067275002137,-56.75722191507816,-2525509.6879768074,152014.912673206,0.0,68.0,-76.0,93.5,3499.133300666667,3518.2666013333337,3549.1333006666664,3568.2666013333337,3468.2666013333337,3449.133300666667,3418.2666013333337,0.14799804000000222,-25402721.0,-1
2016-02-25,3509.649902,3510.0,3401.0,3489.6999509999996,3298.269287,840542.0,3598.6999509999996,3577.5381346000004,-188.8500980000008,26.53566847491288,-8.306181669346843,-240.02019807102033,-57.911883597269046,3225.1219775676054,145251.74036885865,0.0,64.0,-76.0,174.75,3466.8999836666662,3532.7999673333325,3575.8999836666662,3641.7999673333325,3423.7999673333325,3357.8999836666662,3314.7999673333325,0.8137610183486201,-24562179.0,+1
2016-02-26,3452.0,3459.100098,3375.100098,3414.149902,3293.487305,831491.0,3585.9699461,3543.983580236363,-127.30004899999949,21.76860492975524,-10.349262026791866,-223.83743382951798,-64.23246264744692,474406.4364960875,160213.31746555126,12.0,96.0,-76.0,190.1499020000001,3416.116699333333,3457.1333006666664,3500.1166993333327,3541.1333006666664,3373.1333006666664,3332.116699333333,3289.1333006666664,0.4648786190476217,-25393670.0,-1
2016-02-29,3425.0,3434.9499509999996,3193.25,3409.1999509999996,3126.6489260000003,2218323.0,3571.924951,3511.843581127273,-140.4499510000005,21.47692465642045,-10.483122266358572,-219.79895390088132,-74.44326168263198,449731.8130542903,173373.2490832215,8.0,96.0,-76.0,161.6999509999996,3345.799967333333,3498.349934666666,3587.499918333333,3740.0498856666654,3256.6499836666662,3104.1000163333333,3014.9500326666666,0.8934629490264148,-27611993.0,-1
2016-03-01,3200.899902,3510.0,3200.899902,3236.5,3375.79541,1924803.0,3524.449951,3450.8572264,-474.75,13.951437264195931,-15.153402197213673,-212.03984588872208,-75.77428704899425,-548720.2866035228,140550.81564291418,4.0,96.0,-72.0,99.14990200000011,3315.799967333334,3430.7000326666675,3624.900065333334,3739.8001306666674,3121.5999346666677,3006.699869333334,2812.4998366666678,0.11517336367845442,-29536796.0,-1
2016-03-02,3542.9499509999996,3627.6999509999996,3540.0500490000004,3494.399902,3490.031982,1236996.0,3503.3699461,3445.3935811272722,-210.8000489999995,46.3459716830566,-8.179082114864023,-185.5777634522642,-10.258773787679848,-917070.7418525546,92477.10848402817,0.0,92.0,-68.0,50.0,3554.049967333334,3568.0498856666673,3641.6998693333326,3655.6997876666665,3480.399983666668,3466.4000653333346,3392.750081666669,-0.5208237083938863,-28299800.0,+1
2016-03-03,3625.8000490000004,3647.0,3578.0,3612.649902,3486.167725,742263.0,3489.7199461,3465.2626640181816,-136.5,55.25739829381936,-4.981278070185304,-179.63248968852577,8.885561286249592,-700234.6725851716,56444.75479906378,0.0,88.0,-64.0,109.0,3612.549967333334,3647.0999346666677,3681.5499673333343,3716.0999346666677,3578.0999346666677,3543.549967333334,3509.0999346666677,0.5021724927536247,-27557537.0,+1
2016-03-04,3619.0,3619.0,3526.0,3608.649902,3434.435547,610234.0,3485.2599363000004,3486.8862923636366,-44.60009799999989,54.90149189556675,-5.0894490315275025,-171.70169675828856,3.7217619391062264,-243134.0598408184,42827.53595179613,0.0,84.0,-84.0,114.59985299999971,3584.549967333334,3643.0999346666677,3677.5499673333343,3736.0999346666677,3550.0999346666677,3491.549967333334,3457.0999346666677,0.8887086236559152,-28167771.0,-1
2016-03-08,3552.9499509999996,3598.9499509999996,3450.600098,3555.100098,3345.123047,1100041.0,3482.8549559000003,3499.5845035818184,-24.049804000000222,49.933476142546795,-6.5375824761190735,-172.68106600107467,-10.271476308459183,9625.598401967682,41318.35697225845,0.0,80.0,-88.0,241.6999509999996,3534.8833823333334,3619.166666666667,3683.233235333333,3767.5165196666667,3470.8168136666673,3386.5335293333337,3322.4669606666675,0.7044159322490209,-29267812.0,-1
2016-03-09,3454.850098,3600.0,3441.100098,3462.649902,3455.0124509999996,752948.0,3477.0399412000006,3495.910857418182,-58.15014700000029,42.3072233243825,-9.037689120517719,-164.39980080457326,-20.54023631245023,-41631.84532201689,37547.89323160951,0.0,76.0,-92.0,309.1000979999999,3501.25,3561.399902,3660.149902,3720.299804,3402.5,3342.350098,3243.600098,0.13561873688254514,-30020760.0,-1
2016-03-10,3600.0,3634.6999509999996,3573.399902,3576.399902,3504.088135,1016572.0,3485.939941200001,3513.976304836364,89.0,52.587479111817885,-5.961577407348971,-152.77039082155807,17.909530619307134,-192913.15732304737,27072.390933670376,4.0,72.0,-92.0,391.1999509999996,3594.833251666667,3616.2666013333337,3656.1333006666664,3677.566650333333,3554.966552333334,3533.5332026666674,3493.6665033333347,0.048939601989551836,-29004188.0,+1
2016-03-11,3633.6999509999996,3690.0,3616.0500490000004,3627.1999509999996,3517.6130369999996,1002559.0,3499.689941200001,3539.659942981818,137.5,56.57483154466167,-1.748817850181019,-136.09149241097884,38.78713194683249,743476.3403134926,59636.206814571924,0.0,68.0,-88.0,152.6000979999999,3644.4166666666665,3672.7832843333326,3718.3666176666657,3746.7332353333322,3598.833333333333,3570.466715666667,3524.8833823333334,0.15077632708640012,-28001629.0,+1
2016-03-14,3660.0,3684.0,3627.0500490000004,3641.1999509999996,3524.326904,483295.0,3522.3949461,3565.389035672727,227.0500489999995,57.705885504303524,-1.3589543024227346,-116.45514300150899,40.91963300943815,-263730.2897243331,44937.72969916692,36.0,64.0,-84.0,93.0,3650.75,3674.4499509999996,3707.6999509999996,3731.399901999999,3617.5,3593.8000490000004,3560.5500490000004,0.24846205750026545,-27518334.0,+1
2016-03-15,3670.0,3679.899902,3615.5,3648.149902,3530.51001,688839.0,3546.2899412,3588.25357310909,238.9499510000005,58.32760133447636,-1.1654162628794178,-97.92113250668172,42.48814998425324,-414956.32227461704,24033.454609449156,32.0,60.0,-80.0,158.04980400000022,3647.8499346666667,3680.1998693333335,3712.249836666667,3744.5997713333336,3615.7999673333334,3583.4500326666666,3551.4000653333333,0.5069868274023158,-26829495.0,+1
2016-03-16,3650.0,3675.0,3637.5,3654.5500490000004,3542.875488,459188.0,3588.0949461000005,3607.9372290727274,418.0500490000004,58.968494374853954,-0.9871888331940852,-71.72645503465355,51.48769071392255,-85805.41988497342,19040.77849606624,28.000000000000004,56.00000000000001,-76.0,158.8999020000001,3655.6833496666673,3673.8666993333345,3693.1833496666677,3711.3666993333345,3636.3666993333345,3618.1833496666673,3598.8666993333345,0.45466797333334397,-26370307.0,+1
2016-03-17,3686.350098,3750.0,3620.0,3667.350098,3512.05835,710449.0,3605.3899657,3622.347256690909,172.95019599999978,60.37479499494207,-2.263760668310055,-41.79153994423632,69.77061921140023,323082.7686025595,32860.86895545249,24.0,52.0,-68.0,172.0500489999995,3679.116699333333,3738.2333986666663,3809.1166993333336,3868.2333986666663,3608.2333986666663,3549.116699333333,3478.2333986666663,0.36423152307692225,-25659858.0,+1
2016-03-18,3640.0,3649.6999509999996,3557.0500490000004,3635.4499509999996,3498.484863,1073782.0,3607.6699706000004,3627.8127085636365,22.80004899999949,54.95824757144338,-3.1374979183785374,9.753949769315568,38.857881925877194,-753469.8989938431,-2881.438678606869,20.0,48.0,-68.0,113.60009799999989,3614.0666503333327,3671.083251666665,3706.7165523333324,3763.7331536666643,3578.433349666666,3521.4167483333335,3485.7834476666667,0.8461951961913556,-26733640.0,-1
2016-03-21,3630.100098,3678.8000490000004,3605.0,3621.399902,3545.000977,474712.0,3608.9449706000005,3630.3090597272726,12.75,52.56178818208906,-3.5223253355245108,30.039471879139455,58.31522061862825,344171.0732741176,12893.67550106262,16.0,44.0,-28.0,56.9499509999996,3635.0666503333337,3665.1333006666673,3708.8666993333336,3738.9333496666677,3591.333251666667,3561.2666013333333,3517.5332026666665,0.22222074676400314,-27208352.0,-1
2016-03-22,3669.0,3735.9499509999996,3652.0,3669.5500490000004,3573.982422,713115.0,3620.3899657,3641.3281648909096,114.44995100000051,59.53844625679799,-2.2035045466995236,27.602964503678777,104.3900641726996,608346.6758381241,39959.720970929375,12.0,40.0,-28.0,64.39990200000011,3685.8333333333335,3719.666666666667,3769.7832843333326,3803.6166176666666,3635.7167156666674,3601.883382333334,3551.7667646666678,0.20905371344410292,-26495237.0,+1
2016-03-23,3711.850098,3744.0,3666.4499509999996,3699.5500490000004,3609.195313,586282.0,3644.0799804,3655.7209073090908,236.9001470000003,63.40732268748057,-1.3818118597644373,27.02088592484779,129.95426793303446,-133158.9297688932,32090.69139184644,8.0,36.0,-28.000000000000004,37.5,3703.3333333333335,3740.2167156666674,3780.8833823333343,3817.7667646666678,3662.666666666667,3625.783284333333,3585.1166176666666,0.42682239955774404,-25908955.0,+1
2016-03-28,3759.0,3777.8000490000004,3629.9499509999996,3736.0,3515.439453,743468.0,3660.0399901999995,3672.433638145454,159.6000979999999,67.73273980840364,-1.1362413951082448,45.43727536582492,118.5954882872979,75061.14854036769,34043.89398950652,4.0,32.0,-28.0,130.0,3714.5833333333335,3799.2167156666674,3862.433431333334,3947.066813666668,3651.3666176666666,3566.7332353333327,3503.5165196666658,0.7172808840478403,-25165487.0,+1
2016-03-29,3649.0,3769.0,3645.0,3638.9499509999996,3603.350342,686482.0,3661.2149902,3668.5990855636364,11.75,49.6885663810218,-3.7743311990480186,75.70401529913897,75.46077197093244,685436.0506426733,63652.62838283258,0.0,28.000000000000004,-28.0,110.30004899999949,3684.3166503333327,3723.6333006666655,3808.3166503333323,3847.6333006666655,3599.6333006666655,3560.3166503333327,3475.6333006666655,-0.0487907177419387,-25851969.0,-1
2016-03-30,3745.0,3749.899902,3684.0,3729.9499509999996,3600.935303,872340.0,3670.0899902,3681.0963511636364,88.75,60.94515526417198,-1.3006985256784418,97.3041235303117,86.43492635176486,-472613.4936929695,39276.895561204976,92.0,24.0,-28.0,73.8000490000004,3721.283284333333,3758.566568666666,3787.1831863333337,3824.4664706666663,3692.666666666666,3655.383382333333,3626.766764666666,0.6972688821297416,-24979629.0,+1
2016-03-31,3739.5,3748.75,3664.0,3727.4499509999996,3590.163818,1223191.0,3678.0199951,3691.5254349454544,79.30004899999949,60.51595838941644,-1.368655467254529,107.13604768311097,62.66341286298784,1601282.5964092487,110277.15469066217,88.0,20.0,-28.0,114.55004899999949,3713.3999836666662,3762.7999673333325,3798.1499836666662,3847.5499673333325,3678.0499673333325,3628.6499836666662,3593.2999673333325,0.7486719882005852,-26202820.0,-1
2016-04-01,3700.4499509999996,3764.9499509999996,3682.0,3716.3000490000004,3596.82959,769731.0,3684.1949950999997,3698.4854447454545,61.75,58.399520194862234,-1.6717407627717469,110.81482442105153,52.51774521419984,1455151.054054054,171407.78647990778,84.0,16.0,-28.0,77.5500490000004,3721.0833333333335,3760.166666666667,3804.0332843333326,3843.1166176666666,3677.2167156666674,3638.133382333334,3594.2667646666678,0.4135029446852906,-26972551.0,-1
2016-04-04,3735.0,3751.5,3676.0,3723.1999509999996,3558.235596,299849.0,3689.7799804,3705.5772549090907,55.84985299999971,59.41306217158382,-1.4841822679338774,110.46150791399577,43.199510962552964,-741966.5798999966,129890.76982627541,80.0,12.0,-28.0,147.8500980000008,3716.8999836666662,3757.7999673333325,3792.3999836666662,3833.2999673333325,3682.2999673333325,3641.3999836666662,3606.7999673333325,0.6251649139072795,-26672702.0,+1
2016-04-05,3676.0,3696.899902,3536.5,3683.25,3434.194092,826024.0,3694.5599853000003,3704.3899857454544,47.8000490000004,51.096303190785875,-2.570132862363686,106.34938423414314,-8.80104119798099,-1140614.9242288012,72140.51100558968,76.0,8.0,-28.000000000000004,124.0,3638.883300666667,3741.2666013333337,3799.2832026666674,3901.666503333334,3580.8666993333336,3478.4833986666667,3420.4667973333335,0.9149008083558549,-27498726.0,-1
2016-04-06,3568.0,3607.3000490000004,3546.0,3554.850098,3451.7761229999996,664480.0,3687.9050049,3678.9881880545454,-66.54980400000022,33.63544182877585,-6.060398717799422,97.25220721696951,-57.842631049780096,-1633051.4127692874,-5368.212802359853,72.0,4.0,68.0,110.94995100000051,3569.3833823333334,3592.766764666667,3630.683431333334,3654.0668136666673,3531.4667156666665,3508.083333333333,3470.166666666666,0.14437342456283894,-28163206.0,-1
2016-04-07,3556.5,3556.5,3450.0,3573.0500490000004,3353.189697,1221608.0,3678.2550049,3658.1054687999995,-96.5,37.14819298583479,-5.565673515081547,87.82708116139383,-88.25333399120753,474108.7589387968,16426.195004056513,68.0,0.0,68.0,84.75,3526.5166830000003,3603.0333660000006,3633.016683,3709.5333660000006,3496.5333660000006,3420.0166830000003,3390.0333660000006,1.1553995211267643,-26941598.0,+1
2016-04-08,3460.0,3474.0,3418.5,3471.0,3314.209229,1631533.0,3655.4,3620.4227406363634,-228.5500490000004,27.67185800628269,-8.339677202173496,77.12735903448083,-135.07349049092895,1561387.6961193825,86651.71778202635,64.0,0.0,68.0,82.9499509999996,3454.5,3490.5,3510.0,3546.0,3435.0,3399.0,3379.5,0.9459459459459459,-28573131.0,-1
2016-04-11,3437.0,3488.0,3423.0,3430.649902,3360.580078,970375.0,3624.8649901999997,3579.5590864545456,-305.3500979999999,24.787109961923207,-9.43650490312365,47.03890297716316,-128.28626001644614,-2169884.1527607027,-15918.09451537109,60.0,96.0,68.0,75.5,3447.2166340000003,3471.4332680000007,3512.2166340000003,3536.4332680000007,3406.4332680000007,3382.2166340000003,3341.4332680000007,0.1176908000000017,-29543506.0,-1
2016-04-12,3470.1999509999996,3609.850098,3465.0500490000004,3478.649902,3452.404297,1404427.0,3608.8349853000004,3552.9745249636367,-160.3000489999995,34.20221920549872,-8.131731624862775,28.342452707473058,-70.87533810429834,-781494.9580543148,-50717.04285805057,56.00000000000001,92.0,68.0,186.6999509999996,3517.8500163333338,3570.649983666667,3662.6500653333333,3715.4500326666666,3425.8499346666677,3373.0499673333343,3281.049885666668,0.09392160495746628,-28139079.0,+1
2016-04-13,3613.0,3745.350098,3606.600098,3573.6999509999996,3604.945068,1107727.0,3593.2099853,3546.5863369090907,-156.25,48.83600121302278,-5.548007374183896,12.81377927252015,4.415666869392588,495265.31300225423,-25899.66304621839,52.0,88.0,68.0,137.25,3641.8833823333334,3677.166666666667,3780.6333823333334,3815.916666666667,3538.416666666667,3503.1333823333334,3399.666666666667,-0.23711817657657866,-27031352.0,+1
2016-04-18,3720.8000490000004,3750.0,3680.0,3731.600098,3592.7238770000004,999621.0,3593.625,3571.748175581818,4.150147000000288,64.12836456134492,-1.2558429483700517,13.512548450574286,52.950041504540515,-1789873.3527581105,-106080.28530585028,48.0,84.0,68.0,106.5,3720.5333659999997,3761.0667319999993,3790.5333659999997,3831.0667319999993,3691.0667319999993,3650.5333659999997,3621.0667319999993,0.7371442571428556,-26031731.0,+1
2016-04-20,3724.350098,3724.350098,3651.0,3718.9499509999996,3545.483887,1830988.0,3593.8899902,3594.5345303090903,2.6499019999992015,62.40417612936762,-1.5997090686132258,-2.2946251400562687,38.61181351339536,-269524.66097875993,-113509.57510916439,44.0,80.0,64.0,154.5500490000004,3698.1000163333333,3745.2000326666666,3771.4501143333327,3818.5501306666665,3671.8499346666667,3624.7499183333334,3598.499836666667,0.9263784623709664,-27862719.0,-1
2016-04-21,3695.0,3737.25,3674.0,3670.0500490000004,3579.537598,1928958.0,3588.5750000000003,3608.381813727273,-53.1499019999992,55.721949673021335,-2.6961839509536674,-25.995434387110436,37.335959178715314,1986660.7943597496,-18047.28558784965,40.0,76.0,-36.0,65.0,3693.7666830000003,3713.5333660000006,3757.016683,3776.7833660000006,3650.2833660000006,3630.5166830000003,3587.0333660000006,-0.06244981818181187,-29791677.0,-1
2016-04-22,3703.0,3833.0,3680.100098,3705.3000490000004,3686.5283200000003,1165761.0,3590.7800049,3629.604549909091,22.0500490000004,59.34305622366076,-3.4199237011247883,-41.640202842795134,67.37532515177689,-497641.3806221555,-39847.017180318195,36.0,72.0,-35.99999999999999,179.20019599999978,3739.466715666667,3798.833333333334,3892.3666176666675,3951.733235333334,3645.933431333334,3586.566813666667,3493.0335293333337,0.16481338882742053,-28625916.0,+1
2016-04-25,3806.100098,3842.0,3715.149902,3816.0500490000004,3601.418457,838216.0,3616.9000000000005,3670.5627397454546,261.1999510000005,68.64034979760707,-0.6932928399679295,-53.394484496806854,101.34025110162587,-19837.11732030816,-38937.47627759046,96.0,68.0,-36.0,266.7001959999998,3791.0666503333337,3866.983398666667,3917.916748333334,3993.833496666667,3740.1333006666673,3664.2165523333338,3613.2832026666674,0.7954282148051661,-27787700.0,+1
2016-04-26,3704.0500490000004,3894.0,3691.899902,3727.9499509999996,3740.144775,2782566.0,3632.3899902000003,3690.7536399272726,154.8999019999992,56.732478411168415,-4.375495362318851,-61.66058000676321,80.52947195074047,-124175.9900313481,-42811.95417548855,96.0,64.0,-36.0,176.3000490000004,3771.283284333333,3850.666666666666,3973.3833823333325,4052.766764666666,3648.566568666666,3569.183186333333,3446.4664706666663,0.17837719702639387,-30570266.0,-1
2016-04-27,3841.100098,3932.75,3830.25,3871.5500490000004,3728.406982,1388262.0,3672.4449951000006,3734.237286981818,400.5500490000004,67.37660541420308,-1.5963469448972831,-48.03521977735272,147.28676299411956,-1746.0563937524894,-40945.3224581369,96.0,60.0,-36.0,80.60009799999989,3878.1833496666673,3926.1166993333345,3980.6833496666677,4028.6166993333345,3823.6166993333345,3775.6833496666673,3721.1166993333345,0.40292730731707704,-29182004.0,+1
2016-04-28,3819.0,3854.0,3735.100098,3859.399902,3620.739746,1821236.0,3715.3199951000006,3768.229088236363,428.75,65.7963597832759,-1.9132728529507634,-35.34584259536814,90.47990831101099,-292474.2332154919,-52378.45476528945,96.0,56.00000000000001,-36.0,63.25,3816.1666666666665,3897.233235333333,3935.066568666666,4016.1331373333333,3778.333333333333,3697.2667646666664,3659.433431333333,1.0454155294425735,-31003240.0,-1
2016-04-29,3742.0,3820.0,3725.0,3747.9499509999996,3665.8544920000004,962848.0,3742.2500000000005,3774.1618074909093,269.3000489999995,52.711547550556496,-4.820346892729062,-8.634533504080537,50.70038721871521,458059.5947846033,-29176.725240294247,92.0,52.0,-36.0,162.9499509999996,3764.3166503333327,3803.6333006666655,3859.3166503333323,3898.6333006666655,3708.6333006666655,3669.3166503333327,3613.6333006666655,0.24157843157894315,-31966088.0,-1
2016-05-02,3799.899902,3840.0,3751.600098,3794.649902,3700.826172,762337.0,3764.3449951000002,3783.6890624000007,220.9499510000005,56.85951292220803,-3.6022197065536323,25.685803724357356,66.40485386564849,-947499.9904928795,-70918.69184268464,88.0,48.0,28.0,136.6999509999996,3795.4166666666665,3839.233235333333,3883.816568666666,3927.6331373333333,3750.833333333333,3707.0167646666664,3662.433431333333,0.4869892729066619,-31203751.0,+1
2016-05-03,3840.8000490000004,3879.0,3795.6999509999996,3830.850098,3690.295654,795697.0,3774.2699951000004,3795.780899290909,99.25,59.99789134654795,-2.6579694033257284,56.70338695141527,86.4410016794681,-691789.6483227559,-99140.09895541526,84.0,44.0,32.0,202.1000979999999,3835.1833496666663,3874.666748333333,3918.4833986666663,3957.9667973333335,3791.3666993333327,3751.883300666666,3708.0666503333323,0.4219703040030639,-30408054.0,+1
2016-05-04,3800.0,3844.0,3796.0500490000004,3819.9499509999996,3682.181152,557609.0,3784.3699951000003,3804.086345818182,101.0,58.518833149200525,-2.9422901597652533,80.17365864115936,76.90736968560944,10070.335288782802,-94175.9883079517,80.0,40.0,36.0,204.8000490000004,3820.0,3843.9499509999996,3867.9499509999996,3891.899901999999,3796.0,3772.0500490000004,3748.0500490000004,0.49843433625196826,-30965663.0,-1
2016-05-05,3825.0,3850.0,3802.0,3811.5500490000004,3706.622314,485772.0,3798.5199951000004,3809.0281738,141.5,57.26361896581363,-3.1613942223671234,85.12676572495957,77.78021657772133,361782.3296265014,-73450.61022002195,76.0,36.0,39.99999999999999,136.4499510000005,3821.1833496666673,3840.3666993333345,3869.1833496666677,3888.3666993333345,3792.3666993333345,3773.1833496666673,3744.3666993333345,0.19895935416667498,-31451435.0,-1
2016-05-06,3829.9499509999996,3835.0,3802.0,3836.850098,3689.330078,411877.0,3811.675,3815.9972834181817,131.5500489999995,60.22838519109349,-2.5014646755787444,95.41432297183655,73.76081379110876,21796.435592190177,-69121.19904673957,72.0,32.0,40.0,134.3999020000001,3824.616699333333,3847.2333986666663,3857.6166993333336,3880.2333986666663,3814.2333986666663,3791.616699333333,3781.2333986666663,1.0560635757575725,-31039558.0,+1
2016-05-09,3830.0,3878.0,3825.0,3818.9499509999996,3715.94458,771389.0,3811.9649902,3817.320001781818,2.8999019999992015,57.00024366978915,-2.9683742810564175,107.10594944467584,70.10913425766208,-679082.0,-96846.68999916056,68.0,28.000000000000004,40.0,92.0500490000004,3840.6499836666662,3856.2999673333325,3893.6499836666662,3909.2999673333325,3803.2999673333325,3787.6499836666662,3750.2999673333325,-0.11415186792453584,-31810947.0,-1
2016-05-10,3850.5,3897.0500490000004,3835.100098,3846.5,3714.30249,1094666.0,3823.8199951000006,3823.5990944727273,118.5500490000004,60.73742217042223,-2.2497554613628954,121.63126969368932,69.75296360701935,-962243.5994502984,-136182.91315603055,64.0,24.0,40.0,84.35009799999989,3859.550049,3884.0,3921.500000000001,3945.9499510000005,3822.0500489999995,3797.6000979999994,3760.100097999999,0.18401793409005307,-30716281.0,+1
2016-05-11,3800.0,3898.0,3790.0,3844.8000490000004,3758.016602,679706.0,3821.1449951000004,3827.413649727273,-26.75,60.36389941179103,-2.2940971894359206,121.51698428244981,48.130921437172766,2256633.830396329,-27418.515721832147,60.0,20.0,40.0,47.9499509999996,3844.2666830000003,3898.5333660000006,3952.266683,4006.5333660000006,3790.5333660000006,3736.2666830000003,3682.5333660000006,0.5074078611111148,-31395987.0,-1
2016-05-12,3884.850098,3909.8000490000004,3841.5,3890.0500490000004,3723.383301,857976.0,3824.2100098000005,3839.941841345455,30.65014700000029,66.66103339553794,-1.1137907010107493,134.5419585318673,54.91666785000592,101394.77212007035,-21563.36627447293,56.00000000000001,16.0,40.0,48.0,3880.450032666667,3919.400065333334,3948.750081666667,3987.7001143333346,3851.1000163333338,3812.1499836666667,3782.7999673333334,0.7108347608945363,-30538011.0,+1
2016-05-13,3856.0,3877.899902,3828.0,3854.1999509999996,3715.703125,435056.0,3834.8350098,3845.3945579272727,106.25,58.20728997936799,-2.0489090055428862,127.892319126654,31.28824121728732,81596.39213630767,-16874.286346710167,52.0,12.0,40.0,33.0,3853.3666176666666,3878.733235333333,3903.2665196666667,3928.6331373333333,3828.833333333333,3803.4667156666665,3778.933431333333,0.5250501493970778,-30973067.0,-1
2016-05-16,3870.0,3895.0,3840.0,3846.25,3749.8535159999997,878812.0,3839.9950196,3847.4700106909095,51.60009799999989,56.37789334645923,-2.2562764916856866,119.71851580789553,30.57176484198797,110166.76125607961,-11099.693273856075,48.0,8.0,40.0,53.0,3860.4166666666665,3880.833333333333,3915.416666666666,3935.833333333333,3825.833333333333,3805.4166666666665,3770.833333333333,0.11363636363636363,-31851879.0,-1
2016-05-17,3891.0500490000004,3969.0,3886.25,3881.600098,3816.60791,865028.0,3845.0700196000003,3855.0345704,50.75,62.43527318143795,-2.2583954005167985,119.77255889062599,55.96433333741748,-21515.93513170024,-11573.158812848993,44.0,4.0,40.0,78.1000980000008,3912.2833659999997,3938.3167319999993,3995.0333659999997,4021.0667319999993,3855.5667319999993,3829.5333659999997,3772.8167319999993,-0.056192169184291374,-30986851.0,+1
2016-05-18,3928.8000490000004,3939.0,3805.0500490000004,3950.6999509999996,3782.023193,1921044.0,3858.1450196,3874.2400124727274,130.75,71.39436791616927,-0.4728694832041446,116.79122179064416,45.28648725440588,-1044392.0407649595,-58519.47162885408,96.0,0.0,40.0,108.0,3898.25,3991.4499509999996,4032.1999509999996,4125.399901999999,3857.5,3764.3000490000004,3723.5500490000004,1.0873456907796826,-29065807.0,+1
2016-05-19,3900.0,3940.0,3881.0,3914.899902,3793.326172,679821.0,3868.4800049000005,3884.5590820000007,103.34985299999971,62.48558927209685,-1.3979353488372066,101.74128364244552,49.30157037559827,-332948.4206959477,-70993.51476826744,92.0,0.0,40.00000000000001,68.3000490000004,3911.9666340000003,3942.9332680000007,3970.9666340000003,4001.9332680000007,3883.9332680000007,3852.9666340000003,3824.9332680000007,0.5745746101694934,-29745628.0,-1
2016-05-20,3883.8000490000004,3959.0,3881.100098,3926.600098,3811.052979,485214.0,3877.4550049000004,3895.1263716545454,89.75,64.17152109603519,-1.09560470284238,85.68360514585765,50.42396354682854,-211687.01812792564,-77388.67401188829,88.0,0.0,40.0,62.0500490000004,3922.2333986666667,3963.3666993333336,4000.1333006666673,4041.2666013333337,3885.4667973333335,3844.3334966666666,3807.5668953333334,0.5840828914008125,-29260414.0,+1
2016-05-23,3964.0,3968.3000490000004,3900.0,3944.9499509999996,3781.008789,348354.0,3890.0550049000003,3907.3981800363636,126.0,66.8661624894998,-0.6214482945736537,74.1103211675013,57.26932393701285,460929.1963845576,-52919.6799029589,84.0,0.0,40.0,55.0,3937.75,3975.5,4006.0500490000004,4043.8000490000004,3907.1999509999996,3869.4499509999996,3838.899901999999,0.6581247255034816,-28912060.0,+1
2016-05-24,3913.8000490000004,3937.9499509999996,3893.149902,3913.850098,3791.007568,283533.0,3896.7900147,3911.7245605999997,67.35009799999989,58.29262807720879,-1.4250620671834655,64.22220285884396,38.938442435555444,-568187.1563789052,-76340.92883368376,80.0,4.0,40.0,122.75,3914.9833169999997,3936.8167319999993,3959.7833659999988,3981.616780999999,3892.016683,3870.183268,3847.2166340000003,0.4620574410532456,-29195593.0,-1
2016-05-25,3948.0,4072.0,3940.0,3924.1999509999996,3923.116211,842663.0,3904.7300048999996,3916.708185381818,79.3999019999992,60.24974669574569,-3.7201119808708882,67.09409495799264,84.84216037936525,-346512.08274480706,-88621.43582964392,76.0,0.0,96.0,133.9499509999996,3978.7333169999997,4017.4666339999994,4110.733317,4149.466633999999,3885.4666339999994,3846.7333169999997,3753.4666339999994,-0.11969734090909394,-28352930.0,+1
2016-05-26,4064.0,4125.0,4027.1999509999996,4060.9499509999996,3978.229736,1074664.0,3921.8199950999997,3945.111811945455,170.8999019999992,76.82733538265593,-1.590910307998023,69.43388210113062,145.1427844624884,68089.03994052083,-81498.2323855455,96.0,0.0,92.0,69.6999509999996,4071.049967333333,4114.899983666666,4168.850016333333,4212.700032666667,4017.099934666666,3973.2499183333325,3919.2998856666654,0.3450918516410954,-27278266.0,+1
2016-05-27,4114.700195,4162.0,4091.0500490000004,4118.0,4005.859131,880888.0,3948.2000000000007,3980.7809037454545,263.8000490000004,80.70152627584147,-1.0829436377061286,71.26199614942516,161.3455107405447,-448565.2174450885,-98183.09534279747,96.0,0.0,88.0,77.89990200000011,4123.683349666667,4156.316650333333,4194.6333006666655,4227.266601333333,4085.3666993333336,4052.733398666667,4014.416748333334,0.3798445329440714,-26397378.0,+1
2016-05-30,4132.0,4155.200195,4054.0,4146.600098,3933.549561,555311.0,3978.2350098000006,4016.853648836364,300.3500979999999,82.40327807063423,-0.37902786118631826,70.6411566683878,135.31469956319137,451590.3970015182,-73193.39114532857,96.0,4.0,84.0,68.3000490000004,4118.600097666666,4183.200195333333,4219.800292666667,4284.400390333333,4082.0000003333325,4017.399902666666,3980.799805333332,0.9150189680958576,-25842067.0,+1
2016-05-31,4060.0,4180.0,4055.0500490000004,4071.75,4020.350098,775477.0,3997.25,4033.8563743272725,190.1499020000001,65.07484934052654,-2.6525361431021808,81.00471219564588,109.4744135879586,-152479.44731737682,-76797.30278951257,92.0,0.0,76.0,51.80004899999949,4102.266683000001,4149.483317000001,4227.216634000001,4274.433268000001,4024.5333660000015,3977.316732000001,3899.583415000002,0.1336531216406772,-26617544.0,-1
2016-06-01,4170.700195,4199.950195,4150.0,4161.600098,4023.9729,647041.0,4018.3400147,4063.738210327272,210.9001470000003,72.95276966219598,-0.9351514935918518,90.66581688305314,132.9282174078623,-214881.45622855847,-83073.85521856011,96.0,8.0,76.0,158.1499020000001,4170.516764333333,4191.033528666667,4220.466959333335,4240.983723666667,4141.0833336666665,4120.566569333333,4091.133138666666,0.23223328757775236,-25970503.0,+1
2016-06-02,4150.0,4194.950195,4124.0,4165.350098,4044.5493159999996,411143.0,4043.3850343,4090.467316381818,250.45019599999978,73.24341581887582,-0.8437092711388184,106.18184110814991,109.17840771545839,-58629.84592836317,-81962.76388718754,96.0,4.0,96.0,200.8000490000004,4161.433431,4198.866862000001,4232.383626000001,4269.817057000001,4127.916667,4090.483236,4056.966472,0.5828045715730547,-25559360.0,+1
2016-06-03,4192.149902,4235.0,4180.0,4186.649902,4074.787842,591630.0,4069.3900147,4116.515474145454,260.0498040000002,75.00380213812585,-1.1690062379110224,113.44162555262164,110.95976483487757,197937.6132079186,-69240.01947377362,92.0,0.0,96.0,101.0500490000004,4200.549967333333,4221.099934666667,4255.5499673333325,4276.099934666667,4166.099934666667,4145.549967333333,4111.099934666667,0.1209073090909111,-24967730.0,+1
2016-06-06,4216.0,4217.0,4118.0,4217.950195,4001.415283,443085.0,4096.6900391,4143.526416018181,273.00024400000075,77.51245237068811,-0.4122293278529896,120.76610851213809,86.54400516609005,48204.875,-63901.61517951118,96.0,0.0,92.0,101.20019500000035,4184.316731666667,4250.633463333334,4283.316731666666,4349.633463333334,4151.633463333334,4085.316731666667,4052.6334633333336,1.009597929292933,-24524645.0,+1
2016-06-07,4175.0,4188.950195,4118.0,4142.0,3995.280762,471388.0,4119.5050292999995,4151.764590727273,228.1499020000001,60.509689991270086,-2.248549323017408,129.00633562710163,61.26976612933177,118468.24578968331,-55612.0760445478,92.0,24.0,92.0,124.9499509999996,4149.650065000001,4181.300130000001,4220.600260000001,4252.250325000002,4110.349935000001,4078.6998700000004,4039.3997400000007,0.3382654550843713,-24996033.0,-1
2016-06-08,4131.0,4169.799805,4124.700195,4135.649902,4018.9011229999996,417715.0,4140.6500244,4154.700022127272,211.4499510000005,59.25574662060868,-2.4020816731141172,138.216164644547,50.39453828065844,-586262.528793136,-79732.55116948365,88.0,20.0,88.0,128.20019500000035,4143.383300666667,4162.066406333334,4188.482910666667,4207.166016333334,4116.966796333335,4098.283690666668,4071.8671863333357,0.24278939440939581,-25413748.0,-1
2016-06-09,4152.049805,4189.75,4140.0,4160.100098,4027.6435549999997,305434.0,4150.5650391,4158.236399145454,99.15014700000029,62.69069329056772,-1.81092606382979,153.2933230936501,51.83786001886948,2118604.9375424683,20191.88013560516,84.0,16.0,92.0,70.95019500000035,4163.283366,4186.566731999999,4213.033366,4236.316731999999,4136.816731999999,4113.533366,4087.0667319999993,0.4040220703517566,-25108314.0,+1
2016-06-10,4165.100098,4197.0,4100.0,4169.149902,3971.950439,464892.0,4155.6800293,4161.615465127273,51.14990200000011,63.987316681637154,-1.592120357833653,168.70732044834222,41.377738853368946,-1227346.7885948366,-36514.422988505874,80.0,12.0,92.0,69.64990200000011,4155.383300666667,4210.766601333335,4252.383300666668,4307.766601333335,4113.766601333335,4058.3833006666673,4016.7666013333346,0.7128855876288671,-24643422.0,+1
2016-06-13,4074.0,4150.0,4062.0,4111.5,3994.410889,385639.0,4152.170019499999,4153.582732527273,-35.10009799999989,50.9676804795565,-2.9859767891682787,166.84808837025548,16.795948152924236,156027.74406911663,-27762.50630406848,76.0,8.0,96.0,99.0,4107.833333333333,4153.666666666666,4195.833333333332,4241.666666666666,4065.666666666666,4019.833333333333,3977.666666666666,0.5625,-25029061.0,-1
2016-06-14,4145.0,4155.899902,4096.0,4134.75,3965.187988,403193.0,4158.4700195000005,4150.4154562545455,63.0,55.20870568648509,-2.4238394584139265,156.72991197427473,21.06768781538989,-92763.7799206965,-30717.10965027885,72.0,4.0,68.0,99.95019500000035,4128.883300666667,4161.766601333335,4188.783202666667,4221.666503333335,4101.8666993333345,4068.983398666667,4041.9667973333344,0.6469125775865198,-24625868.0,+1
2016-06-15,4125.0,4215.0,4112.100098,4104.5,4066.7211909999996,510807.0,4152.7600097,4140.602725436364,-57.10009799999989,48.86378951736183,-3.155222437137331,143.24601129261282,22.792737092591167,69652.49774974126,-26154.854768459747,68.0,0.0,68.0,45.0996099999993,4143.866699333333,4175.6333006666655,4246.766601333332,4278.533202666666,4072.7333986666654,4040.9667973333326,3969.8334966666653,-0.07385913739742804,-25136675.0,-1
2016-06-16,4160.0,4164.0,4062.0,4209.600098,3945.4804689999996,1118517.0,4157.1850097,4150.937286945455,44.25,64.99263787110951,-0.6141175531914921,142.44981411688696,19.69455718433663,45333.33512544767,-22905.39159146395,64.0,16.0,68.0,54.10009799999989,4145.200032666667,4228.400065333333,4247.2000326666675,4330.400065333333,4126.400065333333,4043.2000326666666,4024.4000653333333,1.4470597843137245,-24018158.0,+1
2016-06-17,4115.0,4158.0,4093.4499509999996,4084.100098,3974.8486329999996,951658.0,4146.930029300001,4137.649121181818,-102.54980400000022,45.304499082412306,-3.6484502417794995,129.11273083237757,0.583608693017785,2618090.374722838,97139.87051373169,60.0,12.0,68.0,97.0,4111.850016333333,4130.250081666666,4176.400065333334,4194.8001306666665,4065.7000326666657,4047.2999673333325,4001.1499836666653,-0.14484656704133028,-24969816.0,-1
2016-06-20,4076.5500490000004,4144.799805,4065.6999509999996,4114.5,3992.913818,667114.0,4136.5850098,4131.752752218182,-103.45019500000035,49.573948073972275,-2.913442940038685,113.01263053102275,-5.975285057948989,1102764.2015974058,142850.06738117145,56.00000000000001,8.0,68.0,107.14990200000011,4108.333251999999,4150.966552999999,4187.4331059999995,4230.066406999999,4071.8666989999992,4029.2333979999994,3992.766844999999,0.6169423397418706,-24302702.0,+1
2016-06-21,4146.0,4168.100098,4109.0,4133.200195,4016.2924799999996,512383.0,4135.7050293,4131.137331345455,-8.799804999999651,52.22109632310874,-2.461310565764015,93.01159151212778,3.9595817066095265,-1071453.4272158104,87654.4539903995,52.0,4.0,68.0,59.89990200000011,4136.766764333333,4164.533528666667,4195.866862333332,4223.633626666667,4105.433430666667,4077.6666663333335,4046.333332666667,0.40947808580622647,-23790319.0,+1
2016-06-22,4145.0,4180.5,4125.049805,4157.399902,4010.4479979999996,417540.0,4137.8800292999995,4135.081853654546,21.75,55.69403694067106,-1.876211266924562,70.25903752718796,10.891516762221636,-909219.7519022598,42341.99008618768,48.0,0.0,68.0,102.89990200000011,4154.316569,4183.583333,4209.766763999999,4239.033528,4128.133137999999,4098.866373999999,4072.682942999999,0.5834081737674729,-23372779.0,+1
2016-06-23,4151.899902,4175.0,4120.450195,4151.350098,4027.1125490000004,341093.0,4137.0050292999995,4137.530957054545,-8.75,54.55027091352613,-2.022483123791105,61.1519599522494,4.980932781348445,-1175264.162861296,-13003.744138697983,44.0,0.0,48.0,102.0,4148.933431,4177.416667,4203.483236000001,4231.966472,4122.866862000001,4094.3836260000007,4068.317057000001,0.5664530423160952,-23713872.0,-1
2016-06-24,4053.0,4092.100098,3866.600098,4168.600098,3931.907227,1559787.0,4136.9500489,4143.275514999999,-0.549804000000222,57.42674863413443,-1.17532544924721,50.780097550138635,-99.55441732402132,276049.7503338062,135.05106459767305,40.0,0.0,48.0,116.15014700000029,4042.4334313333334,4218.266764666667,4267.933431333334,4443.766764666667,3992.766764666667,3816.9334313333334,3767.266764666667,1.3392461197339247,-22154085.0,+1
2016-06-27,4061.0,4061.0,4004.100098,4070.0500490000004,3888.48291,836629.0,4132.8050538,4131.111878654546,-41.4499509999996,40.52124404837019,-3.521621744412041,34.78091509682781,-103.66514069521077,-152789.3224462712,-6816.056822260009,36.0,96.0,48.00000000000001,79.09985400000005,4045.050049,4086.0,4101.949951,4142.899902,4029.100098,3988.150147,3972.200196,1.1590521017066142,-22990714.0,-1
2016-06-28,4041.100098,4081.9499509999996,4040.0,4025.100098,3940.263428,626447.0,4121.840063600001,4111.529159418182,-109.64990200000011,35.08546894649045,-4.6137002429543275,16.497702137728993,-102.30012764151999,-23900.802907888406,-7592.636189788573,32.0,92.0,48.0,59.10009799999989,4049.016683,4058.0333659999997,4090.9666339999994,4099.983316999999,4016.083415,4007.0667320000002,3974.1334640000005,-0.3551828225019918,-23617161.0,-1
2016-06-29,4100.0,4141.0,4089.1999509999996,4078.6999509999996,3991.030029,646945.0,4119.260058700001,4103.685502581819,-25.8000490000004,45.19991740439927,-3.311468634596706,4.6002420557697405,-33.64076449835004,159659.7664791832,9.745749710150209,28.000000000000004,88.0,48.0,55.45019500000035,4102.966633999999,4116.733316999999,4154.766683000001,4168.533366,4064.933267999999,4051.166584999999,4013.1332189999985,-0.20270251095708267,-22970216.0,+1
2016-06-30,4179.899902,4200.0,4145.549805,4131.25,4045.081543,770542.0,4111.425048900001,4105.865491909091,-78.35009799999989,53.411653951163835,-2.0347424684159376,-9.118334894326836,44.35140479041112,-102358.93173102487,-4643.375953959628,24.0,84.0,44.0,54.54980499999965,4158.933268333333,4172.316731666667,4213.3834633333345,4226.766926666667,4117.866536666666,4104.483073333333,4063.416341666666,-0.2626217408404058,-22199674.0,+1
2016-07-01,4188.600098,4214.200195,4132.0,4187.200195,4024.0207520000004,804652.0,4121.735058600001,4119.6427912,103.10009700000046,60.65472528623879,-0.67540828474246,-9.043959726514913,83.5295534832684,-822627.9990040698,-41824.495183510124,20.0,80.0,40.0,284.75,4177.8001300000005,4223.600260000001,4260.000325000001,4305.800455000001,4141.400065000001,4095.599935,4059.1998700000004,0.6715336259238815,-21395022.0,+1
2016-07-04,4171.0,4190.5,4155.75,4165.399902,4032.1354979999996,343648.0,4126.8250488,4127.581853636364,50.89990200000011,56.69215423293214,-1.2050558309037875,-20.673020830777205,71.45827634228613,-975848.1931779173,-84280.11781961958,16.0,76.0,-60.0,164.5,4170.549967333333,4185.349934666667,4205.2999673333325,4220.099934666667,4150.599934666667,4135.799967333333,4115.849934666667,0.277695021582737,-21738670.0,-1
2016-07-05,4180.0,4202.0,4150.0,4173.799805,4031.7006840000004,282439.0,4130.8850098,4136.1227184,40.5996099999993,57.91452923313166,-1.000976554907686,-13.29761409562434,78.27514176317108,563927.6318603405,-54816.12919780319,12.0,72.0,-60.0,41.9499509999996,4175.266601666666,4200.5332033333325,4227.266601666666,4252.5332033333325,4148.5332033333325,4123.266601666666,4096.5332033333325,0.457688557692301,-21456231.0,+1
2016-07-07,4181.100098,4189.899902,4125.0,4173.350098,4000.546143,325843.0,4132.4800294,4143.843643527272,15.950195999999778,57.81372654233878,-0.9926636631100874,-14.293028128066908,56.47175284434946,-689490.2740325652,-83664.95396301965,8.0,68.0,-60.0,115.89990200000011,4162.75,4200.5,4227.649902000001,4265.399902,4135.600098,4097.850098,4070.700196,0.7449949308089835,-21782074.0,-1
2016-07-08,4142.0,4175.649902,4126.0,4141.100098,4020.5429689999996,261295.0,4131.4550294,4145.410928727273,-10.25,50.53544769762007,-1.7763436415272733,-12.94740481944882,32.70604297887859,-304454.0944791551,-93700.82398648036,4.0,64.0,-60.0,121.3000490000004,4147.583333333333,4169.166666666666,4197.233235333333,4218.816568666666,4119.516764666666,4097.933431333333,4069.866862666666,0.3041314764327199,-22043369.0,-1
2016-07-11,4190.0,4285.899902,4189.950195,4161.799805,4127.050781,518428.0,4130.7750001,4150.9281606545455,-6.800293000000238,54.75397214921171,-2.9640091691879302,-14.22931554992283,135.74006709589744,-273451.72481255024,-101871.31947857446,0.0,60.0,-60.0,82.95019500000035,4212.549967333333,4235.149739666666,4308.499674333333,4331.099446666666,4139.200032666667,4116.600260333334,4043.250325666667,-0.2933869303008999,-21524941.0,+1
2016-07-12,4300.0,4382.0,4291.0,4272.049805,4222.062988000001,688921.0,4150.9749757,4176.6144888181825,201.99975599999925,70.31329733375051,-2.5671303992528682,-10.623285904713157,257.63543761870545,-189394.0,-105849.62313863925,96.0,56.00000000000001,-60.0,34.75,4315.016601666666,4339.0332033333325,4406.016601666666,4430.0332033333325,4248.0332033333325,4224.016601666666,4157.0332033333325,-0.20824390109890492,-20836020.0,+1
2016-07-13,4350.0,4360.0,4301.0,4370.399902,4174.726074,416940.0,4185.5049561000005,4216.509929963637,345.2998040000002,78.07416847899505,-0.27084048564090335,-4.620677312278531,224.76201725054926,57694.28683717724,-98415.80904882941,96.0,52.0,-60.0,52.0,4343.799967333333,4386.599934666667,4402.7999673333325,4445.599934666667,4327.599934666667,4284.799967333333,4268.599934666667,1.1762695254237308,-20419080.0,+1
2016-07-14,4326.0,4439.0,4326.0,4321.399902,4277.997559,637580.0,4209.7749512,4241.218101945455,242.6999510000005,67.87371815839043,-2.709679677419352,10.038370405224669,191.1328718106206,114910.04732610947,-88719.1792136049,92.0,48.0,-60.0,64.89990200000011,4362.133300666667,4398.266601333335,4475.133300666668,4511.266601333335,4285.266601333335,4249.133300666667,4172.266601333335,-0.0407088318584061,-21056660.0,-1
2016-07-15,4450.0,4493.549805,4404.5,4428.299805,4320.262695,654076.0,4239.4799317,4280.949893545455,297.04980499999965,75.82459289785366,-1.4847937307653294,35.118290139073906,211.7693822473233,-205473.5237377219,-94026.19487379205,96.0,44.0,-60.0,49.64990200000011,4442.1165366666655,4479.733073333331,4531.166341666665,4568.782878333331,4390.683268333331,4353.066731666666,4301.633463333332,0.2672639766027533,-20402584.0,+1
2016-07-18,4477.0,4564.399902,4432.399902,4472.049805,4303.549805,684924.0,4267.964892700001,4323.235325054546,284.8496099999993,78.35432343990146,-2.0681260139464315,57.96149868181692,205.2146080551183,-543331.046873331,-114449.14269195292,96.0,40.0,-60.0,144.79980400000022,4489.616536333334,4546.833170666668,4621.616536333334,4678.833170666668,4414.833170666668,4357.616536333334,4282.833170666668,0.3003780530302995,-19717660.0,+1
2016-07-19,4455.200195,4499.0,4440.0,4454.75,4333.449707,378788.0,4296.8999025,4357.196253654545,289.3500979999999,74.78390070421142,-2.455544954683436,75.94152407796992,152.02045354813512,907551.7044005991,-67994.55873320052,96.0,36.0,39.99999999999999,220.20019500000035,4464.583333333333,4489.166666666666,4523.583333333332,4548.166666666666,4430.166666666666,4405.583333333333,4371.166666666666,0.25,-20096448.0,-1
2016-07-20,4471.850098,4510.0,4452.049805,4485.700195,4317.460449,357560.0,4328.0899415,4391.523579563636,311.9003900000007,76.95191257331693,-1.7624335720693478,85.10735363921685,137.55026112671322,-2008225.8522894986,-156186.89025848688,92.0,32.0,44.0,87.95019500000035,4482.583333333333,4513.116861666666,4540.5335283333325,4571.067056666667,4455.166666666666,4424.633138333333,4397.216471666666,0.580677769936762,-19738888.0,+1
2016-07-21,4489.0,4493.049805,4405.25,4469.149902,4263.893555,252227.0,4357.6699219,4417.170845109091,295.7998040000002,73.07536645254578,-2.133067633143868,99.89098703013042,101.19434949100717,-2097827.0136012724,-244443.25950134083,88.0,28.000000000000004,44.0,113.0,4455.816569,4506.383137999999,4543.616373999999,4594.182942999999,4418.583333,4368.016764,4330.783528,0.7277909330208691,-19991115.0,-1
2016-07-22,4421.0,4449.0,4405.0,4413.700195,4264.859375,339886.0,4384.9299316,4427.358167490909,272.60009700000046,61.16397001058514,-3.3748311530284925,112.04130888345298,71.73689182902096,-135591.28519114607,-239495.44248724106,84.0,24.0,52.0,172.14990299999954,4422.566731666667,4440.133463333334,4466.566731666666,4484.133463333334,4396.133463333334,4378.566731666667,4352.133463333334,0.1977317045454625,-20331001.0,-1
2016-07-25,4427.0,4565.0,4421.0,4414.700195,4396.098145,499616.0,4410.2199706,4432.770942654545,252.9003900000007,61.295251826296365,-3.3654233094491635,132.63456284549738,77.87252398434426,-1520624.568807949,-297728.5845927278,80.0,20.0,56.0,136.10009700000046,4466.900065000001,4512.800130000001,4610.900065000002,4656.800130000001,4368.800130000001,4322.900065000001,4224.800130000001,-0.04374864583333091,-19831385.0,+1
2016-07-26,4575.149902,4584.0,4451.149902,4550.549805,4319.538086,1828186.0,4438.0699706,4458.285458,278.5,74.7007648985371,-0.7458237458194058,155.62220440062265,88.07184490603623,-1889789.2515723272,-370094.9785463461,96.0,16.0,60.0,59.0,4528.566569,4605.983235999999,4661.416666999999,4738.833333999999,4473.133137999999,4395.716471,4340.283039999999,0.7482109873942255,-18003199.0,+1
2016-07-27,4510.299805,4628.0,4510.0,4471.299805,4403.440918,1212744.0,4448.1599609,4464.327246072728,100.89990299999954,60.57791620841181,-3.4599292338264593,178.53350482523638,75.87313864618451,604687.6263611618,-325786.6783232775,96.0,12.0,60.0,57.95019500000035,4536.433268333333,4562.866536666666,4654.433268333334,4680.866536666666,4444.866536666666,4418.433268333333,4326.866536666666,-0.3279677542372911,-19215943.0,-1
2016-07-28,4579.0,4784.0,4570.549805,4558.149902,4601.820313,1879461.0,4471.8349609,4484.325417181818,236.75,68.18400952094464,-4.820706467449304,191.91295421644372,96.75136056622036,-640594.9315637449,-340096.1443796624,96.0,8.0,60.0,87.79980499999965,4637.566569,4704.583333,4851.016763999999,4918.033528,4491.133137999999,4424.116373999999,4277.682942999999,-0.058092722754362065,-17336482.0,+1
2016-07-29,4751.0,4824.0,4720.549805,4763.5,4596.120605,799265.0,4505.3549804,4537.3554242909095,335.20019500000035,79.15583826248654,-1.2804232804232805,200.03481393068887,120.13978245496152,-788821.5209915056,-360492.75240747345,96.0,4.0,60.0,64.14990200000011,4769.349934999999,4818.150064999999,4872.800129999999,4921.600259999999,4714.699869999999,4665.899739999999,4611.249674999998,0.41517751609844916,-16537217.0,+1
2016-08-01,4798.950195,4885.0,4772.25,4757.600098,4701.083984000001,1206974.0,4533.9100097,4583.218172945455,285.55029300000024,78.26113808914569,-2.6619285833681596,216.34547760095666,110.29668592576591,-824081.8474182421,-381564.98399887205,96.0,0.0,60.0,151.29980499999965,4804.950032666667,4837.650065333333,4917.7000326666675,4950.400065333333,4724.900065333333,4692.200032666667,4612.150065333333,-0.12993261197339345,-17744191.0,-1
2016-08-02,4900.0,5039.0,4880.0,4866.25,4816.816895,1611134.0,4575.0600097,4643.643625727273,411.5,82.47112746456753,-3.4969635627530367,223.76334162035528,126.54803944584981,221709.2898558304,-354143.4260963855,96.0,0.0,80.0,169.29980499999965,4928.416666666667,4976.833333333334,5087.416666666668,5135.833333333334,4817.833333333334,4769.416666666667,4658.833333333334,-0.08647798742138364,-16133057.0,+1
2016-08-03,5014.899902,5020.0,4853.149902,4986.049805,4708.425293,1019631.0,4625.0949707,4718.369043054546,500.3496099999993,85.93625906250202,-1.0718662955465659,223.58307296665043,113.5726178733924,361381.3024163991,-321619.57480034983,96.0,0.0,84.0,118.0,4953.066569,5052.983235999999,5119.916666999999,5219.833333999999,4886.133137999999,4786.216471,4719.283039999999,0.7965227745925545,-15113426.0,+1
2016-08-04,4945.0,4945.0,4869.350098,4873.850098,4723.689453,727097.0,4665.5649903,4763.597248018182,404.7001959999998,70.80964618365712,-3.3431154251012165,221.74965665360014,84.47200513672357,-27870.081531005388,-308267.32510628866,92.0,0.0,88.0,312.70019500000035,4896.066731999999,4922.783365999999,4971.716633999999,4998.433267999999,4847.133463999999,4820.416829999999,4771.4835619999985,0.05948454500311175,-15840523.0,-1
2016-08-05,4919.0,4965.0,4900.0,4889.649902,4773.923828,598288.0,4713.159961,4804.339959236364,475.94970699999976,71.62129054050298,-3.0232813360323867,220.80201491775006,78.7109933028301,-220077.16762895774,-304258.6815845918,88.0,16.0,92.0,265.8500979999999,4918.216634,4936.433268000001,4983.216634,5001.433268000001,4871.433268000001,4853.216634,4806.433268000001,-0.1592322769230752,-15242235.0,+1
2016-08-08,4980.0,5010.0,4960.049805,4941.649902,4822.32373,474502.0,4765.854931700001,4845.883584872727,526.9497069999998,74.33163320705995,-1.9706497570850179,228.40518746585622,80.9209396387254,-23130.639075251835,-291480.1341978036,84.0,12.0,96.0,121.5,4970.566569,4981.083333,5020.516763999999,5031.033528,4931.133137999999,4920.616373999999,4881.182942999999,-0.3683649883648985,-14767733.0,+1
2016-08-09,5009.899902,5021.75,4915.399902,4991.75,4792.472168,508711.0,4809.974951200001,4886.9554154727275,441.20019500000035,76.79534454936012,-0.9564777327935222,251.06153193207138,72.84413447589041,-256330.16814227894,-289882.40846800705,80.0,8.0,96.0,281.3999020000001,4976.299967333333,5037.200032666667,5082.650065333332,5143.5501306666665,4930.849934666667,4869.9498693333335,4824.499836666667,0.7179128128306941,-14259022.0,+1
2016-08-10,4975.0,4980.0,4850.0,4960.850098,4696.59082,512317.0,4858.929980500001,4914.387260345455,489.55029300000024,71.88516584156505,-1.5819818218623505,275.04648590315446,55.32192388773474,-697824.2776303695,-308425.22070265986,76.0,4.0,96.0,166.8500979999999,4930.283366,5010.566731999999,5060.283366,5140.566731999999,4880.566731999999,4800.283366,4750.566731999999,0.8526930615384607,-14771339.0,-1
2016-08-11,4862.100098,4923.5,4805.0,4861.600098,4713.062011999999,623156.0,4889.2750001,4914.872736254545,303.4501959999998,58.1141592857347,-3.5910911336032414,281.4004678024721,35.23081807356067,91274.60209288847,-290257.04693922587,72.0,0.0,92.0,116.69970699999976,4863.366699333333,4921.733398666665,4981.866699333332,5040.233398666665,4803.233398666665,4744.866699333333,4684.733398666665,0.47763795780590623,-15394495.0,-1
2016-08-12,4882.0,4940.0,4847.100098,4878.649902,4732.334961,686072.0,4900.7899903,4912.9409002363645,115.14990200000011,59.64646279822139,-3.2459534008097144,301.6319446518528,35.80171529952898,319208.4841513034,-262554.06825329264,68.0,0.0,72.0,91.14990200000011,4888.583333333333,4930.066568666666,4981.483235333332,5022.966470666666,4837.166666666666,4795.683431333333,4744.266764666666,0.33961073500379135,-14708423.0,+1
2016-08-16,4948.0,4948.0,4852.0,4898.600098,4699.103027,793106.0,4914.8899903,4912.542738,141.0,61.545778949720145,-2.8421032793522287,311.40933595058414,33.900307706067146,99611.74739590813,-246091.9857237835,64.0,0.0,72.0,120.35009799999989,4899.533366,4947.066731999999,4995.533366,5043.066731999999,4851.066731999999,4803.533366,4755.066731999999,0.48541768749999886,-13915317.0,+1
2016-08-17,4860.0,4911.299805,4849.100098,4864.200195,4723.882324,498247.0,4914.6850098,4903.326411581818,-2.049804999999651,56.275950814234264,-3.53845759109311,294.89381290943857,24.66682529550795,-1982588.645563162,-325023.65208011895,60.0,0.0,72.0,106.35009799999989,4874.866699333333,4900.6333006666655,4937.066406333332,4962.833007666665,4838.433593666666,4812.666992333333,4776.233886666666,0.24276797638291958,-14413564.0,-1
2016-08-18,4920.850098,4950.0,4901.0,4889.850098,4749.0,479572.0,4905.0650391,4898.810973072727,-96.19970699999976,59.27597843861098,-3.0192287854251036,287.02065597835826,28.97310036628417,96147.72575573139,-305879.4985421257,56.00000000000001,0.0,72.0,141.75,4913.616699333333,4926.233398666665,4962.616699333332,4975.233398666665,4877.233398666665,4864.616699333333,4828.233398666665,-0.22754902040816552,-13933992.0,+1
2016-08-19,4916.0,4933.200195,4889.049805,4915.850098,4733.78418,426426.0,4909.265039100001,4900.771892872727,42.0,62.30126929776266,-2.492912995951419,271.1784427469147,24.61012100668381,-46834.150924148445,-294104.7100140358,52.0,0.0,72.0,155.8500979999999,4912.700032666667,4936.350260333334,4956.850422666667,4980.500650333334,4892.199870333333,4868.549642666666,4848.049480333332,0.6070227918711435,-13507566.0,+1
2016-08-22,4896.0,4897.0,4828.0,4900.100098,4673.550781,292890.0,4910.310058700001,4899.105539945454,10.450195999999778,59.225994323866374,-2.8117389068825935,234.38574208009777,11.661718933904199,-299611.0,-294354.99592248874,48.0,0.0,68.0,92.89990200000011,4875.033366,4922.066731999999,4944.033366,4991.066731999999,4853.066731999999,4806.033366,4784.066731999999,1.0449289565217375,-13800456.0,-1
2016-08-23,4835.049805,4855.200195,4800.0,4837.75,4669.734863000001,270869.0,4899.9200685,4885.912802,-103.89990200000011,48.32915084543825,-4.073886639676114,216.73218548715704,-3.8626111725117322,-1303669.3327853652,-340232.9203253468,44.0,16.0,64.0,96.0,4830.983398333334,4861.9667966666675,4886.183593333335,4917.166991666668,4806.766601666667,4775.783203333333,4751.566406666667,0.6838743957335615,-14071325.0,-1
2016-08-24,4890.0,4983.799805,4886.450195,4833.799805,4780.589355,952400.0,4884.125048999999,4873.89093590909,-157.95019500000035,47.68775734844723,-3.8179918744604207,198.8338305527277,11.47579476707726,-57747.73507661081,-327392.68463222246,40.0,12.0,60.0,62.19970699999976,4901.349934999999,4916.249674999998,4998.699544999999,5013.5992849999975,4818.900064999999,4804.000325,4721.550455,-0.5408382221562169,-15023725.0,-1
2016-08-25,4973.799805,4982.799805,4906.25,4948.549805,4766.244629,914319.0,4882.895019700001,4885.60452790909,-12.300293000000238,63.79358324008194,-1.4869777055507662,174.5794127666377,21.90596303438635,-129427.50473405248,-318394.2673641238,36.0,8.0,56.00000000000001,85.79980499999965,4945.8665366666655,4985.483073333331,5022.416341666665,5062.032878333331,4908.933268333331,4869.316731666666,4832.383463333332,0.5525788733230587,-14109406.0,+1
2016-08-26,4934.799805,4964.899902,4910.100098,4933.700195,4753.878418,337715.0,4890.1050294,4894.841832509091,72.10009700000046,60.989783364273265,-1.7886304403026694,143.57094269789013,14.845916939890662,-1195797.5261359923,-358276.23367193603,32.0,4.0,52.0,44.1503900000007,4936.233398333334,4962.366698666668,4991.033202333335,5017.166502666668,4907.566894666667,4881.4335943333335,4852.767090666667,0.4306602446972322,-14447121.0,-1
2016-08-29,4925.0,4955.0,4920.899902,4920.899902,4760.157715,299611.0,4894.3300294,4900.440900254545,42.25,58.43532826586671,-2.0486536590320426,113.75154301637122,11.496442645066598,-1557102.8663480547,-412768.3533390323,28.000000000000004,0.0,48.0,87.85009799999989,4932.266601333334,4943.633300666667,4966.366699333333,4977.733398666667,4909.533202666667,4898.166503333334,4875.4331046666675,0.0,-14746732.0,-1
2016-08-30,4955.0,5103.899902,4951.0,4927.399902,4895.647461,996156.0,4897.2100098,4906.453604363636,28.799804000000222,59.430911971625655,-3.5265440559454366,93.15825592825149,43.18031969549835,-129655.71715393147,-399899.59714880044,24.0,0.0,28.0,100.10009799999989,4994.099934666668,5037.199869333335,5146.999836666668,5190.099771333335,4884.299967333335,4841.2000326666675,4731.400065333335,-0.15434998774557665,-13750576.0,+1
2016-08-31,5063.899902,5103.850098,5036.299805,5067.649902,4916.075684,804288.0,4917.5549805,4937.442675672727,203.44970699999976,74.58611820852153,-0.7242902097904934,73.26612267515429,96.20689572474036,-763788.5416500036,-416440.0037170369,96.0,0.0,28.0,146.04980499999965,5069.266601666666,5102.233398333333,5136.816894666666,5169.783691333333,5034.683105333333,5001.716308666666,4967.132812333332,0.4641000890995447,-12946288.0,+1
2016-09-01,5074.0,5100.0,5019.299805,5053.649902,4922.982422,870402.0,4933.9349609,4962.187206854545,163.79980400000022,71.50929750112718,-1.004016083916477,58.47865108519909,92.48434803060783,542260.8448969551,-372862.6924164009,92.0,0.0,28.0,149.0,5057.649902333334,5095.9999996666675,5138.350097333335,5176.700194666668,5015.299804666667,4976.949707333333,4934.599609666667,0.4256507310794021,-13816690.0,-1
2016-09-02,5078.0,5188.649902,5075.0,5060.75,5019.96875,956049.0,4948.4249511,4985.244486690909,144.8999020000001,72.18083835245099,-2.512941056117461,43.62204607247713,124.9144620316068,1647520.808080808,-281027.0787574368,88.0,0.0,28.0,54.79980400000022,5108.133300666667,5141.266601333335,5221.783202666667,5254.916503333335,5027.6166993333345,4994.483398666667,4913.966797333334,-0.12538506192464632,-12860641.0,+1
2016-09-06,5201.0,5335.0,5201.0,5160.450195,5174.883789,970024.0,4974.459960800001,5023.794531036364,260.35009700000046,79.8688935880721,-3.3336479182582055,33.29087324461398,205.56209191111665,-560417.8990241189,-293726.66149683145,96.0,0.0,28.000000000000004,34.10009799999989,5232.150065000001,5263.300130000001,5366.150065000002,5397.300130000001,5129.300130000001,5098.150065000001,4995.300130000001,-0.30261048507462424,-11890617.0,+1
2016-09-07,5319.0,5362.0,5290.100098,5319.700195,5190.787598,734051.0,5022.654980300002,5086.565482709091,481.95019500000035,86.66227040993017,-0.8037204066121918,36.77008405796823,238.49896420124344,-522993.9409651407,-304147.9014726637,96.0,0.0,24.0,183.0,5323.933431,5357.766764000001,5395.833333000001,5429.666666000001,5285.866862000001,5252.033529,5213.966960000001,0.4116848031308918,-11156566.0,+1
2016-09-08,5321.0,5499.0,5319.0,5336.049805,5339.963379,942300.0,5072.879980300002,5143.546359927273,502.25,87.17495790325569,-3.0175962037037105,43.87936724051997,226.91161115114127,-2138324.3649548492,-387519.5589036722,96.0,56.00000000000001,96.0,176.45019599999978,5384.683268333333,5450.366536666666,5564.683268333334,5630.366536666666,5270.366536666666,5204.683268333333,5090.366536666666,0.09472113888888695,-10214266.0,+1
2016-09-09,5489.700195,5489.950195,5377.049805,5489.399902,5255.915527,547599.0,5126.96499,5219.277254781818,540.8500970000005,90.94277943227739,-0.17777959259259055,72.49195030917235,216.09851496045604,697622.3118374948,-338194.92841543735,96.0,52.0,92.0,80.70019500000035,5452.133300666667,5527.216796333335,5565.033690666668,5640.117186333336,5414.316406333334,5339.232910666667,5301.416016333334,0.9951258538610873,-9666667.0,+1
2016-09-12,5305.0,5350.0,5251.0,5403.0,5183.930176,795632.0,5173.8949705,5269.465438418181,469.29980499999965,76.35903466673528,-1.7777777777777777,110.65351383378402,124.05993697759408,-511614.14719526726,-346077.6201781569,92.0,48.0,88.0,135.0,5334.666666666667,5418.333333333334,5433.666666666668,5517.333333333334,5319.333333333334,5235.666666666667,5220.333333333334,1.5353535353535352,-10462299.0,-1
2016-09-14,5330.049805,5384.75,5330.049805,5329.0,5217.879883,539702.0,5214.7049803,5297.666352872728,408.1000979999999,65.91327355290304,-3.148148148148148,127.46036498463491,107.93625569931069,171508.1796773822,-322550.99291199597,88.0,44.0,96.0,274.25,5347.933268333333,5365.816731666667,5402.6334633333345,5420.516926666667,5311.116536666666,5293.233073333333,5256.416341666666,-0.019191979114510364,-11002001.0,-1
2016-09-15,5356.0,5461.0,5349.549805,5363.899902,5303.970703,704384.0,5258.3549803,5324.792702272727,436.5,68.27495997837605,-2.5018536666666646,150.65873849833588,103.81150730529795,-1496495.9526081015,-375912.1274436372,84.0,40.0,96.0,201.54980499999965,5391.483235666667,5433.4166663333335,5502.933430666667,5544.866861333334,5321.966471333333,5280.033040666666,5210.516276333333,0.12875793532707963,-10297617.0,+1
2016-09-16,5473.0,5619.899902,5473.0,5452.399902,5421.579102000001,1669960.0,5296.829980300001,5360.0735971272725,384.75,73.62233104136592,-3.0339256819222804,184.25197408465283,123.42911426727716,-12164.210435973346,-359378.1312160161,80.0,36.0,39.99999999999999,180.0,5515.099934666668,5557.199869333335,5661.999836666668,5704.099771333335,5410.299967333335,5368.2000326666675,5263.400065333335,-0.1402322106382336,-8627657.0,+1
2016-09-19,5569.0,5569.0,5485.0,5573.299805,5342.39502,632835.0,5348.7949706,5410.340837981818,519.6499029999995,79.15939010080633,-0.8440670511544525,227.14129168440832,109.87807232086766,138828.46955411436,-336732.3766355556,96.0,32.0,44.0,153.9003900000007,5542.433268333333,5599.866536666666,5626.433268333334,5683.866536666666,5515.866536666666,5458.433268333333,5431.866536666666,1.0511881547619006,-7994822.0,+1
2016-09-20,5525.0,5560.0,5498.350098,5491.899902,5364.721191,423083.0,5391.9099608,5436.3599164181815,431.1499020000001,68.06040841351196,-2.318462610662996,250.71117575519293,84.99482900182106,162073.64083200527,-314059.37584157556,92.0,28.000000000000004,44.0,238.3999020000001,5516.75,5535.149902,5578.399902,5596.799804,5473.5,5455.100098,5411.850098,-0.10462621659965926,-8417905.0,-1
2016-09-21,5526.0,5542.5,5462.100098,5514.850098,5351.491211,549370.0,5427.3499511,5458.712668636364,354.39990299999954,69.45372366161345,-1.9027659596209108,273.6470839209587,68.51223045353402,-350721.4566468551,-315725.83405999735,88.0,24.0,44.0,72.95019500000035,5506.483398666666,5550.866699333333,5586.883300666667,5631.266601333333,5470.466797333333,5426.083496666666,5390.0668953333325,0.656095327081368,-7868535.0,+1
2016-09-22,5565.350098,5634.100098,5564.950195,5501.25,5444.731934,526494.0,5445.5049315999995,5472.149041163636,181.54980499999965,67.44206434740082,-2.4001390335831987,299.6623865113643,70.26749604501524,272714.6529965358,-288978.5391937913,84.0,20.0,44.0,132.0,5566.766764333333,5568.5833336666665,5635.916667333332,5637.733236666666,5499.433430666667,5497.616861333334,5430.283527666667,-0.9211899400639907,-8395029.0,-1
2016-09-23,5630.0,5630.0,5565.600098,5597.100098,5449.303711,559592.0,5471.609960900001,5499.71179869091,261.05029300000024,73.64873610402734,-0.6684612625771524,318.76331415916593,66.67173191014716,-16320.001127260057,-276584.96928167617,96.0,16.0,44.0,256.0,5597.566731999999,5629.533365999999,5661.966633999999,5693.933267999999,5565.133463999999,5533.166829999999,5500.7335619999985,0.489131179112663,-7835437.0,+1
2016-09-26,5586.0,5625.0,5555.549805,5601.799805,5417.299316,418297.0,5482.849951200001,5523.382679436363,112.39990299999954,73.92990716762023,-0.5835539091997869,316.0681845305344,56.58546964355321,-3787083.8265527524,-436153.0991576343,92.0,12.0,64.0,116.60009799999989,5594.1165366666655,5632.683268333331,5663.566731666665,5702.133463333332,5563.233073333331,5524.666341666665,5493.782878333331,0.6659448544384903,-7417140.0,+1
2016-09-27,5598.950195,5599.950195,5500.0,5568.899902,5361.364258,427991.0,5499.439941400001,5539.028125036364,165.8999020000001,68.06371153406494,-1.1779406848226393,312.97584170169466,41.39704339328928,-40711.038548677425,-418178.4600390454,88.0,8.0,64.0,74.94970699999976,5556.283365666667,5612.566731333334,5656.2335606666675,5712.516926333335,5512.616536333334,5456.333170666667,5412.666341333334,0.6893423469559001,-7845131.0,-1
2016-09-28,5510.600098,5555.0,5506.0,5511.399902,5371.480957,449876.0,5517.679931600001,5541.202663327273,182.3999020000001,58.67491393776486,-2.2167656199087546,289.13247444557237,29.38807047408204,-548707.2340425532,-424111.5861301139,84.0,4.0,64.0,80.39990200000011,5524.133300666667,5542.266601333335,5573.133300666668,5591.266601333335,5493.266601333335,5475.133300666667,5444.266601333335,0.11020208163265532,-8295007.0,-1
2016-09-29,5575.0,5577.0,5395.0,5521.799805,5290.546386999999,693217.0,5533.4699219,5541.951731218182,157.89990299999954,59.83127056736639,-2.0288755580152515,275.93650288044046,19.751216744817597,-614316.0103927788,-432757.2417784169,80.0,0.0,64.0,119.25,5497.933268333333,5600.866536666666,5679.933268333334,5782.866536666666,5418.866536666666,5315.933268333333,5236.866536666666,0.6967022252747234,-7601790.0,+1
2016-09-30,5420.0,5497.5,5382.600098,5438.600098,5328.192383,646631.0,5532.0899415,5524.702672327273,-13.799804000000222,47.54942319803431,-3.5320047792927918,267.38333518824584,3.47658236608003,225214.82832459905,-402849.420410098,76.0,0.0,80.0,128.75,5439.566731999999,5496.533365999999,5554.466633999999,5611.433267999999,5381.633463999999,5324.666829999999,5266.7335619999985,0.4873807464169982,-8248421.0,-1
2016-10-03,5661.0,5720.0,5631.799805,5477.299805,5526.347656,840940.0,5522.489941500001,5514.740829327273,-96.0,52.754527688265384,-4.3177405265966975,255.31258661247557,40.533748709512565,-335933.90566228033,-399807.80610337894,72.0,0.0,80.0,69.45019500000035,5609.6998699999995,5587.599934999999,5697.900065000001,5675.80013,5499.399739999999,5521.499674999999,5411.199544999999,-1.7516968074730377,-7407481.0,+1
2016-10-04,5715.149902,5717.950195,5650.0,5681.0,5525.375,464913.0,5541.399951300001,5543.560839963636,189.1000979999999,70.521571818282,-0.6938267212239815,243.58599491352834,53.97757345209156,84977.2041999796,-377772.12381686264,96.0,0.0,80.0,101.79980499999965,5682.983398333334,5715.9667966666675,5750.933593333335,5783.916991666668,5648.016601666667,5615.033203333333,5580.066406666667,0.4562164979806142,-6942568.0,+1
2016-10-05,5707.0,5767.0,5673.0,5680.0,5534.324707,644731.0,5557.914941500001,5568.760848818181,165.1499020000001,70.37166917173897,-1.5349329569513057,214.0471065198999,55.2211798919637,3778.5025900349233,-360428.91352564,92.0,0.0,80.0,62.89990200000011,5706.666666666667,5740.333333333334,5800.666666666668,5834.333333333334,5646.333333333334,5612.666666666667,5552.333333333334,0.07446808510638298,-7587299.0,-1
2016-10-06,5700.0,5745.600098,5700.0,5689.200195,5554.996094,416860.0,5576.7099610000005,5592.630894909091,187.95019500000035,71.02547469576574,-1.3726147671136142,194.49952050069442,52.79424831424226,345530.5010910723,-328339.8492248803,96.0,0.0,80.0,182.0,5711.600097666666,5723.200195333333,5757.200195666666,5768.800293333333,5677.600097333333,5665.999999666667,5631.999999333333,-0.23683731995487547,-7170439.0,+1
2016-10-07,5709.450195,5717.25,5667.299805,5710.450195,5529.071289,309473.0,5588.044970700001,5616.94730109091,113.35009700000046,72.6348209835792,-0.9977029816513701,172.59412323413198,47.582551477993796,-203716.4061302682,-322675.14726603427,92.0,4.0,76.0,139.19970699999976,5698.333333333333,5729.366861666666,5748.2835283333325,5779.317056666667,5679.416666666666,5648.383138333333,5629.466471666666,0.8638682992128539,-6860966.0,+1
2016-10-10,5724.899902,5734.399902,5695.950195,5683.799805,5556.844238000001,205840.0,5596.2449707000005,5634.357270963636,82.0,67.2310652796027,-1.4678933486238595,160.62801642232716,49.345087719467735,87303.98940341563,-304039.73196287744,88.0,0.0,72.0,281.3999020000001,5704.716634,5713.483073,5743.166341000001,5751.93278,5675.033366000001,5666.266927000001,5636.583659000001,-0.3160073495488736,-7066806.0,-1
2016-10-13,5690.0,5752.799805,5652.600098,5712.350098,5562.875488000001,441169.0,5610.5899903,5655.46729410909,143.45019599999978,69.99075824292039,-0.9641831686661981,135.11570821420173,46.631139883722064,-406383.2014790083,-308691.70784997434,84.0,0.0,96.0,240.6503900000007,5705.916667,5759.233236000001,5806.116374,5859.432943000001,5659.033529000001,5605.716960000001,5558.833822000001,0.5963091289278933,-6625637.0,+1
2016-10-14,5760.200195,5766.950195,5669.100098,5718.549805,5535.540527,352350.0,5631.3049806,5675.096351327273,207.14990299999954,70.6109031554606,-0.8548023112208954,108.72806344387664,47.18945334885477,12475.944444444443,-294093.178200228,80.0,0.0,92.0,94.0,5718.200032666667,5767.299967333333,5816.050129666667,5865.150064333334,5669.449870333333,5620.349935666666,5571.599773333332,0.5053618597843549,-6273287.0,+1
2016-10-17,5699.0,5699.0,5574.600098,5690.450195,5446.677246,400595.0,5648.1700196,5685.850026672728,168.6503900000007,63.72408228852057,-1.3505611326746587,91.77843926048263,20.605818450203525,-571327.0727174355,-306694.71886010113,76.0,12.0,96.0,65.60009799999989,5654.683431,5734.766764000001,5779.083333000001,5859.166666000001,5610.366862000001,5530.283529,5485.966960000001,0.9312716098441971,-6673882.0,-1
2016-10-18,5621.0,5645.350098,5580.100098,5599.100098,5473.525879,487798.0,5664.2200196,5676.928222745454,160.5,46.655239718872515,-2.9622424488355703,90.50751667005898,0.4575798109715039,-448277.37478398473,-313130.29412936856,72.0,8.0,88.0,49.95019500000035,5608.183431333334,5636.266764666668,5673.433431333334,5701.516764666668,5571.016764666668,5542.933431333334,5505.766764666668,0.29118773946360155,-7161680.0,-1
2016-10-19,5633.700195,5647.899902,5593.049805,5626.700195,5452.027344,384608.0,5679.1600586,5670.1064364545455,149.4003900000007,51.21110590250924,-2.475296489061391,90.12729170021703,5.8003568728180275,-627930.7140151291,-327439.40412417584,68.0,4.0,88.0,38.44970699999976,5622.549967333333,5652.050129666667,5677.400064333334,5706.900226666668,5597.200032666667,5567.699870333333,5542.349935666666,0.6134973653738555,-6777072.0,+1
2016-10-20,5615.0,5683.5,5615.0,5604.600098,5490.841309,311728.0,5671.520068400001,5656.550079981818,-76.39990200000011,47.465766590945,-2.865206457304166,111.50837898177451,9.86457613096886,12910.838399861264,-311968.9385549014,64.0,0.0,84.0,100.19970699999976,5634.366699333333,5653.733398666665,5702.866699333332,5722.233398666665,5585.233398666665,5565.866699333333,5516.733398666665,-0.1518233868613155,-7088800.0,-1
2016-10-21,5650.5,5670.0,5616.0,5644.5,5496.38623,224567.0,5667.970068400001,5651.637340272728,-35.5,54.41135792578168,-2.161256175017643,125.1988863482402,12.093332746184142,-1102393.6927119733,-347897.336471132,60.0,0.0,80.0,97.85009700000046,5643.5,5671.0,5697.5,5725.0,5617.0,5589.5,5563.0,0.5277777777777778,-6864233.0,+1
2016-10-24,5666.0,5748.0,5666.0,5650.200195,5558.352051,412403.0,5664.0700684,5648.4064542,-39.0,55.38371553786522,-2.060688161609027,107.07514040762362,37.63375575879999,-753360.3187136663,-366327.4720276108,56.00000000000001,0.0,64.0,143.94970699999976,5688.066731666667,5710.133463333334,5770.066731666666,5792.133463333334,5628.133463333334,5606.066731666667,5546.133463333334,-0.19268054878048355,-6451830.0,+1
2016-10-25,5734.0,5799.0,5725.649902,5713.899902,5624.063477000001,339506.0,5664.4150391,5657.466423945455,3.449706999999762,65.00739701131567,-1.4929841754385946,92.10180200143623,68.41425911753073,694893.4575630361,-318090.1570462177,52.0,40.0,64.0,110.35009700000046,5746.183268000001,5766.716634000001,5819.533366000001,5840.066732000001,5693.366536000001,5672.833170000001,5620.0164380000015,-0.16019065168801844,-6112324.0,+1
2016-10-26,5796.600098,5898.0,5785.0,5781.450195,5709.32666,590811.0,5674.1800781,5678.745543200001,97.6503900000007,72.31440271396721,-2.0098259182617633,82.59325407854249,112.30808768564104,-371669.2768331575,-320525.57158198766,96.0,36.0,64.0,54.85009700000046,5821.483398333334,5857.9667966666675,5934.483398333334,5970.9667966666675,5744.9667966666675,5708.483398333334,5631.9667966666675,-0.03141420353981992,-5521513.0,+1
2016-10-27,5897.0,5948.0,5789.100098,5869.100098,5700.620605,1864862.0,5689.855078099999,5714.185546818181,156.75,78.90835452541197,-1.3489468627115764,79.72107022344153,135.65147075115038,864716.4306918691,-266650.9351149941,96.0,32.0,64.0,68.5,5868.733398666666,5948.366699333333,6027.633300666667,6107.266601333333,5789.466797333333,5709.833496666666,5630.5668953333325,0.5034616069177937,-3656651.0,+1
2016-10-28,5922.0,5928.549805,5865.75,5860.149902,5716.185059,935542.0,5704.0150878,5745.148242072728,141.60009700000046,76.75445964894153,-1.501967823559581,75.4365943060493,134.14104384852382,-575840.1979295345,-280704.99251565506,96.0,28.000000000000004,60.0,65.39990200000011,5884.816569,5903.883137999999,5947.616373999999,5966.682942999999,5841.083333,5822.016764,5778.283528,-0.08917381192505168,-4592193.0,-1
2016-11-01,5919.0,5974.0,5855.200195,5876.149902,5718.082031,1163831.0,5722.585058500001,5776.445481018181,185.69970699999976,77.99350644329814,-1.6655335829787214,69.21105947704928,130.63448261587288,546326.6674214079,-243112.64433669762,92.0,24.0,56.00000000000001,103.5,5901.783365666667,5948.366536333334,6020.583170666666,6067.166341333334,5829.566731333334,5782.9835606666675,5710.766926333335,0.1763446244713939,-3428362.0,+1
2016-11-02,5805.0,5864.899902,5785.0,5878.100098,5636.855469,522312.0,5750.4850585,5804.7209427454545,279.0,78.15724900584814,-1.6323387574468102,61.36184933838376,76.46849474074745,2515360.64516129,-117727.49481406172,96.0,20.0,12.0,148.79980499999965,5842.666666666667,5900.333333333334,5922.566568666667,5980.233235333334,5820.433431333334,5762.766764666667,5740.533529333334,1.1652091638360178,-2906050.0,+1
2016-11-03,5799.899902,5859.899902,5780.0,5794.600098,5647.506836,585730.0,5767.275048799999,5812.741859018182,167.89990299999954,57.149508141459954,-3.053615353191491,61.427602506491894,51.29922742701226,-161491.76957036206,-119716.78003025721,92.0,16.0,60.0,184.1000979999999,5811.5,5843.0,5891.399902000001,5922.899902,5763.100098,5731.600098,5683.200196,0.18272986117054146,-3491780.0,-1
2016-11-04,5789.0,5789.0,5667.299805,5805.549805,5549.548828,679821.0,5787.3700195,5819.700905600001,200.94970699999976,58.824130166394404,-2.8672373617021334,75.5119608731211,11.919744572342342,1454691.1580914888,-48152.782842905064,88.0,12.0,64.0,166.54980499999965,5753.9498699999995,5840.599934999999,5875.650065000001,5962.30013,5718.899739999999,5632.249674999999,5597.199544999999,1.135988319492829,-2811959.0,+1
2016-11-07,5763.0,5784.850098,5708.0,5704.850098,5560.346191,532212.0,5793.4050293,5804.69728350909,60.35009799999989,41.58062319145271,-4.581274927659576,82.65656892123388,-3.785223357700309,3065563.7645046767,93379.78749107604,84.0,8.0,68.0,62.79980499999965,5732.566731999999,5757.133463999999,5809.416829999998,5833.9835619999985,5680.283365999999,5655.716633999999,5603.433267999999,-0.04098761201319633,-3344171.0,-1
2016-11-08,5727.799805,5731.0,5581.5,5715.950195,5514.674316,684050.0,5799.980029300001,5790.614586363637,65.75,43.68041390772858,-4.392337106382973,90.66338847268253,-45.866632911590564,-3941543.2455518534,-90025.80491996635,80.0,4.0,68.0,118.79980499999965,5676.150065000001,5770.800130000001,5825.650065000002,5920.300130000001,5621.300130000001,5526.650065000001,5471.800130000001,0.8993324080267582,-2660121.0,+1
2016-11-09,5305.0,5553.0,5305.0,5669.0,5246.13916,1299603.0,5795.490039099999,5766.8000355818185,-44.89990200000011,37.161556000102294,-5.191489361702128,93.74131486806891,-159.18796621229603,87840.7135279848,-81940.9631723322,76.0,0.0,76.0,91.14990200000011,5509.0,5713.0,5757.0,5961.0,5465.0,5261.0,5217.0,1.467741935483871,-3959724.0,-1
2016-11-10,5505.5,5517.25,5305.0,5392.950195,5183.443359000001,942971.0,5756.640039100001,5693.6109730181815,-388.5,18.465632788077585,-9.890209446808505,84.42816666386989,-193.09689914715898,-183067.78602814354,-86537.63693850544,72.0,96.0,76.0,98.10009799999989,5405.066731666667,5505.133463333334,5617.316731666666,5717.383463333334,5292.883463333334,5192.816731666667,5080.633463333334,0.41437076560659764,-4902695.0,-1
2016-11-11,5290.0,5292.950195,5103.0,5328.5,4994.481445,1058491.0,5702.580029300001,5615.767329545455,-540.6000979999999,16.261676215150644,-10.987234042553192,66.36427448702125,-235.5729008565981,563764.3667167458,-56978.454954175824,68.0,92.0,76.0,127.30029300000024,5241.483398333334,5379.9667966666675,5431.433593333335,5569.916991666668,5190.016601666667,5051.533203333333,5000.066406666667,1.187153295630992,-5961186.0,-1
2016-11-15,5101.899902,5119.049805,4806.399902,5134.25,4714.662109000001,2793900.0,5629.990039100001,5512.434596945454,-725.8999020000001,11.49176517431809,-14.293617021276594,45.03643969446057,-269.06919414862205,-1340164.9966238353,-115305.11593916039,64.0,96.0,76.0,97.54980499999965,5019.899902333334,5233.399902666667,5332.549805333333,5546.0498056666665,4920.7499996666675,4707.249999333334,4608.100096666668,1.048617302785475,-8755086.0,-1
2016-11-16,4924.0,5009.399902,4901.549805,4846.600098,4854.936522999999,1952224.0,5527.035058700001,5370.0000622,-1029.5498040000002,7.655140911709154,-19.189785565957447,0.9978195066578337,-234.7606481254995,571424.6456451702,-84090.12677623625,60.0,96.0,76.0,149.5,4919.183268333333,4936.816731666667,5027.033365333334,5044.666828666667,4828.966634666666,4811.333171333333,4721.116537666666,-0.509500765678491,-10707310.0,-1
2016-11-17,5030.0,5048.0,4916.299805,4990.799805,4791.462890999999,668715.0,5438.3050293999995,5272.502743345454,-887.3002930000002,22.60172246275644,-16.735322468085112,-42.64260375871436,-166.7133380218259,508352.56604184274,-57160.91346632355,56.00000000000001,92.0,76.0,410.95019500000035,4985.0332033333325,5053.766601666665,5116.733398333333,5185.466796666666,4922.066406666665,4853.333008333332,4790.366211666665,0.5656787372258621,-10038595.0,+1
2016-11-18,4935.0,4989.899902,4887.899902,4925.549805,4816.123047,699355.0,5351.4000001,5179.274520727273,-869.0502930000002,20.840548175979762,-17.845960765957454,-93.96906900681915,-151.8818507126536,-220988.6007789277,-64607.62652598738,52.0,88.0,-24.0,364.0,4934.449869666667,4980.999837333334,5036.449869666668,5082.999837333334,4878.999837333334,4832.449869666667,4776.999837333334,0.36911669607842684,-10737950.0,-1
2016-11-21,4990.0,4990.0,4765.299805,4950.899902,4657.122559,864696.0,5265.9350098,5106.456321072727,-854.6499029999995,23.51231962722916,-17.41446975319149,-152.57169595763935,-136.03936731290852,20809.41831659615,-60725.03357859722,48.0,84.0,-24.0,289.95019500000035,4902.066569,5038.833333,5126.766763999999,5263.533528,4814.133137999999,4677.366373999999,4589.432942999999,0.8259899240407876,-9873254.0,+1
2016-11-22,4830.0,4956.0,4825.549805,4787.450195,4800.217772999999,845997.0,5174.195019500001,5019.459082018182,-917.3999029999995,18.79329811153781,-20.196592425531907,-208.21134775941482,-125.23582709911632,-892551.8721973094,-98535.34442490235,44.0,96.0,-32.0,522.1000979999999,4856.333333333333,4887.116861666666,4986.7835283333325,5017.567056666667,4756.666666666666,4725.883138333333,4626.216471666666,-0.29206249940829293,-10719251.0,-1
2016-11-23,4945.0,4945.0,4860.0,4934.549805,4747.97998,757744.0,5096.0549805,4975.887224836363,-781.4003900000007,32.7990699142658,-16.135384117183385,-267.8685668637572,-97.05516338024799,-1437568.437841662,-159400.48503475508,40.0,92.0,-36.0,232.70019500000035,4913.183268333333,4966.366536666666,4998.183268333334,5051.366536666666,4881.366536666666,4828.183268333333,4796.366536666666,0.8770565294117606,-9961507.0,+1
2016-11-24,4862.0,4883.899902,4804.0,4880.850098,4698.659668,550368.0,5017.2399903000005,4936.7590643818185,-788.1499020000001,30.577664689350613,-16.994737292000256,-323.17446068282334,-91.98965998554313,239642.91283292978,-141262.14876804213,36.0,88.0,-35.99999999999999,201.3999020000001,4856.25,4908.5,4936.149902000001,4988.399902,4828.600098,4776.350098,4748.700196,0.9618296903543109,-10511875.0,-1
2016-11-25,4849.0,4905.0,4792.450195,4830.149902,4740.927246,669501.0,4960.9599610000005,4902.742684690909,-562.8002930000002,28.476597295500838,-16.8514955711775,-393.67111102874696,-79.27234542260805,901399.6161900897,-93868.4321790361,32.0,84.0,-36.0,102.89990299999954,4842.533365666667,4892.616536333334,4955.083170666666,5005.166341333334,4780.066731333334,4729.9835606666675,4667.516926333335,0.33496021605723686,-11181376.0,-1
2016-11-28,4866.0,4913.0,4833.0,4873.600098,4760.528809,1387068.0,4915.4699708,4886.859073236364,-454.8999020000001,33.02715303446372,-16.026627228891112,-462.3446018595696,-61.48697801570096,-486950.6489646679,-111735.8056692921,28.000000000000004,80.0,-36.0,224.70019500000035,4873.200032666667,4913.400065333333,4953.2000326666675,4993.400065333333,4833.400065333333,4793.200032666667,4753.400065333333,0.5075012249999986,-9794308.0,+1
2016-11-29,4898.0,5119.0,4896.0,4893.75,4949.636719,874897.0,4891.419970800001,4882.909987636363,-240.5,35.23213458416822,-14.865944602272727,-500.013790019153,-38.18524748780118,121463.27814453583,-101135.8473141181,24.0,76.0,-52.0,130.45019500000035,4969.583333333333,5043.166666666666,5192.583333333332,5266.166666666666,4820.166666666666,4746.583333333333,4597.166666666666,-0.010089686098654708,-8919411.0,+1
2016-11-30,5110.549805,5282.0,5100.100098,5088.149902,5122.64502,1270618.0,4915.5749512,4918.679066036364,241.54980400000022,52.60319340187098,-8.523104107077373,-525.5843752346864,-7.099760803373296,86526.36375288869,-92605.74681107233,20.0,72.0,-52.0,157.54980499999965,5156.75,5213.399902,5338.649902,5395.299804,5031.5,4974.850098,4849.600098,-0.06569654996295583,-7648793.0,+1
2016-12-01,5266.0,5307.5,5204.25,5266.0,5109.123535,1221883.0,4943.094970700001,4982.392711272727,275.20019500000035,63.06132296179452,-4.637106076685277,-521.8354562483,10.692303989324497,-1749495.068609674,-167918.89780191792,16.0,68.0,-52.0,130.54980499999965,5259.25,5314.25,5362.5,5417.5,5211.0,5156.0,5107.75,0.5980629539951574,-6426910.0,+1
2016-12-02,5220.0,5236.200195,5046.0,5252.100098,4930.132813,772281.0,4975.750000000001,5038.575461690909,326.55029300000024,61.83100662930224,-1.0636440817893849,-473.7295350166314,4.07822136893311,-224906.50758536728,-170509.24370116563,12.0,64.0,-52.0,112.54980499999965,5178.100097666666,5310.200195333333,5368.300292666667,5500.400390333333,5120.0000003333325,4987.899902666666,4929.799805333332,1.0835956188162663,-7199191.0,-1
2016-12-05,5063.899902,5219.899902,5055.0,5068.100098,5061.311522999999,578935.0,4987.470019599999,5055.3663885999995,117.20019599999978,47.635813905644135,-4.596331035806856,-443.3546453650979,-0.4349726894773723,403795.06262684363,-144404.5025044379,8.0,60.0,-52.0,82.85009799999989,5114.333333333333,5173.666666666666,5279.233235333333,5338.566568666666,5008.766764666666,4949.433431333333,4843.866862666666,0.07944272762514971,-7778126.0,-1
2016-12-06,5220.0,5261.0,5118.049805,5202.950195,4995.405761999999,646660.0,5029.0200196,5094.544602309092,415.5,56.14906070120999,-2.0072920226552684,-393.38038937577494,17.39257589546492,-346869.6037658378,-153607.46165268336,4.0,56.00000000000001,-52.0,245.3999020000001,5194.0,5269.950195,5336.950195,5412.900390000001,5127.0,5051.049805,4984.049805,0.5939158739867441,-7131466.0,+1
2016-12-07,5150.950195,5209.75,5035.049805,5135.200195,4977.360352000001,590462.0,5049.0850586,5113.850088745455,200.6503900000007,51.31297484393903,-3.3080503983872447,-346.4604442818609,11.986528903152308,-81991.10198195105,-150352.17257674097,0.0,52.0,-52.0,388.25,5126.666666666667,5218.283528333334,5301.366861666668,5392.983723333335,5043.583333333334,4951.966471666667,4868.883138333334,0.5732700527323424,-7721928.0,-1
2016-12-08,5172.0,5269.899902,5170.0,5116.649902,5092.100098,845955.0,5072.6650389999995,5126.134605727273,235.79980400000022,49.953696131371636,-3.664204627051932,-273.1107539358154,29.225015424917174,19932.80637922804,-142611.94626056057,0.0,48.0,-52.0,219.3500979999999,5185.516601333334,5201.033202666667,5285.416503333334,5300.9331046666675,5101.133300666667,5085.616699333334,5001.233398666667,-0.5340355388937201,-8567883.0,-1
2016-12-09,5290.0,5312.5,5201.200195,5234.600098,5092.489258,562518.0,5113.110058600001,5155.577343727273,404.4501959999998,58.09733908972384,-1.49419587609092,-212.84017576683618,49.66244627889038,-1134860.69073945,-187714.16191869194,0.0,44.0,-52.0,220.0,5249.433431,5297.666667,5360.733236000001,5408.966472,5186.366862000001,5138.133626000001,5075.067057000001,0.30008950150451424,-8005365.0,+1
2016-12-12,5228.0,5228.0,5120.049805,5235.0,5004.355469,357439.0,5149.2500488000005,5177.7391512545455,361.3999020000001,58.12399630391679,-1.4865253668360987,-146.49842861079742,41.43318513858388,314192.401726862,-164900.22720753038,0.0,40.0,-52.0,197.1000979999999,5194.349934999999,5268.650064999999,5302.300129999999,5376.600259999999,5160.699869999999,5086.399739999999,5052.749674999998,1.064844718437053,-7647926.0,+1
2016-12-13,5178.75,5207.0,5134.049805,5144.399902,5022.594727000001,484291.0,5174.315038999999,5176.8573063818185,250.6499020000001,49.836167133295596,-3.224323352833987,-70.12488141802532,35.65151691121171,53022.75902463227,-154994.63692425026,0.0,36.0,-52.00000000000001,192.8999020000001,5161.816569,5189.583333,5234.766763999999,5262.533528,5116.633137999999,5088.866373999999,5043.682942999999,0.14187894905559073,-8132217.0,-1
2016-12-14,5179.950195,5214.75,5130.200195,5163.149902,5001.09668,371699.0,5181.815039000001,5174.827281472727,75.0,51.487959216929596,-2.8646801189220272,-0.7054077391885585,39.29702526033801,-83855.6009151839,-151761.04437838358,0.0,32.0,-52.0,174.70019500000035,5169.366699000001,5208.533203000002,5253.916504000002,5293.083008000001,5123.983398000002,5084.816894000001,5039.4335930000025,0.38970766402122275,-7760518.0,+1
2016-12-15,5099.950195,5197.0,5080.0,5141.049805,5011.796875,457317.0,5169.320019500001,5167.415420745454,-124.95019500000035,49.28104529795528,-3.288581471180595,70.72074955094104,31.084520023639666,345565.6419374496,-129155.28590948206,0.0,28.000000000000004,-48.0,134.69970699999976,5139.349934999999,5198.699869999999,5256.349934999998,5315.699869999999,5081.699869999999,5022.349934999999,4964.699869999999,0.5217932051282022,-8217835.0,-1
2016-12-16,5174.5,5207.0,5151.200195,5152.049805,5047.400879,1170505.0,5159.3149902,5164.275381745454,-100.05029300000024,50.499572084716384,-3.077590773952246,116.42374416419443,47.8477117647497,-293482.269625294,-136624.69426020078,0.0,24.0,-44.0,195.8500979999999,5170.083333333333,5188.966471666666,5225.883138333332,5244.766276666665,5133.166666666666,5114.283528333333,5077.366861666666,0.015226038872345655,-7047330.0,+1
2016-12-19,5175.0,5195.450195,5104.049805,5188.649902,4975.804199,369118.0,5171.3699706,5169.609002072728,120.54980400000022,54.67974801522253,-2.3755653208017624,122.6209255318081,45.56067648205858,-69921.66706513701,-133592.73847860697,76.0,20.0,-40.0,114.55029300000024,5162.716634,5221.383463000001,5254.117024000002,5312.783853000002,5129.983073,5071.316244,5038.582683,0.9255988623243272,-6678212.0,+1
2016-12-20,5135.899902,5147.5,5072.0,5115.049805,4968.946289,377676.0,5162.579931599999,5159.368971963636,-87.9003900000007,45.72103340353377,-3.7872867555385126,124.45655138335133,7.18666869484661,-80577.08091088235,-131182.9358618922,72.0,16.0,-36.0,100.95019500000035,5111.516601666666,5151.0332033333325,5187.016601666666,5226.5332033333325,5075.5332033333325,5036.016601666666,5000.0332033333325,0.5701960927152272,-7055888.0,-1
2016-12-21,5119.399902,5160.0,5073.549805,5108.0,4997.983886999999,413072.0,5159.859912100001,5149.4453480363645,-27.20019500000035,44.90785077457591,-3.9225088711997693,139.5101579371958,1.7750509059138335,-502961.25538300915,-148081.95038557937,68.0,12.0,-32.0,84.54980499999965,5113.849934999999,5154.150064999999,5200.300129999999,5240.600259999999,5067.699869999999,5027.399739999999,4981.249674999998,0.39849759737384294,-7468960.0,-1
2016-12-22,5144.0,5144.0,5053.0,5137.850098,4945.98877,399573.0,5161.979931700001,5145.443563654546,21.200195999999778,49.31229622867543,-3.3499549630766303,119.02534288986953,-9.831665037125383,-515610.24910754163,-164787.78214566858,64.0,8.0,-28.000000000000004,117.0,5111.616699333333,5170.233398666665,5202.616699333332,5261.233398666665,5079.233398666665,5020.616699333333,4988.233398666665,0.9324186593406582,-7069387.0,+1
2016-12-23,5050.0,5214.0,5041.0,5084.399902,5055.669434,589006.0,5146.959912100001,5131.33810370909,-150.20019599999978,42.32167438343157,-4.375181701352257,114.77416895445731,-19.482844082001407,-383476.0062398,-174728.1559681291,60.0,4.0,-24.0,65.95019500000035,5113.133300666667,5185.266601333335,5286.133300666668,5358.266601333335,5012.266601333335,4940.133300666667,4839.266601333335,0.2508664855491336,-7658393.0,-1
2016-12-26,5179.0,5257.799805,5151.100098,5197.149902,5026.681152,510998.0,5143.174902300001,5140.463556418182,-37.85009799999989,57.11792126128111,-2.2125270547616744,111.79390217296896,37.208840096493134,-324714.4296345091,-181545.71386205548,56.00000000000001,0.0,56.0,91.4003900000007,5202.016601666666,5252.933105333333,5308.716308666665,5359.632812333332,5146.233398333333,5095.3168946666665,5039.533691333333,0.43158322824635614,-7147395.0,+1
2016-12-27,5185.0,5237.399902,5117.200195,5167.350098,5081.788086,486703.0,5145.4699219,5144.8590465454545,22.950195999999778,52.97369060483673,-2.7841162750551476,93.05057270912675,7.823100537012163,-171044.13659768362,-181068.36944094766,52.0,12.0,56.0,116.64990200000011,5173.983398333334,5230.766601666667,5294.183105333334,5350.966308666667,5110.566894666667,5053.783691333334,4990.367187666668,0.4172215078693964,-7634098.0,-1
2016-12-28,5250.0,5278.0,5219.450195,5224.0,5088.84082,595514.0,5151.5549316999995,5159.137242563636,60.85009799999989,59.43033168149141,-1.6975160640644482,64.10660238782111,61.57028386904707,-357074.5919714584,-189068.6522832436,48.0,8.0,56.0,86.45019500000035,5240.483398333334,5261.516601666667,5299.033203333333,5320.066406666667,5202.9667966666675,5181.933593333334,5144.416991666668,0.07770828613348377,-7038584.0,+1
2016-12-29,5217.200195,5349.0,5217.200195,5231.25,5170.116211,655325.0,5160.5749512,5173.627254981819,90.20019500000035,60.23652069690816,-2.242857142857143,56.00831995621411,88.41371031645266,-1017924.618416545,-226743.92347112097,44.0,4.0,56.0,91.0,5265.816731666667,5314.433268333333,5397.6165366666655,5446.233073333333,5182.633463333334,5134.016926666667,5050.833658333334,0.10659958867161973,-6383259.0,+1
2016-12-30,5347.0,5377.899902,5303.0,5314.799805,5174.737305,559886.0,5176.849951200001,5201.6681374909085,162.75,68.54740509752362,-1.1953266432669793,43.915568331281065,159.39767300473866,140921.85947492896,-210031.84242811866,96.0,0.0,56.0,173.0,5331.899902333334,5360.799804666667,5406.799804333334,5435.699706666667,5285.899902666667,5257.000000333333,5211.000000666667,0.15754099384535422,-5823373.0,+1
2017-01-02,5320.049805,5474.200195,5267.799805,5319.549805,5317.200195,651321.0,5189.9399415,5227.613565454546,130.89990299999954,68.9728089311472,-2.8771093985272613,31.770360708183034,170.11036110815917,-295868.73776669265,-213933.51948896292,96.0,0.0,56.00000000000001,173.39990299999954,5353.849934999999,5439.900064999999,5560.250325,5646.300455,5233.499674999998,5147.449544999999,5027.0992849999975,0.25072627043001144,-5172052.0,+1
2017-01-03,5466.0,5524.200195,5432.600098,5466.0,5358.445801,631753.0,5225.034961,5277.806303363636,350.95019500000035,79.05209489861889,-1.0727750665061007,24.647852024878375,265.8297515536999,-137854.11679368728,-210475.36482099583,96.0,0.0,40.0,120.19970699999976,5474.266764333333,5515.933430666667,5565.866861333335,5607.533527666667,5424.3333336666665,5382.666667333333,5332.733236666666,0.3646273649688378,-4540299.0,+1
2017-01-04,5530.0,5554.700195,5494.0,5508.399902,5352.366211,679443.0,5265.0749512,5329.327201727272,400.3999020000001,81.10281857190569,-0.8486590418299229,15.277869047118656,249.0697170140773,-752026.1823775576,-235091.31107356682,96.0,20.0,40.0,110.64990200000011,5519.033365666667,5544.066731333334,5579.7335606666675,5604.766926333335,5483.366536333334,5458.333170666667,5422.666341333334,0.2372299133470663,-3860856.0,+1
2017-01-05,5525.100098,5649.899902,5525.100098,5502.149902,5481.551758,744210.0,5301.5049316,5372.431738236363,364.2998040000002,79.77452567864518,-2.661730577176601,29.01714151446413,222.6727187635184,-97849.35018369988,-228853.0401240274,96.0,16.0,40.0,131.79980499999965,5559.049967333333,5592.999836666667,5683.849771333334,5717.799640666667,5468.200032666667,5434.250163333333,5343.400228666666,-0.1838960900932163,-4605066.0,-1
2017-01-06,5650.0,5657.299805,5597.0,5634.950195,5462.679199,544695.0,5356.5599609,5433.058149763637,550.5502930000002,85.56906862115802,-0.4020943594999066,60.45479888822956,221.66340229171257,758892.7033908182,-183955.50632789804,96.0,12.0,96.0,146.6499020000001,5629.75,5662.5,5690.049804999999,5722.799805,5602.200195,5569.450195,5541.900390000001,0.6293585029006407,-4060371.0,+1
2017-01-09,5644.799805,5680.0,5610.600098,5615.549805,5504.459961,345094.0,5398.3999512,5480.147212327272,418.39990299999954,81.62709126419362,-1.1548144597742402,89.53291538327994,178.01338732988535,57846.56919359635,-172964.50289510284,96.0,8.0,96.0,206.4003900000007,5635.383300999999,5660.166503999998,5704.783202999998,5729.566405999998,5590.766601999998,5565.983398999999,5521.366699999998,0.07132152722636055,-4405465.0,-1
2017-01-10,5680.0,5693.700195,5641.0,5658.5,5520.364746,410444.0,5447.514941400001,5527.43813029091,491.1499020000001,83.5615551865687,-0.6291703536046287,118.87463023998043,151.840131686761,-122853.16099575051,-170686.71462695044,96.0,4.0,96.0,204.6503900000007,5664.400065000001,5687.800130000001,5717.100260000001,5740.500325000002,5635.099935000001,5611.69987,5582.399740000001,0.33206708248422767,-3995021.0,+1
2017-01-11,5691.0,5772.899902,5691.0,5674.850098,5605.48291,539326.0,5492.5999512,5568.771795127272,450.8500979999999,84.28818338113703,-1.728084839237973,144.8237230557761,138.52441133136222,-258212.81597533205,-174665.17377914963,96.0,0.0,76.0,88.70019500000035,5712.916666666667,5734.833333333334,5794.816568666667,5816.733235333334,5652.933431333334,5631.016764666667,5571.033529333334,-0.1971907365652292,-3455695.0,+1
2017-01-12,5770.0,5795.0,5742.0,5762.350098,5620.074707,421634.0,5545.709961,5617.817276363637,531.1000979999999,87.65718571272285,-0.5732075491573053,176.1347102362024,128.23753580194466,-153787.31093339308,-173716.18001343342,96.0,44.0,80.0,141.5,5766.450032666667,5790.900065333333,5819.4500326666675,5843.900065333333,5737.900065333333,5713.450032666667,5684.900065333333,0.3839641132075451,-3034061.0,+1
2017-01-13,5792.0,5794.0,5683.649902,5777.350098,5544.34375,1086873.0,5591.9649903,5659.933664909091,462.55029300000024,88.15938964900084,-0.3098648525280918,202.52654920064833,101.15889339118482,189754.0474661673,-157194.80603708792,96.0,40.0,84.0,155.14990299999954,5751.666666666667,5819.683431333334,5862.016764666668,5930.033529333334,5709.333333333334,5641.316568666667,5598.983235333334,0.8491174697461517,-1947188.0,+1
2017-01-16,5697.950195,5725.200195,5661.0,5699.5,5522.359375,290142.0,5629.9600098,5679.485484854545,379.95019500000035,70.88713113161158,-1.676615168539326,236.95119778390472,70.96154949771741,-80470.84861362119,-153707.35342693035,92.0,36.0,88.0,69.39990200000011,5695.233398333334,5729.4667966666675,5759.433593333335,5793.666991666668,5665.266601666667,5631.033203333333,5601.066406666667,0.5996866520420973,-2237330.0,-1
2017-01-17,5690.0,5718.899902,5657.049805,5676.899902,5515.063477000001,343048.0,5651.049999999999,5688.0200107090905,210.8999020000001,66.5215507868007,-2.07338655196629,262.7926450470486,56.55625281524477,-184261.7226332937,-155096.18839085597,88.0,32.0,92.0,78.1503900000007,5684.283203,5711.516601,5746.1333,5773.366698000001,5649.666504,5622.4331059999995,5587.816406999999,0.32093881760606313,-2580378.0,-1
2017-01-18,5685.0,5719.0,5665.0,5669.399902,5529.704102000001,308483.0,5667.1500000000015,5691.3563565272725,161.0,64.98900547517059,-2.205057900280897,285.17133140414717,47.71055399799159,-617030.9971024148,-176093.22515047228,84.0,28.000000000000004,96.0,114.39990200000011,5684.466634,5703.933268000001,5738.466634,5757.933268000001,5649.933268000001,5630.466634,5595.933268000001,0.08147966666666873,-2888861.0,-1
2017-01-19,5675.0,5728.0,5675.0,5684.450195,5562.681152,239027.0,5685.380029300001,5694.501846527272,182.30029300000024,66.76203893574085,-1.9408322507022413,291.2648150453215,42.4253582689247,-829810.7381115631,-205807.65755779462,80.0,24.0,52.0,120.14990200000011,5695.816731666667,5716.633463333334,5748.816731666666,5769.633463333334,5663.633463333334,5642.816731666667,5610.633463333334,0.17830556603774245,-2649834.0,+1
2017-01-20,5717.0,5749.0,5642.0,5718.350098,5514.625977000001,444280.0,5693.7200196,5700.496404472727,83.39990299999954,70.62792082839437,-1.3456794592696648,292.3375920745066,37.12457495000209,46719.09267022355,-194329.1689110665,76.0,20.0,56.0,110.35009799999989,5703.116699333333,5764.233398666665,5810.116699333332,5871.233398666665,5657.233398666665,5596.116699333333,5550.233398666665,0.7135523177570083,-2205554.0,+1
2017-01-23,5668.950195,5712.75,5643.799805,5668.950195,5544.830078,297515.0,5699.0600586,5695.9928,53.4003900000007,59.07496245364019,-2.212953037219095,294.9791565603455,25.57361251469708,-129291.04962401732,-191372.89076165514,72.0,16.0,56.0,116.35009799999989,5675.166666666667,5706.533528333334,5744.116861666668,5775.483723333335,5637.583333333334,5606.216471666667,5568.633138333334,0.3647616950176946,-2503069.0,-1
2017-01-24,5704.0,5745.75,5688.950195,5700.0,5581.018066,301613.0,5703.2100586,5696.163698436364,41.5,63.41506295858867,-1.6678370786516854,283.0549290364406,28.789460576068787,-1149021.757480315,-234902.38470341242,68.0,12.0,56.0,61.85009700000046,5711.566731666667,5734.183268333333,5768.3665366666655,5790.983073333333,5677.383463333334,5654.766926666667,5620.583658333334,0.19453948829577353,-2201456.0,+1
2017-01-25,5763.899902,5834.0,5708.049805,5737.200195,5644.588379,1148793.0,5709.4450683,5702.343723236363,62.35009700000046,68.09277967715835,-1.6878780296425397,270.1502287592375,35.484185540925225,84772.04295221735,-220371.72890088378,64.0,8.0,56.0,54.0,5759.75,5811.450195,5885.700195,5937.400390000001,5685.5,5633.799805,5559.549805,0.23144378617278533,-1052663.0,+1
2017-01-27,5842.0,5927.700195,5825.049805,5802.549805,5754.853027,576906.0,5713.465039000001,5719.271857181819,40.19970699999976,74.66002785965799,-2.1471406284948014,252.50505374689237,53.100747162726094,179615.64511521376,-202190.48462742483,96.0,4.0,56.0,58.60009799999989,5851.766601666666,5878.483398333333,5954.416991666668,5981.1337883333335,5775.833008333332,5749.116211666666,5673.182618333331,-0.21919059440494915,-475757.0,+1
2017-01-30,5916.0,5939.0,5885.0,5915.899902,5734.473145,323448.0,5727.3200194,5756.078195909091,138.54980400000022,82.05292830962931,-0.3955496232876693,237.20978397151885,64.17460355689576,-421486.44569402863,-212158.482857725,96.0,0.0,56.0,107.0,5913.299967333333,5941.599934666667,5967.2999673333325,5995.599934666667,5887.599934666667,5859.299967333333,5833.599934666667,0.5722204074074094,-152309.0,+1
2017-01-31,5889.0,5934.899902,5875.5,5894.950195,5733.791992,374637.0,5746.8650389,5786.556409654546,195.45019500000035,77.24682265327434,-0.7542774828767063,205.66366266072146,55.600858869008476,-396959.0479253678,-220558.50854261787,96.0,4.0,56.0,74.55029300000024,5901.783365666667,5928.066731333334,5961.183267666667,5987.466633333334,5868.666829333334,5842.383463666667,5809.266927333334,0.327444900498326,-526946.0,-1
2017-02-01,5900.0,6203.5,5886.0,5894.25,6010.985352000001,1212008.0,5768.6000487,5813.35367530909,217.3500979999999,77.07272660590434,-5.065934966008681,177.94943916736702,77.49020619989808,163255.74729067922,-203112.4060047407,92.0,0.0,56.0,76.79980499999965,5994.583333333333,6103.166666666666,6312.083333333332,6420.666666666666,5785.666666666666,5677.083333333333,5468.166666666666,0.025984251968503937,-1738954.0,-1
2017-02-02,6170.0,6218.350098,6130.0,6179.200195,5977.083984000001,745214.0,5819.580078000001,5888.008247363638,509.80029300000024,88.86102836304957,-0.6397722368065685,165.80712467273588,124.4353330120134,408068.6859025037,-175331.44728168412,96.0,4.0,56.0,134.0,6175.850097666666,6221.700195333333,6264.200195666666,6310.050293333333,6133.350097333333,6087.499999666667,6044.999999333333,0.5568776505488473,-993740.0,+1
2017-02-03,6147.899902,6156.649902,6096.549805,6144.350098,5948.970703,304078.0,5865.570068300001,5947.0573419090915,459.89990299999954,82.84967079811145,-1.2092787439010162,160.50989491472592,102.4295247216231,162004.07638105284,-159998.01438792335,96.0,0.0,92.0,190.5,6132.516601666666,6168.483398333333,6192.616698666668,6228.583495333333,6108.383301333332,6072.416504666666,6048.283204333332,0.7953446897098997,-1297818.0,-1
2017-02-06,6157.0,6187.0,6125.0,6115.450195,5982.288574,322223.0,5905.280078000001,5992.490092218182,397.10009700000046,77.81288976293155,-1.6815495330726467,157.42921910502446,98.14115895864299,242394.62228297978,-141707.4399937914,92.0,4.0,96.0,136.45019500000035,6142.483398333334,6159.9667966666675,6204.483398333334,6221.9667966666675,6097.9667966666675,6080.483398333334,6035.9667966666675,-0.1540291129032202,-1620041.0,-1
2017-02-07,6166.0,6231.5,6144.0,6149.700195,6044.05957,456427.0,5953.3550780000005,6036.930113490909,480.75,79.51580591068169,-1.333873705666525,160.01062993586947,98.05840946947556,266705.7616950784,-123143.2035533882,88.0,0.0,92.0,59.39990200000011,6175.066731666667,6206.133463333334,6262.566731666666,6293.633463333334,6118.633463333334,6087.566731666667,6031.133463333334,0.0651450857142897,-1163614.0,+1
2017-02-08,6219.700195,6233.899902,6165.149902,6213.200195,6026.014647999999,410369.0,6004.6750975,6084.174680218182,513.2001950000003,82.4048064744903,-0.3374090422119452,161.7078075356594,95.62385727322527,385965.29051420937,-100001.90836849739,96.0,0.0,92.0,317.5,6204.083333,6243.016763999999,6272.833333,6311.766763999999,6174.266763999999,6135.333333,6105.516763999999,0.6989133527272762,-753245.0,+1
2017-02-09,6195.5,6204.0,6111.600098,6194.649902,5989.486816,511610.0,6050.4200682,6118.715553763636,457.44970699999976,78.66511411909877,-0.6397822397591907,181.3329242010659,76.46116067681437,-558897.8539975728,-120860.81498800084,96.0,0.0,92.0,324.1000979999999,6170.083333333333,6228.566568666666,6262.483235333332,6320.966470666666,6136.166666666666,6077.683431333333,6043.766764666666,0.8988083558789934,-1264855.0,-1
2017-02-10,6170.0,6173.75,6096.399902,6157.100098,5945.85791,284471.0,6085.8750975,6138.1119228181815,354.55029300000024,71.12605951000265,-1.2518509711130446,201.5579935219148,62.12357233706138,123685.59257308798,-109745.06918976952,92.0,0.0,96.0,82.6503900000007,6142.416666666667,6188.433431333334,6219.766764666668,6265.783529333334,6111.083333333334,6065.066568666667,6033.733235333334,0.7847462067856703,-1549326.0,-1
2017-02-13,6092.0,6139.899902,6002.0,6112.25,5858.064941,404675.0,6105.510107300001,6142.907359636364,196.3500979999999,62.82774631024986,-1.9829158412241052,218.16850497864834,41.59131937506664,-129587.83792164254,-110647.0132230365,88.0,0.0,88.0,62.0,6084.716634,6167.433268000001,6222.616536000001,6305.333170000001,6029.533366000001,5946.816732,5891.6334640000005,0.7994929539543829,-1954001.0,-1
2017-02-14,6045.0,6045.0,5928.100098,6022.0,5778.151367,439745.0,6118.215087800001,6127.723703763637,127.04980499999965,49.43602658295846,-3.4540074880589327,234.41277877097673,14.984318149628326,318070.1481679437,-91159.86952344648,84.0,0.0,88.0,116.04980499999965,5998.366699333333,6068.6333006666655,6115.266601333332,6185.533202666666,5951.733398666665,5881.466797333333,5834.833496666665,0.8032504766342748,-2393746.0,-1
2017-02-15,5950.0,5961.799805,5842.200195,5939.850098,5703.101563,609791.0,6122.775097600001,6095.293705618182,45.60009799999989,40.39325659494904,-4.7930660434107315,233.46985777900136,-9.672567184359746,-169051.7298876095,-94700.40863090844,80.0,0.0,96.0,84.19970699999976,5914.616699333333,5987.033203666665,6034.216309333332,6106.632813666664,5867.433593666666,5795.017089333333,5747.833983666666,0.816473423282903,-3003537.0,-1
2017-02-16,5860.0,6037.950195,5860.0,5862.700195,5860.544922,576390.0,6091.1250976,6048.00735969091,-316.5,33.711222714153934,-6.050623692800388,237.01702932493026,-11.64820352614246,312024.4294218225,-76212.91599214793,76.0,28.000000000000004,96.0,101.60009700000046,5920.2167966666675,5980.433593333335,6098.166991666669,6158.383788333335,5802.483398333335,5742.266601666667,5624.533203333334,0.015173880534384038,-3579927.0,-1
2017-02-17,6038.0,6055.850098,5955.049805,6024.549805,5826.692383,326378.0,6079.145068299999,6035.902761036364,-119.80029300000024,52.66533011878111,-3.4124451962411246,246.86773687804907,9.258914469025902,252560.96073535315,-61268.648868170596,72.0,24.0,92.0,98.25,6011.816569333333,6068.5833336666665,6112.616862333333,6169.383626666667,5967.783040666666,5911.016276333333,5866.982747666666,0.6894821228347009,-3253549.0,+1
2017-02-20,5989.75,6120.75,5912.299805,5989.75,5927.277832,504439.0,6066.575048799999,6019.649112254545,-125.70019500000035,49.17684367509204,-3.9796884366508793,222.26462447647918,3.9998926142560505,-77393.80209282125,-62001.61037838199,68.0,20.0,88.0,155.1000979999999,6007.599934999999,6102.900064999999,6216.050129999999,6311.350259999999,5894.449869999999,5799.149739999999,5685.999674999998,0.3715525188163063,-3757988.0,-1
2017-02-21,6071.100098,6090.649902,6043.0,6093.149902,5898.094238000001,287864.0,6060.920019500001,6024.480903745454,-56.55029300000024,58.58246871386736,-2.294250961684232,204.44297052993716,19.735296804510355,-191885.64684012052,-67905.43021755193,64.0,16.0,84.0,184.1499020000001,6075.599934666668,6108.199869333335,6123.249836666668,6155.849771333335,6060.549967333335,6027.9500326666675,6012.900065333335,1.0524660050717416,-3470124.0,+1
2017-02-22,6073.0,6116.149902,6040.0,6063.149902,5914.145508,431264.0,6045.914990200001,6024.886336927273,-150.05029300000024,55.16474703152957,-2.7832564952581356,183.98393283681798,14.112875042487323,-287721.41564685025,-77897.06591888367,60.0,12.0,80.0,179.79980499999965,6073.099934666668,6106.199869333335,6149.249836666668,6182.349771333335,6030.049967333335,5996.9500326666675,5953.900065333335,0.30400435709030954,-3901388.0,-1
2017-02-23,6090.0,6092.100098,6015.049805,6079.649902,5866.819824,461009.0,6034.414990200001,6031.019957254546,-115.0,56.765449336528505,-2.5143034517924887,156.53054224619336,5.923674282096187,225151.02584679803,-64122.15265680722,56.00000000000001,8.0,48.0,177.95019500000035,6062.266601666666,6109.483398333333,6139.316894666666,6186.533691333333,6032.433105333333,5985.216308666666,5955.382812333332,0.8384146832511106,-3440379.0,+1
2017-02-27,6005.0,6050.950195,5940.0,6031.0,5789.483886999999,394395.0,6021.804980400002,6030.399049945454,-126.10009799999989,50.617407981013464,-3.307305827986761,116.62852064094841,-22.681519227401314,-640169.0461339027,-90306.10236031159,52.0,4.0,48.0,193.14990299999954,6007.316731666667,6074.633463333334,6118.266926666667,6185.583658333334,5963.683268333333,5896.366536666666,5852.733073333333,0.8201878329280964,-3834774.0,-1
2017-02-28,5946.299805,6000.0,5914.799805,5951.5,5761.272949,558820.0,6005.7299804,6017.616326236363,-160.75,42.03356128097451,-4.603170491957606,75.4855248325257,-56.15421849443923,177352.70175599886,-78139.79308229747,48.0,0.0,48.0,208.45019500000035,5955.433268333333,5996.066731666667,6040.6334633333345,6081.266926666667,5910.866536666666,5870.233073333333,5825.666341666666,0.4307524765641698,-4393594.0,-1
2017-03-01,5960.0,5998.799805,5885.149902,5922.5,5758.452147999999,559896.0,5995.7799804,6002.4836025272725,-99.5,39.233197022090245,-5.075875841079046,38.093193066428285,-78.91522167190973,439864.61986269424,-54594.13794843419,44.0,0.0,48.0,100.89990200000011,5935.483235666667,5985.816569333333,6049.133138666665,6099.466472333333,5872.1666663333335,5821.833332666667,5758.516763333334,0.32864170592384967,-4953490.0,-1
2017-03-02,5951.0,5998.799805,5900.25,5919.600098,5757.625488000001,473769.0,5993.7549804,5988.632714818182,-20.25,38.933915672709915,-4.658475053235056,1.155803639117039,-87.32682204373666,-598391.0,-79312.17713259629,40.0,0.0,48.0,76.14990200000011,5939.549967666666,5978.849935333332,6038.099772666665,6077.3997403333315,5880.300130333332,5841.000162666666,5781.7503253333325,0.19634841489539182,-5427259.0,-1
2017-03-03,5924.0,5928.950195,5875.0,5918.75,5727.469727000001,362057.0,5999.3599609,5974.995445654546,56.04980499999965,38.83371549809583,-4.197703609202025,-23.448348646081286,-116.46833798979334,-96037.71275327732,-80072.42875171817,36.0,0.0,48.00000000000001,77.05029300000024,5907.566731666667,5940.133463333334,5961.516926666667,5994.083658333334,5886.183268333333,5853.616536666666,5832.233073333333,0.8109331208163328,-5789316.0,-1
2017-03-06,5925.5,5974.799805,5912.0,5887.75,5773.287109000001,361209.0,5985.679980399999,5954.702725490909,-136.79980499999965,35.039366719277496,-4.174045358979035,-36.16452302704329,-101.95090995671059,-1583341.6213988764,-148402.8465993163,32.0,0.0,48.0,139.6499020000001,5924.849934999999,5937.699869999999,5987.649739999999,6000.499674999998,5874.900064999999,5862.05013,5812.100259999999,-0.38614769584077746,-6150525.0,-1
2017-03-07,5931.0,5954.0,5881.0,5934.850098,5728.19873,373103.0,5980.1899902,5945.460928690909,-54.89990200000011,44.53932090983286,-3.0871408145472676,-32.91199425727609,-98.24648598884016,17616.5537508284,-140856.51021976426,28.000000000000004,48.0,48.0,116.20019500000035,5923.283366,5965.566731999999,5996.283366,6038.566731999999,5892.566731999999,5850.283366,5819.566731999999,0.7376725753424642,-5777422.0,+1
2017-03-08,5895.0,5904.899902,5800.0,5888.5,5704.511719,639968.0,5959.724999999999,5928.790021381818,-204.6499020000001,38.19663609242084,-3.8568522439490183,-45.94066426289464,-135.65375129697478,-200418.46025428013,-143563.8715849695,24.0,44.0,44.0,113.64990299999954,5864.466634,5928.933268000001,5969.366536000001,6033.833170000001,5824.033366000001,5759.566732,5719.1334640000005,0.8436614173385968,-6417390.0,-1
2017-03-09,5884.0,5975.0,5864.149902,5864.149902,5802.032715,598391.0,5939.825,5911.412730836364,-199.0,35.16139238158779,-4.261221372524596,-56.946249290418564,-77.72254798866253,-899275.3107375626,-177914.39154645105,20.0,96.0,40.0,98.54980499999965,5901.099934666668,5938.049967333335,6011.950032666668,6048.900065333335,5827.199869333335,5790.249836666668,5716.349771333335,0.0,-7015781.0,-1
2017-03-10,5997.0,6008.399902,5936.049805,5964.399902,5793.472168,443986.0,5928.300000000001,5915.880894836364,-115.25,52.929727541074996,-2.596422933532609,-80.99336436032263,-9.40822850034512,42507.04675283823,-167895.23526011972,16.0,92.0,36.0,53.95019500000035,5969.616536333334,6003.183267666668,6041.966633333334,6075.533364666669,5930.833170666668,5897.266439333333,5858.483073666667,0.3918460123142652,-6571795.0,+1
2017-03-14,6060.0,6144.399902,6010.0,5955.600098,5965.458984000001,875005.0,5920.7600098,5920.844549018182,-75.39990200000011,51.50030898101051,-3.1230325050546215,-84.85644527739987,51.514346106510345,234038.8667930221,-149625.50334861325,12.0,88.0,32.0,62.79980499999965,6036.666666666667,6063.333333333334,6171.066568666667,6197.733235333334,5928.933431333334,5902.266764666667,5794.533529333334,-0.404761470733811,-7446800.0,-1
2017-03-15,6115.0,6168.799805,6092.5,6132.399902,5970.274902,384040.0,5938.85,5959.324529418182,180.8999020000001,70.17350526953504,-0.5996886910506523,-89.64239329048269,124.06639010335049,741685.4949757576,-109111.36706114179,8.0,84.0,-19.999999999999996,73.0,6131.233235666667,6169.966471333333,6207.533040666665,6246.266276333333,6093.6666663333335,6054.933430666667,6017.366861333334,0.5229358318805702,-7062760.0,+1
2017-03-16,6159.600098,6186.299805,6131.700195,6137.350098,5987.881836,252721.0,5960.3350098,5995.415456327273,214.8500979999999,70.53994434273577,-0.8041284078006696,-89.85426655087122,124.55021128184038,-617778.1381638963,-132232.58392944883,4.0,80.0,-20.0,134.8500979999999,6151.783366,6171.866536999999,6206.382975999998,6226.466146999998,6117.266927,6097.183756,6062.667317,0.10347881605747024,-6810039.0,+1
2017-03-17,6165.0,6226.799805,6150.0,6155.450195,6024.020996,1048024.0,5983.920019499999,6030.890944545455,235.85009700000046,71.99169744314952,-1.164359350345965,-76.21481274486086,121.65322609714639,318491.0281534497,-111745.14701658979,0.0,76.0,-76.0,110.85009799999989,6177.416666666667,6204.833333333334,6254.216471666667,6281.633138333334,6128.033528333334,6100.616861666667,6051.233723333335,0.07096626091694339,-5762015.0,+1
2017-03-20,6220.0,6220.0,6151.100098,6192.600098,5991.237305,207710.0,6011.305029300001,6068.832777,273.8500979999999,74.91876535640597,-0.5581074462010719,-52.40627987032076,106.88842880884961,148170.3939121518,-99930.80424710154,96.0,72.0,-76.0,144.25,6187.900065333332,6224.700032666665,6256.799967333332,6293.599934666665,6155.800130666665,6119.000163333332,6086.900228666665,0.6023230628107414,-5554305.0,+1
2017-03-21,6164.75,6200.549805,6051.850098,6158.899902,5910.88623,532134.0,6038.420019500001,6095.6682084,271.1499020000001,67.53163253501026,-1.1080633369353283,-28.393436646971168,66.62962276732348,-233814.16967989597,-106016.41176677402,92.0,68.0,-76.0,180.0,6137.099934999999,6222.349771999999,6285.799641999999,6371.049478999998,6073.650064999999,5988.4002279999995,5924.950357999999,0.7199059511260529,-6086439.0,-1
2017-03-22,6046.399902,6053.399902,5977.399902,6076.299805,5842.305176,462793.0,6052.564990200001,6102.555442127273,141.44970699999976,52.80624800674646,-2.4560201832507484,-6.907873272903998,8.80205673393747,63728.871663844526,-98300.71706538225,88.0,64.0,-76.0,213.19970699999976,6035.699869666667,6093.999837333334,6111.699869666668,6169.999837333334,6017.999837333334,5959.699869666667,5941.999837333334,1.3013145131578887,-6549232.0,-1
2017-03-23,6015.899902,6069.0,6015.899902,6005.799805,5870.516113000001,447530.0,6064.294970700001,6094.052681181819,117.29980499999965,43.47118344893443,-3.606514687697113,15.993426346623892,7.5058971406512365,-650526.2269711811,-123401.87660655496,84.0,60.0,-76.0,54.5996099999993,6030.233235666667,6044.566569333333,6083.3333336666665,6097.666667333333,5991.466471333333,5977.133137666667,5938.366373333333,-0.19020863200667693,-6996762.0,-1
2017-03-24,6047.0,6047.0,5992.100098,6034.799805,5841.186522999999,573292.0,6081.359961000001,6088.689923781818,170.64990299999954,47.84708357981357,-3.133261629130523,29.008284513017315,6.017503209902006,-337776.43223060825,-133146.17458946648,80.0,56.00000000000001,-76.0,89.44970699999976,6024.633300999999,6057.166503999998,6079.533202999998,6112.066405999998,6002.266601999998,5969.733398999999,5947.366699999998,0.7777738291773212,-6423470.0,+1
2017-03-27,5977.0,6020.0,5965.649902,6004.649902,5822.850098,340512.0,6085.384961000001,6074.742640327273,40.25,43.78149075249032,-3.6252800363800324,43.90134487553132,-10.542191605033658,-545348.7677039959,-151882.6560946724,76.0,52.0,24.0,68.89990200000011,5996.766601333334,6027.883300666667,6051.116699333333,6082.233398666667,5973.533202666667,5942.416503333334,5919.1831046666675,0.7175700032776404,-6763982.0,-1
2017-03-28,5971.200195,6049.0,5962.549805,5985.799805,5811.614746,505962.0,6088.4049317,6056.636248327272,30.199706999999762,41.25279068476829,-3.9328961073982085,58.549764528866945,-9.260306162423825,-1069568.255540057,-193595.6378876445,72.0,48.0,24.0,148.69970699999976,5999.1165366666655,6035.683268333331,6085.566731666665,6122.133463333332,5949.233073333331,5912.666341666665,5862.782878333331,0.26894097809727213,-7269944.0,-1
2017-03-29,6008.899902,6008.899902,5929.350098,5974.25,5782.333984000001,494597.0,6072.5899415,6035.8808062,-158.1499020000001,39.63438330720977,-4.121378195056743,70.59877491559746,-33.29005664069983,591059.6743533172,-157929.48733123712,68.0,44.0,24.0,181.5,5970.833333333333,6012.316568666666,6050.383137333333,6091.866372666666,5932.766764666666,5891.283529333333,5853.216960666666,0.5644250487405348,-7764541.0,-1
2017-03-30,5965.0,6000.899902,5935.049805,5944.149902,5794.444824,898999.0,6053.269921900001,6012.528071745454,-193.20019599999978,35.452063840111805,-4.612583830975849,81.98607982979229,-47.01115939079814,52590.12533957786,-148360.41402801825,64.0,40.0,24.0,60.39990299999954,5960.033203,5985.016601,6025.8833,6050.866698000001,5919.166504,5894.1831059999995,5853.316406999999,0.13819413204509626,-8663540.0,-1
2017-03-31,5952.0,6041.0,5940.100098,5956.600098,5851.936035,501939.0,6033.3849122,5994.951740127272,-198.85009700000046,38.546950321612776,-4.409408198674006,75.95209938782136,-33.00464051240499,-173324.46640962307,-149495.14368172755,60.0,36.0,23.999999999999993,54.89990200000011,5979.233398666666,6018.366699333333,6080.133300666667,6119.266601333333,5917.466797333333,5878.333496666666,5816.5668953333325,0.16352840461628973,-8161601.0,+1
2017-04-03,6095.0,6095.0,6030.0,6015.700195,5906.703125,378716.0,6015.6949219,5991.736337,-176.89990299999954,51.32881453312789,-3.444949520507374,67.91048502946342,21.743337611861683,13432.75504773223,-142089.33010311573,56.00000000000001,32.0,24.0,69.14990299999954,6046.900065000001,6063.800130000001,6111.900065000002,6128.800130000001,5998.800130000001,5981.900065000001,5933.800130000001,-0.21999699999999464,-7782885.0,+1
2017-04-05,6110.0,6359.0,6071.049805,6072.0,6169.742676,1076674.0,6007.0049317,6001.9736239272725,-86.89990200000011,60.38553830275762,-4.584664536741214,58.80854451080813,122.30540548191982,317885.93917212664,-121181.36331787743,52.0,28.000000000000004,24.0,86.45019500000035,6167.349934999999,6263.650064999999,6455.300129999999,6551.600259999999,5975.699869999999,5879.399739999999,5687.749674999998,0.0032998588523280832,-6706211.0,+1
2017-04-06,6335.0,6336.0,6260.0,6342.399902,6120.374022999999,505863.0,6033.6149414,6062.954527618182,266.10009700000046,80.49710323588945,-0.26517728434504617,47.2365035304083,243.24829330844372,240107.64456809266,-104759.13568669696,96.0,24.0,24.0,79.54980400000022,6312.799967333333,6365.599934666667,6388.7999673333325,6441.599934666667,6289.599934666667,6236.799967333333,6213.599934666667,1.0842092368421068,-6200348.0,+1
2017-04-07,6250.0,6336.0,6236.049805,6291.649902,6088.953613000001,467235.0,6062.199951099999,6109.869975,285.85009700000046,72.52360481049861,-1.0758801597444072,33.357612418774806,182.87217703141087,-7637.855008238293,-100344.53201949429,92.0,20.0,24.0,65.85009700000046,6287.899902333334,6339.7499996666675,6387.850097333335,6439.700194666668,6239.799804666667,6187.949707333333,6139.849609666667,0.5562780242699903,-6667583.0,-1
2017-04-10,6282.0,6307.799805,6245.049805,6259.350098,6098.194824,318486.0,6084.654980399999,6145.715456254546,224.55029300000024,67.60587308110229,-1.5918514696485642,27.847475883903826,147.5862615936748,-488680.4907225206,-117996.16650599551,88.0,16.0,24.0,100.89990200000011,6270.733236,6296.416667,6333.483235999999,6359.166667,6233.666667,6207.983236,6170.916667,0.2278931155378524,-6986069.0,-1
2017-04-11,6274.799805,6305.0,6230.0,6268.850098,6077.717285,373105.0,6111.075000000001,6179.205477636363,264.2001959999998,68.33456267279782,-1.4400942811501616,32.577024756741594,132.67214185693607,-208827.70610205265,-122124.87285127083,84.0,12.0,24.000000000000007,138.3999020000001,6267.950032666667,6305.900065333333,6342.9500326666675,6380.900065333333,6230.900065333333,6192.950032666667,6155.900065333333,0.5180013066666652,-6612964.0,+1
2017-04-12,6263.899902,6263.899902,6126.700195,6247.799805,5986.95752,415372.0,6137.275,6204.064533090909,262.0,64.6182364105689,-1.7763609424920181,33.64781441195919,76.63533760637823,-394347.74018485646,-134498.63954825202,80.0,8.0,23.999999999999996,343.29980499999965,6212.799967333333,6298.899739666666,6349.999674333333,6436.099446666666,6161.700032666667,6075.600260333334,6024.500325666667,0.8826521036229291,-7028336.0,-1
2017-04-13,6155.0,6175.0,6066.899902,6154.5,5912.491699,386820.0,6155.3,6207.196351272727,180.25,50.556956985319324,-3.2667731629392973,35.42281653018472,11.029709009451556,187186.5958716761,-119876.5833928007,76.0,4.0,72.0,264.0,6132.133300666667,6197.3666993333345,6240.233398666668,6305.466797333334,6089.266601333335,6024.033202666667,5981.166503333335,0.8103609489789729,-7415156.0,-1
2017-04-17,6070.600098,6137.5,6021.0,6077.950195,5949.067871,342286.0,6168.6800293,6193.132750363638,133.80029300000024,41.9209643755794,-4.489613498402551,41.7317636690168,-26.27680594001891,-516699.8717649652,-137914.00559153548,72.0,0.0,72.0,106.35009700000046,6078.816731666667,6136.633463333334,6195.316731666666,6253.133463333334,6020.133463333334,5962.316731666667,5903.633463333334,0.4888428755364837,-7757442.0,-1
2017-04-18,6120.0,6234.350098,6120.0,6115.549805,5970.07959,453391.0,6184.575,6183.472709581818,158.94970699999976,47.0472953425615,-3.8889807507987277,48.782351261994336,32.26119495197946,23911.933615939477,-130558.28108210479,68.0,0.0,72.0,62.75,6156.633300999999,6193.266601999998,6270.983398999999,6307.616699999998,6078.916503999998,6042.283202999999,5964.566405999998,-0.03891728190736096,-7304051.0,+1
2017-04-19,6131.899902,6222.350098,6113.799805,6137.149902,6028.252441,366504.0,6196.719970700001,6174.849964490909,121.44970699999976,49.97415530423067,-3.54393127795527,60.50161524457053,33.4462306970118,-291511.77323076595,-137874.34890704392,64.0,48.0,72.0,75.0,6157.766601666666,6201.733398333333,6266.316894666666,6310.283691333333,6093.183105333333,6049.216308666666,5984.632812333332,0.21510855802112305,-6937547.0,+1
2017-04-20,6200.0,6303.149902,6188.0,6196.950195,6102.718261999999,466934.0,6209.214990200001,6174.891823454545,124.95019500000035,57.481513098170026,-2.588655031948876,80.22443891881085,79.54172096607417,354447.76664935175,-115496.07092720772,60.0,44.0,72.0,142.14990299999954,6229.366699000001,6270.733398000002,6344.516601000001,6385.883300000002,6155.583496000002,6114.216797000001,6040.433594000002,0.0777264664975602,-6470613.0,+1
2017-04-21,6283.899902,6295.049805,6177.0,6273.5,6017.405272999999,294827.0,6202.325000000001,6186.580007054546,-68.89990200000011,65.19605062242118,-1.365814696485623,95.3376441099299,81.11678157468717,-1106842.30489335,-160557.26338021422,56.00000000000001,40.0,72.0,180.89990299999954,6248.516601666666,6320.0332033333325,6366.566406666665,6438.083008333332,6201.983398333333,6130.466796666667,6083.933593333333,0.8174515832533589,-6175786.0,+1
2017-04-24,6223.200195,6335.0,6200.0,6185.799805,6146.347656,426893.0,6191.7399903000005,6183.575426145455,-105.85009700000046,52.58389727041474,-2.766776277955277,113.42276333357313,65.45233923676072,-2366526.870949609,-260828.60917882316,52.0,36.0,72.0,133.5,6240.266601666666,6280.5332033333325,6375.266601666666,6415.5332033333325,6145.5332033333325,6105.266601666666,6010.5332033333325,-0.10518662962963221,-6602679.0,-1
2017-04-25,6327.700195,6350.0,6282.5,6318.350098,6164.684082,384281.0,6197.6399903,6206.595445727272,59.0,64.54504661531041,-0.6493594568690113,98.23751275659833,100.24063037860667,286615.7153502969,-235944.7762456813,48.0,32.0,68.0,156.39990299999954,6316.950032666667,6351.400065333333,6384.4500326666675,6418.900065333333,6283.900065333333,6249.450032666667,6216.400065333333,0.5311125629629613,-6218398.0,+1
2017-04-26,6335.0,6424.75,6311.0,6337.200195,6231.902832,540500.0,6204.475,6231.9700284,68.35009700000046,65.95430325065563,-1.3840225269730806,90.67706522419576,104.42309572872512,-152497.80569094286,-232151.73212955685,44.0,28.000000000000004,16.0,108.55029300000024,6357.650065000001,6404.300130000001,6471.400065000002,6518.050130000001,6290.550130000001,6243.900065000001,6176.800130000001,0.23033138461538769,-5677898.0,+1
2017-04-27,6439.0,6450.0,6320.350098,6406.299805,6200.530761999999,1087684.0,6220.325000000001,6268.665447490909,158.5,70.8543172085568,-0.6880836876082562,91.29091193844852,109.12303895329265,5442.198708591395,-221352.00800055012,96.0,24.0,16.0,166.0,6392.216634333333,6464.083170666666,6521.866536333334,6593.733072666666,6334.433268666666,6262.566732333333,6204.783366666666,0.6629369222353881,-4590214.0,+1
2017-04-28,6410.0,6589.799805,6390.549805,6374.049805,6347.226074,949573.0,6242.2799804999995,6296.6154120363635,219.54980499999965,65.75768128440183,-3.3239355161409114,87.73875674461397,132.32799798407103,-18078.791698135028,-212112.31635044038,96.0,20.0,16.000000000000007,118.04980499999965,6451.466471666667,6512.383138333334,6650.716471666666,6711.633138333334,6313.133138333334,6252.216471666667,6113.883138333334,-0.08281053952321205,-5539787.0,-1
2017-05-02,6676.0,6730.0,6618.0,6524.850098,6522.958008,888539.0,6286.9699708,6347.991797036364,446.89990299999954,75.33142392494551,-3.093800361936361,85.72397174289108,206.78917851776123,-83973.0123366696,-206287.8025316326,96.0,16.0,16.0,135.0,6624.283366,6630.566731999999,6736.283366,6742.566731999999,6518.566731999999,6512.283366,6406.566731999999,-0.8316955535714295,-4651248.0,+1
2017-05-03,6714.799805,6714.950195,6631.100098,6705.5,6463.131836,370021.0,6345.964990300001,6424.088165981818,589.9501950000003,82.20748100599354,-0.3694767003468557,97.75511052084948,196.93233560539102,-328927.52629915916,-211862.33543015653,96.0,12.0,16.0,164.20019500000035,6683.850097666666,6736.600097333333,6767.700194666667,6820.4501943333335,6652.7500003333325,6600.000000666666,6568.899903333332,0.8872965525609314,-4281227.0,+1
2017-05-04,6662.0,6686.950195,6626.0,6644.0,6459.046386999999,372533.0,6396.6500001,6478.276349563636,506.8500979999999,74.09473241446375,-1.2969386216256975,123.28231186677021,147.82846908161443,-82712.85072437898,-205991.9043071666,92.0,8.0,15.999999999999996,113.75,6652.316731666667,6678.633463333334,6713.266926666667,6739.583658333334,6617.683268333333,6591.366536666666,6556.733073333333,0.2953230912550796,-4653760.0,-1
2017-05-05,6625.549805,6676.399902,6602.0,6639.799805,6473.005371,337498.0,6440.9349611,6522.485404999999,442.8496099999993,73.52296169047679,-1.3602804252752276,144.85015754403958,118.45837190456777,86296.03738317757,-192706.08877578733,88.0,4.0,72.0,129.6499020000001,6639.399902333334,6676.799804666667,6713.799804333334,6751.199706666667,6602.399902666667,6565.000000333333,6528.000000666667,0.5080625643834799,-4991258.0,-1
2017-05-08,6688.0,6703.649902,6612.549805,6654.149902,6450.04834,208481.0,6478.999951300001,6561.251757890908,380.6499020000001,74.30463042123789,-1.1438711808173712,165.70670321432317,105.75591976476834,-357049.95179662394,-200176.26436764357,84.0,0.0,76.0,199.25,6656.783203,6701.016601,6747.8833,6792.116698000001,6609.916504,6565.6831059999995,6518.816406999999,0.45664163233547655,-4782777.0,+1
2017-05-09,6666.0,6666.0,6615.0,6630.549805,6448.832031,215203.0,6523.474951300001,6588.806276745454,444.75,70.36275384655382,-1.4997767305082244,179.91951179793796,84.39598113504822,-766134.0840648698,-225901.6198084266,80.0,0.0,80.0,355.95019500000035,6637.183268333333,6659.366536666666,6688.183268333334,6710.366536666666,6608.366536666666,6586.183268333333,6557.366536666666,0.3048981372548951,-4997980.0,-1
2017-05-10,6645.0,6754.0,6635.899902,6629.299805,6554.330078,295859.0,6554.569922000001,6608.047159236363,310.94970699999976,70.13536542899776,-1.8737820435762638,183.92554442710843,83.10334968595994,205874.89318681322,-206275.4146722793,76.0,0.0,84.0,190.10009700000046,6673.066569,6710.233235999999,6791.166666999999,6828.333333999999,6592.133137999999,6554.966471,6474.033039999999,-0.05588561831676436,-5293839.0,-1
2017-05-11,6749.0,6789.399901999999,6711.100098000001,6737.75,6578.405761999999,259056.0,6594.6249025,6641.352627963637,400.54980499999965,77.4353550953697,-0.7720002205631864,205.96758288333058,90.79128113836214,468956.84069872135,-175583.03942814286,96.0,32.0,84.0,79.5,6746.083333333333,6781.066568666665,6824.383137333332,6859.366372666664,6702.766764666667,6667.783529333335,6624.4669606666685,0.3403571993615686,-5034783.0,+1
2017-05-12,6798.0,6798.0,6691.0,6762.5,6546.98584,256491.0,6630.244922,6671.8753729636355,356.20019500000035,78.79992329286524,-0.5299298402746679,217.13116557608464,79.55050562128618,209181.2161788553,-158093.75508237022,96.0,28.000000000000004,84.0,74.39990200000011,6750.5,6810.0,6857.5,6917.0,6703.0,6643.5,6596.0,0.6682242990654206,-4778292.0,+1
2017-05-15,6759.399901999999,6839.100098000001,6733.450195,6730.200195,6638.134765999999,336356.0,6665.859961,6690.0490589636365,356.1503900000007,72.2231097432022,-1.6157015684724694,230.91947088954385,72.05318088330762,101400.79730729894,-146298.54815556708,96.0,24.0,84.0,91.10009700000046,6767.583496,6801.716797,6873.233399000002,6907.3667000000005,6696.066894,6661.933593,6590.416990999999,-0.03076197807772702,-5114648.0,-1
2017-05-16,6850.0,6977.549805,6830.0,6823.899901999999,6764.644531,707624.0,6695.764941400001,6718.7835936909105,299.0498039999993,78.28857700522136,-2.2337543138571556,256.98042213735243,84.83722271649106,-1438850.354623665,-205050.90299502615,96.0,20.0,80.0,51.0,6877.149902333334,6924.299804666667,7024.699707333333,7071.849609666667,6776.7499996666675,6729.600097333334,6629.200194666668,-0.041342636813385236,-4407024.0,+1
2017-05-17,6950.0,6979.0,6885.850098000001,6953.950195,6768.778809,445461.0,6720.6099609,6765.726367072727,248.45019500000035,83.91394749726513,-0.36409600290697164,290.9156666270801,85.99638876554044,140049.70281938667,-189364.51182164374,96.0,16.0,76.0,123.45019500000035,6939.600097666666,6993.350097333332,7032.749999666665,7086.499999333331,6900.200195333333,6846.450195666667,6807.050293333334,0.7310807154687091,-3961563.0,+1
2017-05-18,6918.299805,6948.0,6814.450195,6958.200195,6645.089844,406814.0,6752.029980400001,6808.924591454545,314.20019500000035,84.06958541873547,-0.3023227470930182,305.5143971246471,67.23335589867219,-270718.9240509109,-193062.43965024682,96.0,12.0,64.0,160.10009699999955,6906.8834633333345,6999.316731666669,7040.433268333335,7132.866536666668,6865.766926666669,6773.333658333335,6732.217121666669,1.0763774608281935,-3554749.0,+1
2017-05-19,6854.799805,6893.899901999999,6691.549805,6831.049805,6605.692383,552223.0,6771.154980400001,6823.29183229091,191.25,63.02081871726718,-2.1504388808139585,294.0590061353241,38.64539242078864,-125231.18881245189,-189979.2009758016,92.0,8.0,68.0,107.0,6805.499837333333,6919.449869666666,7007.849934333332,7121.799966666666,6717.0997726666665,6603.149740333333,6514.749675666667,0.6893992247505585,-4106972.0,-1
2017-05-22,6803.950195,6843.950195,6689.25,6790.549805,6519.261719,327493.0,6784.794970700001,6826.818164036365,136.39990299999954,57.710419025795076,-2.739101671511633,288.94097484424765,27.134953714873436,-232607.76487663278,-191916.86297129394,88.0,4.0,72.0,105.64990300000045,6774.583333333333,6859.916666666666,6929.283528333333,7014.616861666666,6705.216471666666,6619.883138333333,6550.516276666665,0.6548136865632227,-4434465.0,-1
2017-05-23,6765.0,6910.0,6743.649901999999,6701.700195,6691.588867,956457.0,6791.910009700001,6811.710023,71.1503900000007,47.5648249723207,-4.030520421511623,276.80608736898466,25.033079419421213,-72034.54258072076,-186467.66658990426,84.0,0.0,76.0,247.3496099999993,6785.116698999999,6826.583495999999,6951.466796999999,6992.933594,6660.2333979999985,6618.766600999998,6493.883299999998,-0.25217723045764995,-5390922.0,-1
2017-05-24,6903.0,6912.549805,6813.0,6878.850098000001,6682.63916,433647.0,6816.865039000001,6827.517311781819,249.55029300000115,62.66477045294921,-1.4556671802325465,262.5110627179429,40.03559331615782,-505886.81555448414,-200986.71881556697,80.0,4.0,80.0,155.1000980000008,6868.133300999999,6923.266601999998,6967.683105999999,7022.8164069999975,6823.716796999998,6768.583495999999,6724.166991999999,0.661478925046624,-4957275.0,+1
2017-05-25,6879.950195,7018.0,6835.0,6869.649901999999,6795.530273,435721.0,6830.055029200001,6837.1145596,131.8999019999992,61.60173037983987,-2.144097384015043,254.2119152542855,44.821028094797924,321961.3434317672,-177216.35234977904,76.0,0.0,84.0,139.5,6907.5499673333325,6980.099934666665,7090.5499673333325,7163.099934666665,6797.099934666665,6724.5499673333325,6614.099934666665,0.18934372677595193,-5392996.0,-1
2017-05-26,6971.149901999999,7085.049805,6936.200195,6985.700195,6872.476562999999,373937.0,6852.375048700001,6865.413680654546,223.20019500000035,69.20504308636531,-1.4221142530202633,251.4362760025433,62.82755294216789,19458.044651649638,-168276.6070315323,96.0,4.0,84.0,266.6503900000007,7002.316731666667,7068.433268333333,7151.166341666666,7217.2828783333325,6919.583658333334,6853.4671216666675,6770.734048333335,0.33255041783448563,-5019059.0,+1
2017-05-29,7050.0,7197.799805,7025.549805,7064.799805,6940.230956999999,427378.0,6885.835009700001,6904.036363618181,334.5996099999993,73.35449852051217,-1.8735561454532386,240.58474432449657,79.90635824949446,-98714.30862534522,-165114.6843767056,96.0,0.0,84.0,154.70019500000035,7096.049805,7166.549805,7268.299805,7338.799805,6994.299805,6923.799805,6822.049805,0.22786647314949202,-4591681.0,+1
2017-05-30,7134.450195,7206.600098000001,7084.149901999999,7134.450195,6952.925781,403698.0,6916.890039000001,6949.239124581819,310.55029300000115,76.56305456605904,-1.0151092071190475,233.6656543191284,84.14429106702299,56482.7454385625,-155042.07393055706,96.0,0.0,84.0,166.3500980000008,7141.733398333334,7199.316894666668,7264.183594333335,7321.76709066667,7076.866698666667,7019.283202333332,6954.416502666665,0.4107816454618047,-4187983.0,+1
2017-05-31,7138.0,7248.0,7134.950195,7147.5,7014.696289,650259.0,6936.245019500001,6991.1682084,193.54980499999965,77.15769446253749,-1.405791019723038,227.29797909450463,85.80302654972284,-478429.9225488618,-169741.52159502546,96.0,0.0,76.0,210.8496099999993,7176.816731666667,7218.683268333333,7289.8665366666655,7331.733073333333,7105.633463333334,7063.766926666667,6992.583658333334,0.11101129276604847,-3537724.0,+1
2017-06-01,7242.0,7245.0,7110.100098000001,7211.0,6952.050293000001,649217.0,6961.5250000000015,7041.123659399999,252.79980499999965,80.00590676574029,-0.5175549027836062,219.07233973650546,81.88626343079699,-341162.62574285525,-177533.38996538136,96.0,0.0,76.0,183.0,7188.7000326666675,7267.299967333334,7323.599934666667,7402.1998693333335,7132.400065333335,7053.800130666668,6997.500163333336,0.7479612698310174,-2888507.0,+1
2017-06-02,7182.0,7187.700195,7100.0,7146.600098000001,6921.018555,310268.0,6993.0800293,7074.7736772181825,315.55029300000115,69.81852709006819,-1.4183788222128857,192.83296560965664,64.05243212237734,-948136.304896922,-212560.79518954232,92.0,0.0,92.0,215.39990300000045,7144.766764333333,7189.533528666667,7232.466959333335,7277.233723666667,7101.8333336666665,7057.066569333333,7014.133138666666,0.5313568344973533,-3198775.0,-1
2017-06-05,7139.799805,7161.899901999999,7091.100098000001,7114.700195,6931.719238,296147.0,7025.495068300001,7096.886434618183,324.1503900000007,65.08206742031462,-1.8645937194013098,168.83889282741347,53.11901357650399,597136.1423389706,-175756.38893824624,88.0,0.0,96.0,212.0996099999993,7122.566731666667,7154.033365333333,7193.366535666666,7224.833169333331,7083.233561333334,7051.766927666668,7012.433757333336,0.3333356261833731,-3494922.0,-1
2017-06-06,7134.0,7154.299805,7085.049805,7125.700195,6918.489258,324579.0,7067.895068300001,7115.105548563637,424.0,65.99979940893896,-1.7107260456007782,160.64352191523267,48.784111703507754,-216193.58319277473,-177594.443222543,84.0,12.0,96.0,141.80029300000115,7121.683268333333,7158.316731666667,7190.933268333333,7227.566731666667,7089.066731666667,7052.433268333333,7019.816731666667,0.5870092418772664,-3170343.0,+1
2017-06-07,7135.0,7225.0,7107.600098000001,7112.100098000001,7009.541015999999,518152.0,7091.220068300001,7123.14282669091,233.25,63.61461755951554,-1.9009637991327346,168.4414673909714,52.644319646943856,-120878.25346576887,-175016.4345972351,80.0,8.0,96.0,113.54980499999965,7148.233398666667,7188.866699333334,7265.633300666666,7306.266601333333,7071.466797333334,7030.833496666668,6954.066895333335,0.03833052603399985,-3688495.0,-1
2017-06-08,7199.0,7274.950195,7198.0,7205.700195,7052.148926000001,426525.0,7124.825097600001,7143.957395181818,336.05029300000115,71.72822738450489,-0.9650289943240054,204.87626370541147,70.90629439050076,118676.1897387948,-161666.76985468826,76.0,4.0,96.0,134.8999019999992,7226.2167966666675,7254.433593333335,7303.166991666669,7331.383788333335,7177.483398333335,7149.266601666667,7100.533203333334,0.10006725778927934,-3261970.0,+1
2017-06-09,7271.0,7480.899901999999,7230.0,7249.5,7261.63623,1122640.0,7151.2050781,7166.625559254545,263.79980499999965,74.76638582296158,-3.1346930339343313,217.53068350306512,88.89203084788853,72323.16976427022,-151030.86350837196,96.0,0.0,92.0,111.0,7320.1333006666655,7410.266601333331,7571.033202666666,7661.16650333333,7159.366699333332,7069.233398666666,6908.466797333333,0.07772023761093402,-2139330.0,+1
2017-06-12,7445.0,7450.0,7355.5,7464.850098000001,7172.918456999999,454342.0,7191.2101074,7223.651926509092,400.05029300000115,84.3235070399098,-0.2174210462492181,239.19521354294284,103.84454407253875,-125532.68251760509,-149871.85528151892,96.0,0.0,88.0,70.7998039999984,7423.4500326666675,7491.400065333335,7517.9500326666675,7585.900065333335,7396.900065333335,7328.9500326666675,7302.400065333335,1.1571438941799026,-1684988.0,+1
2017-06-13,7394.600098000001,7455.0,7335.0,7373.649901999999,7148.891113,607567.0,7215.130078100001,7256.822798254545,239.19970699999885,71.15461304181864,-1.4528780046305212,246.35531638443172,80.64442776812848,199272.95641469938,-134001.63656805444,92.0,0.0,72.0,69.25,7387.8833006666655,7440.766601333331,7507.883300666665,7560.766601333331,7320.766601333331,7267.8833006666655,7200.766601333331,0.32208251666666,-2292555.0,-1
2017-06-14,7343.0,7392.450195,7331.850098000001,7348.950195,7150.93457,277472.0,7235.275097600001,7281.153728600001,201.45019500000035,67.84365400015604,-1.7874762425896529,242.15004594635047,64.92277777208386,-81766.3885142458,-131627.30711106316,88.0,0.0,72.0,117.3999019999992,7357.750162666667,7383.6502273333335,7418.350259666668,7444.250324333333,7323.050130333334,7297.150065666668,7262.450033333334,0.28217936680859895,-2570027.0,-1
2017-06-15,7348.350098000001,7393.0,7272.149901999999,7351.049805,7113.239258,388150.0,7249.2800781000005,7302.203675400001,140.04980499999965,67.98974873620456,-1.7590335648525781,229.06369286339668,53.71167520142983,-705825.7616739015,-157727.23686391945,84.0,28.000000000000004,72.0,162.85009699999955,7338.733235666667,7405.316569333334,7459.583333666667,7526.166667333335,7284.466471333333,7217.883137666666,7163.616373333332,0.6528741333747196,-2181877.0,+1
2017-06-16,7332.0,7360.049805,7250.0,7312.299805,7066.15625,547028.0,7265.850048800001,7313.661807563636,165.69970699999885,61.99204739440305,-2.283966177248221,220.30080550905677,40.30122067421968,268472.01445980644,-138354.5436219319,80.0,24.0,96.0,275.19970699999885,7307.4498699999995,7364.899739999999,7417.499674999999,7474.949544999999,7254.849934999999,7197.400065,7144.80013,0.5661055464841565,-2728905.0,-1
2017-06-19,7314.0,7322.149901999999,7235.0,7263.899901999999,7051.905273,372747.0,7280.770019500001,7313.307235418182,149.19970699999885,54.99970835867434,-2.9396226294156005,203.15637051949216,26.990506179606875,52189.90300102969,-129693.43241179729,76.0,20.0,96.0,200.5,7273.683268,7312.3665359999995,7360.833169999998,7399.516437999999,7225.216634,7186.533366000001,7138.066732000001,0.3316114113358322,-3101652.0,-1
2017-06-20,7265.0,7283.649901999999,7190.299805,7249.25,7011.048828,757716.0,7293.125000000001,7307.576322781819,123.54980499999965,52.91519337923117,-3.1380796959497874,192.3394793023217,13.79799918173676,-869073.1706391175,-163301.60233122093,72.0,16.0,92.0,129.8500980000008,7241.066569,7291.833333,7334.416666,7385.183429999999,7198.483236,7147.716472,7105.1331390000005,0.6314958087295895,-3859368.0,-1
2017-06-21,7220.0,7284.5,7153.299805,7207.25,7070.339844,460423.0,7302.639990200001,7291.962686418182,95.1499019999992,47.02010034958764,-3.7070389145463545,191.18153030948542,2.321944835354194,-287351.402962475,-168940.22963264157,68.0,12.0,88.0,60.60009699999955,7215.016601666666,7276.733398333333,7346.216796666667,7407.933593333333,7145.5332033333325,7083.816406666666,7014.333008333332,0.41120514340699116,-4319791.0,-1
2017-06-22,7291.0,7352.0,7288.0,7268.200195,7116.936035,436033.0,7308.889990200001,7285.700905472726,62.5,55.34944532379489,-2.8813680735818634,199.0874679069966,24.656700795059816,278862.14713767567,-148585.57614308168,64.0,8.0,56.0,120.8500980000008,7302.733398333334,7317.4667966666675,7366.733398333334,7381.4667966666675,7253.4667966666675,7238.733398333334,7189.4667966666675,-0.30937195312499455,-3883758.0,+1
2017-06-23,7321.25,7331.649901999999,7205.0,7316.100098000001,7022.624512,355854.0,7315.550000000001,7287.011834163637,66.6000980000008,60.920710371242365,-2.2324849454453957,211.83471807065234,14.992229006725044,-510503.15338926134,-165036.37510881713,60.0,4.0,56.0,110.04980499999965,7284.25,7363.5,7410.899901999999,7490.149901999999,7236.850098000001,7157.600098000001,7110.200196000002,0.8772221395007593,-3527904.0,+1
2017-06-27,7239.5,7267.200195,7155.100098000001,7219.149901999999,6987.799316,365667.0,7290.9799804,7269.484543618182,-245.7001960000016,47.1741753462718,-3.5458351301821818,202.55536065567776,-12.169720540125477,-268503.0578409224,-169739.40614209464,56.00000000000001,0.0,56.0,87.1499019999992,7213.816731666666,7272.533365333331,7325.916828666666,7384.6334623333305,7160.433268333331,7101.716634666666,7048.333171333332,0.5713626099716814,-3893571.0,-1
2017-06-28,7213.950195,7324.0,7205.0,7183.350098000001,7028.364258,637214.0,7271.950000000001,7249.915474090909,-190.2998039999984,43.03659837821644,-4.030802475652405,183.68624802484374,-5.5490133028050135,116172.5971237994,-156743.4059936449,52.0,0.0,56.0,93.35009699999955,7237.4500326666675,7269.900065333335,7356.4500326666675,7388.900065333335,7150.900065333335,7118.4500326666675,7031.900065333335,-0.18193194957982523,-4530785.0,-1
2017-06-29,7254.899901999999,7290.0,7205.0,7225.049805,7027.683105,543979.0,7259.559961000001,7241.388165909091,-123.9003900000007,49.04338989511179,-3.4659112206422815,128.81839628337275,-6.226814780578217,-406597.03565365274,-168100.3891600089,48.0,0.0,56.0,131.20019500000035,7240.016601666666,7275.0332033333325,7325.016601666666,7360.0332033333325,7190.0332033333325,7155.016601666666,7105.0332033333325,0.2358800588235253,-3986806.0,+1
2017-06-30,7214.799805,7233.600098000001,7157.149901999999,7224.350098000001,7021.117187999999,367886.0,7246.889990300001,7234.986372636363,-126.69970699999885,48.943465280958634,-3.47538990511766,94.55612753665719,-23.72661100814065,339803.0,-145013.87147091757,44.0,0.0,56.0,144.75,7205.033366000001,7252.916830000002,7281.483562000003,7329.3670260000035,7176.466634,7128.583169999999,7100.016437999999,0.8790061964000745,-4354692.0,-1
2017-07-03,7238.899901999999,7365.0,7211.200195,7217.600098000001,7153.804198999999,556846.0,7237.4200196,7229.660937672728,-94.69970699999885,47.85808292448345,-3.22729611201739,60.86782487419896,1.6196884349988951,39131.43307141246,-136643.6303553571,40.0,0.0,56.0,126.6499019999992,7264.600097666666,7318.0000003333325,7418.399902666665,7471.799805333332,7164.200195333333,7110.800292666667,7010.400390333333,0.04161190581483809,-4911538.0,-1
2017-07-04,7386.0,7415.049805,7340.0,7354.0,7175.351073999999,428293.0,7246.4300294,7250.857297745456,90.1000980000008,65.62977042386862,-1.3730288200108753,35.63707635670289,65.51424271001686,-152077.44067799687,-137345.16718820436,36.0,0.0,56.00000000000001,161.0,7369.683268333333,7399.366536666666,7444.733073333333,7474.416341666666,7324.316731666667,7294.633463333334,7249.266926666667,0.18654278981804237,-4483245.0,+1
2017-07-05,7374.75,7394.0,7332.0,7376.149901999999,7176.810547,273869.0,7259.120019600001,7274.442729127273,126.8999019999992,67.69298395877723,-0.5317063721110145,20.052399923695702,66.08394569249981,-28495.215149084037,-132397.44209551706,32.0,0.0,52.0,119.0,7367.3833006666655,7402.766601333331,7429.383300666665,7464.766601333331,7340.766601333331,7305.3833006666655,7278.766601333331,0.7120951935483743,-4209376.0,+1
2017-07-06,7377.649901999999,7498.0,7376.200195,7377.649901999999,7270.585937999999,416512.0,7276.160009800001,7295.993616836364,170.3999019999992,67.84381599948269,-1.6265724827679524,15.078293474392012,113.75628534954018,-372745.44014438905,-143322.35109773852,28.000000000000004,16.0,48.0,106.6499019999992,7417.283365666667,7458.366536333334,7539.083170666666,7580.166341333334,7336.566731333334,7295.4835606666675,7214.766926333335,0.011902375377356776,-3792864.0,+1
2017-07-07,7470.0,7474.049805,7420.0,7474.049805,7230.458984000001,339803.0,7296.7449708,7331.973579599999,205.8496099999993,76.11340959301245,-0.32369502635491754,15.558627269958379,157.0948091798003,101430.62019983678,-132197.21603875782,96.0,12.0,44.0,76.4501960000016,7456.0332033333325,7492.066406666665,7510.083008333331,7546.116211666665,7438.016601666665,7401.983398333333,7383.966796666666,1.0,-3453061.0,+1
2017-07-10,7458.799805,7500.0,6700.0,7432.799805,7228.172852,47033.0,7308.414941499999,7356.710822181818,116.69970699999885,67.53785549464966,-0.90798804215647,25.65435444695322,-105.30369382287535,126345.01699893815,-120445.29635522618,92.0,8.0,40.0,153.79980499999965,7210.933268333333,7721.866536666666,8010.933268333334,8521.866536666666,6921.866536666666,6410.933268333333,6121.866536666666,0.9159997562499995,-3500094.0,-1
2017-07-11,7473.899901999999,7495.0,7400.0,7430.450195,7254.0,423681.0,7329.544970800001,7378.899050090909,211.30029300000115,67.0414187194651,-0.9397352384812816,24.215381477188203,152.3657191386928,-313316.30867268326,-129212.16055147424,96.0,96.0,36.0,197.44970699999885,7441.816731666667,7483.633463333334,7536.816731666666,7578.633463333334,7388.633463333334,7346.816731666667,7293.633463333334,0.3205283684210563,-3923775.0,-1
2017-07-12,7485.0,7485.0,7435.100098000001,7457.0,7273.115234000001,233096.0,7356.909960999999,7402.072691763637,273.6499019999992,69.92381014661002,-0.5810025672206459,15.045045297201796,152.33320053140312,-92793.30405599269,-127556.75798349781,92.0,92.0,32.0,62.0,7459.033366000001,7482.966634,7508.933267999999,7532.8665359999995,7433.066732000001,7409.133464000001,7383.166830000002,0.4388766535052424,-3690679.0,+1
2017-07-13,7490.0,7574.5,7465.149901999999,7476.649901999999,7361.540526999999,472029.0,7382.069970699999,7423.843590127271,251.60009699999955,72.01393955587025,-1.3089438565982314,20.861508639124622,166.53058121796818,162589.72811553915,-114368.28134263249,88.0,88.0,12.000000000000004,121.8500980000008,7505.433268,7545.716634,7614.7833660000015,7655.066732000001,7436.3665359999995,7396.083169999999,7327.016437999999,0.1051668010393545,-3218650.0,+1
2017-07-14,7574.950195,7588.950195,7520.0,7567.549805,7351.521484000001,267450.0,7416.3899414,7457.567196363636,343.19970699999885,79.58619502562124,-0.28572139257063106,34.63244105972626,184.4909032206589,-53842.442791752015,-111617.106863047,96.0,84.0,84.0,96.39990300000045,7558.833333333333,7597.666666666666,7627.783528333333,7666.616861666666,7528.716471666666,7489.883138333333,7459.766276666665,0.6896253882965727,-2951200.0,+1
2017-07-17,7571.950195,7578.0,7504.299805,7557.25,7317.522461,289180.0,7450.3549316,7483.178116109089,339.6499019999992,76.86702084005809,-0.4232363924283791,50.35012855977857,142.21941688343128,106193.10810810812,-101716.64254617631,96.0,80.0,84.0,800.0,7546.516601666666,7588.733398333333,7620.216796666667,7662.433593333333,7515.0332033333325,7472.816406666666,7441.333008333332,0.7184539335343698,-3240380.0,-1
2017-07-18,7525.0,7591.5,7515.0,7522.299805,7343.835937999999,387214.0,7467.1849121000005,7496.259002181818,168.29980499999965,67.79755284682585,-0.9235928595261976,70.20182651325376,115.65231352127985,173296.97744511295,-89216.02345566315,92.0,76.0,0.0,95.0,7542.933268333333,7570.866536666666,7619.433268333334,7647.366536666666,7494.366536666666,7466.433268333333,7417.866536666666,0.09542228758169478,-3627594.0,-1
2017-07-19,7564.25,7584.0,7535.0,7549.350098000001,7355.655273,223986.0,7484.5049317,7511.198126890909,173.2001960000016,70.86723715303773,-0.5625612545879106,107.71277829075916,102.34855689649181,-370731.57091383956,-102012.18470376209,96.0,72.0,0.0,54.54980499999965,7556.1166993333345,7577.233398666669,7605.116699333335,7626.233398666669,7528.233398666669,7507.1166993333345,7479.233398666669,0.29285914285715914,-3403608.0,+1
2017-07-20,7580.0,7584.5,7480.049805,7561.5,7287.026367,290547.0,7502.889941500001,7525.197230218182,183.8500980000008,72.23872798047216,-0.40040040040040037,123.62908595994122,77.77342055672382,-692538.5375806942,-128854.29165271357,92.0,68.0,0.0,117.5,7542.016601666666,7603.983398333333,7646.466796666667,7708.433593333333,7499.5332033333325,7437.566406666666,7395.083008333332,0.7797993579619461,-3113061.0,+1
2017-07-21,7500.0,7549.899901999999,7445.0,7490.950195,7337.65918,434483.0,7504.579980500001,7523.026367218183,16.900390000000698,54.91706750104501,-1.3420060727394014,134.6507122230969,47.013488478017784,-299286.78649728035,-136601.22323655753,88.0,64.0,12.0,112.30029300000115,7495.283365666666,7545.566731333332,7600.183267666665,7650.466633333332,7440.666829333333,7390.383463666667,7335.766927333334,0.4380384931150908,-3547544.0,-1
2017-07-24,7554.0,7569.0,7495.0,7543.0,7348.894043000001,357195.0,7515.600000000001,7530.011825309091,110.20019500000035,62.559509585507165,-0.647313980647314,148.1344326090957,57.345670209727025,-687568.8158360495,-161645.20471835264,84.0,60.0,16.0,73.70019500000035,7535.666666666667,7576.333333333334,7609.666666666668,7650.333333333334,7502.333333333334,7461.666666666667,7428.333333333334,0.6486486486486487,-3190349.0,+1
2017-07-25,7573.0,7573.0,7493.549805,7554.549805,7300.547852,323585.0,7528.009961000002,7537.093608036364,124.0996099999993,64.11695467598179,-0.49316242909576713,147.15218999979516,51.327461072615556,-815108.5354064655,-191348.08338599416,80.0,56.00000000000001,16.0,76.5,7540.3665366666655,7587.183268333331,7619.816731666665,7666.633463333332,7507.733073333331,7460.916341666665,7428.282878333331,0.7677765926188065,-2866764.0,+1
2017-07-26,7539.0,7595.0,7504.0,7504.850098000001,7359.303223000001,377790.0,7532.7949708,7532.882723854545,47.8500980000008,53.141299194466946,-1.202640101387396,148.0182216488247,41.50653607484356,225776.2555410349,-172387.88616203828,76.0,52.0,24.0,61.70019500000035,7534.6166993333345,7565.233398666669,7625.616699333335,7656.233398666669,7474.233398666669,7443.6166993333345,7383.233398666669,0.009341736263745038,-3244554.0,-1
2017-07-27,7615.0,7683.399901999999,7536.0,7565.25,7392.718262,1148259.0,7541.6549806,7538.7836382545465,88.6000980000008,62.2120161106554,-1.5578015865018298,150.42856377675253,60.69609554200651,124092.50847457627,-158911.5045876467,96.0,48.0,24.0,104.45019500000035,7594.8833006666655,7653.766601333331,7742.283202666666,7801.16650333333,7506.366699333332,7447.483398666666,7358.966797333333,0.19843975201557568,-2096295.0,+1
2017-07-28,7617.0,7673.600098000001,7584.0,7599.600098000001,7422.728515999999,459181.0,7544.8600099000005,7549.3191141454545,32.05029300000115,66.47104896265847,-1.1048969606402277,148.13297666724884,62.44366370947233,-351063.7651203008,-167645.6982482219,96.0,44.0,24.0,116.5,7619.066732,7654.1334640000005,7708.666830000002,7743.733562000001,7564.533366,7529.466633999999,7474.933267999999,0.1741080461764747,-1637114.0,+1
2017-07-31,7664.0,7765.0,7651.0,7630.450195,7539.072265999999,505371.0,7552.1800294,7564.880965981819,73.20019500000035,69.977592562505,-1.755150078267671,148.29197997586562,79.37195204587488,-331095.2763399023,-175075.22452511644,92.0,40.0,24.0,78.04980499999965,7682.150065000001,7713.300130000001,7796.150065000002,7827.300130000001,7599.300130000001,7568.150065000001,7485.300130000001,-0.18026144736841798,-1131743.0,+1
2017-08-01,7759.899901999999,7920.0,7725.0,7750.049805,7642.235352,1096934.0,7574.9550294,7600.857288818181,227.75,79.54628526584743,-2.172998273878025,142.25972743117927,117.76605771038244,119684.28302324047,-161677.0650911002,96.0,36.0,23.999999999999993,79.45019500000035,7798.349934999999,7871.699869999999,7993.349934999998,8066.699869999999,7676.699869999999,7603.349934999999,7481.699869999999,0.12846053846153668,-34809.0,+1
2017-08-02,7878.899901999999,7880.0,7775.0,7856.100098000001,7583.285156,414448.0,7605.630029400001,7651.9745740181825,306.75,84.57591940258739,-0.817029817158921,134.4662509891914,117.32208252617298,142086.88523635783,-147869.61280348845,96.0,32.0,24.0,91.0,7837.033366000001,7899.066732000001,7942.033366,8004.066732000001,7794.066732000001,7732.033366000001,7689.066732000001,0.7723818857142933,379639.0,+1
2017-08-03,7794.0,7829.0,7711.0,7795.5,7526.76709,287116.0,7629.030029400002,7686.496386854545,234.0,72.7764044223468,-1.5918680475642502,128.32267950875394,82.93723520135292,550552.9025760241,-116123.1348316924,92.0,28.000000000000004,48.0,178.5498039999984,7778.5,7846.0,7896.5,7964.0,7728.0,7660.5,7610.0,0.7161016949152542,92523.0,-1
2017-08-04,7750.0,7804.899901999999,7740.0,7737.399901999999,7558.770995999999,325021.0,7653.675000100001,7706.200000054545,246.44970699999885,63.04608695187533,-2.3347410561309396,120.15592797725458,70.71230182378685,1071759.323076194,-62128.47765406115,88.0,24.0,52.0,108.3500980000008,7760.766601333333,7781.533202666666,7825.666503333332,7846.433104666665,7716.633300666666,7695.866699333334,7651.733398666667,-0.04006320379344842,-232498.0,-1
2017-08-07,7779.5,7892.350098000001,7771.0,7770.299805,7625.260254000001,327318.0,7676.4049806,7727.404510036364,227.29980499999965,66.01494888915134,-1.9140799769850447,111.42264875925866,79.30362026166974,-615374.9242818827,-87276.04340987124,84.0,20.0,52.0,165.3999019999992,7811.216634333334,7851.433268666668,7932.566732333335,7972.783366666668,7730.083170666667,7689.866536333333,7608.733072666666,-0.00577004066367004,94820.0,+1
2017-08-08,7849.0,7885.0,7736.899901999999,7838.649901999999,7544.763184,319951.0,7704.814990300001,7756.903586654544,284.10009699999955,71.50303166911296,-1.0401495716660376,114.54327471588658,74.96289316016546,-319387.39644909557,-97826.55945710871,80.0,16.0,60.0,289.54980499999965,7820.183268,7903.466634,7968.2833660000015,8051.566732000001,7755.3665359999995,7672.083169999999,7607.266437999999,0.6870353320090271,414771.0,+1
2017-08-09,7759.0,7795.0,7639.100098000001,7755.899901999999,7453.030273,285089.0,7729.919970699999,7766.191752418182,251.0498039999984,58.34197827070862,-2.098198414525007,118.36601661811164,34.81558178133512,286898.4958145458,-80339.05694476077,76.0,12.0,64.0,129.95019500000035,7730.0,7820.899901999999,7885.899901999999,7976.799803999998,7665.0,7574.100098000001,7509.100098000001,0.7491974177122895,129682.0,-1
2017-08-10,7637.350098000001,7640.0,7538.899901999999,7661.600098000001,7372.435547,385730.0,7739.554980500001,7753.769957381818,96.3500980000008,46.973342469622665,-3.303924076205079,120.7401915828541,-12.41392123847636,34317.59068463984,-75127.39114342438,72.0,8.0,64.0,145.1000980000008,7613.5,7688.100098000001,7714.600098000001,7789.200196000002,7587.0,7512.399901999999,7485.899901999999,1.2136506138698364,-256048.0,-1
2017-08-11,7501.899901999999,7533.799805,7380.0,7578.75,7254.38916,676390.0,7737.4699707,7724.532688199999,-20.8500980000008,39.224828813615005,-4.3632527809743,129.14333962180444,-58.75192454035719,81827.00559393647,-67993.10038263524,68.0,4.0,64.0,64.8999019999992,7497.516601666666,7615.0332033333325,7651.316406666665,7768.833008333332,7461.233398333333,7343.716796666667,7307.433593333333,1.292264317240197,-932438.0,-1
2017-08-14,7516.0,7647.0,7515.0,7457.399901999999,7401.327148,328598.0,7720.1649414,7673.610857527272,-173.05029300000115,30.673628137055204,-5.914845902058571,133.29086352774084,-41.097817139721684,-116791.94822646846,-70211.2298300822,64.0,0.0,64.0,154.9501960000016,7539.7999673333325,7564.599934666665,7671.7999673333325,7696.599934666665,7432.599934666665,7407.7999673333325,7300.599934666665,-0.4363643787878848,-1261036.0,-1
2017-08-16,7649.100098000001,7720.100098000001,7585.049805,7608.450195,7491.503418000001,488766.0,7706.004980400001,7653.299085454545,-141.5996099999993,47.20439960554262,-3.983503452243954,134.4064945044929,-3.4065087902176114,-286465.03620228753,-80040.94830154609,60.0,92.0,64.0,148.1000980000008,7637.8666993333345,7690.683593666669,7772.916992333335,7825.7338866666705,7555.633300666668,7502.816406333333,7420.583007666667,0.17327167146538883,-772270.0,+1
2017-08-17,7701.0,7708.850098000001,7565.0,7701.149901999999,7376.034668000001,321296.0,7690.5099608,7652.4163439272725,-154.9501960000016,54.8311326641345,-2.7982367727912134,133.98443784524625,2.948405339499834,79358.4845711684,-72795.51953460451,56.00000000000001,88.0,64.0,199.5498039999984,7658.333333333333,7751.666666666666,7802.183431333335,7895.516764666667,7607.816568666665,7514.483235333332,7463.9664706666645,0.9464706934019499,-450974.0,+1
2017-08-18,7551.0,7624.0,7531.350098000001,7582.450195,7391.939941,332924.0,7669.204980299999,7632.769113781818,-213.04980499999965,45.18681079870683,-4.315941759365806,115.66606102798596,-33.21394452105679,41785.50887924046,-67587.29097033883,52.0,84.0,64.0,217.0,7579.266764333333,7627.183430666666,7671.916666333333,7719.833332666665,7534.533528666667,7486.616862333334,7441.883626666668,0.5515396767500088,-783898.0,-1
2017-08-21,7629.0,7658.049805,7490.0,7598.799805,7297.678223000001,277519.0,7655.344970599999,7619.968172818182,-138.60009699999955,46.677411628303496,-4.106894195115719,82.53490371258067,-34.942676125339304,399880.1272113075,-46338.77196208216,48.0,80.0,64.0,281.6000980000008,7582.2832033333325,7674.566406666665,7750.333008333331,7842.616211666665,7506.516601666665,7414.233398333333,7338.466796666666,0.647425952086049,-506379.0,+1
2017-08-22,7540.0,7567.5,7475.100098000001,7501.899901999999,7292.035645,278131.0,7628.5049803,7592.069069436364,-268.39990300000045,39.3580427966214,-5.345864953330786,58.607385441561746,-69.50006679426959,-568034.8647195805,-70052.23072378665,44.0,76.0,64.0,132.0,7514.833333333333,7554.566568666665,7607.233235333331,7646.9664706666645,7462.166666666666,7422.433431333334,7369.766764666667,0.2900414764509018,-784510.0,-1
2017-08-23,7548.0,7590.0,7501.0,7496.100098000001,7366.890625,258051.0,7594.249999900001,7567.995454472728,-342.5498039999984,38.93638476848375,-5.084462971857112,39.954678397230055,-67.06519476445926,-428375.42753311765,-86339.64876057443,40.0,72.0,-32.0,262.7001960000016,7529.033366000001,7557.066732000001,7618.033366,7646.066732000001,7468.066732000001,7440.033366000001,7379.066732000001,-0.05505507865167642,-1042561.0,-1
2017-08-24,7536.0,7635.0,7483.600098000001,7573.049805,7479.682617,436912.0,7575.964990200001,7564.140873581819,-182.85009699999955,47.540267997554324,-4.097086477379515,14.648402082235407,-54.56416452471546,-982681.1211210161,-127082.44295877634,36.0,68.0,-31.999999999999993,143.8500980000008,7563.883301000001,7644.166504000001,7715.283203000001,7795.566406,7492.7666020000015,7412.483399000002,7341.366700000002,0.5908174696176443,-605649.0,+1
2017-08-28,7649.0,7649.0,7568.049805,7612.850098000001,7446.424805,391028.0,7571.089990200001,7570.847256818182,-48.75,51.609386419072315,-3.586390916426657,-19.855431479909385,-30.46821269191893,-24791.128405536718,-122432.8377518109,32.0,64.0,-32.0,169.7998039999984,7609.966634333333,7651.883463666666,7690.916829333334,7732.833658666666,7570.933268666666,7529.0164393333325,7489.983073666665,0.553430328364261,-214621.0,+1
2017-08-29,7565.0,7575.549805,7495.049805,7579.0,7389.930664,368309.0,7571.114990200002,7572.285440418181,0.25,47.95878825657624,-4.020736834091612,-45.654558794942204,-72.9595014936499,-46335.80810787018,-118973.8818589045,28.000000000000004,60.0,-32.0,168.04980499999965,7549.8665366666655,7604.683268333331,7630.3665366666655,7685.183268333331,7524.183268333331,7469.3665366666655,7443.683268333331,1.0428595652173955,-582930.0,-1
2017-08-30,7603.0,7639.350098000001,7532.5,7521.5,7425.251953,471048.0,7577.525,7563.264533109092,64.1000980000008,42.119329384938744,-4.6686360133573075,-66.16939206852658,-63.41300456193791,-100600.74056865495,-118138.73907298407,24.0,56.00000000000001,-32.0,123.69970699999885,7564.4500326666675,7596.400065333335,7671.300130666668,7703.250163333336,7489.549967333334,7457.599934666667,7382.6998693333335,-0.1029479636041131,-1053978.0,-1
2017-08-31,7564.899901999999,7720.399901999999,7532.0,7557.450195,7565.602539,586954.0,7572.424999999999,7559.614568563637,-51.0,46.792964248103466,-3.0866658653846106,-72.20653312515151,-29.510581354720287,-491474.73964296817,-135108.55728071064,20.0,52.0,-32.0,89.0,7603.283365666666,7674.566731333332,7791.683267666665,7862.966633333332,7486.166829333333,7414.883463666667,7297.766927333334,0.13508603098955146,-467024.0,+1
2017-09-01,7747.5,7834.899901999999,7730.0,7700.299805,7675.643555,627407.0,7572.339990299999,7582.864533109092,-0.8500969999995505,61.168670753389456,-1.7399410373084165,-56.7871577415126,104.02744738485114,-129715.3508773762,-134863.41153510453,16.0,48.0,-32.0,151.3999019999992,7755.066569,7780.133137999999,7859.966471,7885.033039999998,7675.233236,7650.166667,7570.333334000001,-0.2831289108354036,160383.0,+1
2017-09-04,7840.0,7876.0,7756.75,7812.299805,7684.683105,362724.0,7595.324951299999,7626.493590327273,229.8496099999993,68.79578519019371,-0.8190844155844201,-61.426753837085016,142.63796754508368,-738097.4375,-162283.13998805435,12.0,44.0,-32.0,80.95019500000035,7815.016601666666,7873.2832033333325,7934.266601666666,7992.5332033333325,7754.0332033333325,7695.766601666666,7634.7832033333325,0.46582645702305786,523107.0,+1
2017-09-05,7843.0,7855.950195,7801.0,7821.5,7680.458495999999,182518.0,7617.594970800001,7667.616326454545,222.70019500000035,69.36609041196579,-0.7007843641507008,-75.05647507536196,144.72604001841324,-118274.2939422713,-160282.7378950642,8.0,40.0,-31.999999999999996,117.80029300000115,7826.150065000001,7851.300130000001,7881.100260000001,7906.250325000002,7796.349935000001,7771.19987,7741.399740000001,0.3730651001329453,705625.0,+1
2017-09-06,7800.0,7904.0,7770.0,7817.200195,7709.393066,340420.0,7649.125000100001,7703.9081854,315.30029300000115,68.68910149423971,-1.1121051249199188,-70.39769755053021,137.60970738657565,32956.89944677141,-151499.11801588984,4.0,36.0,-32.00000000000001,106.8500980000008,7830.400065000001,7890.800130000001,7964.400065000002,8024.800130000001,7756.800130000001,7696.400065000001,7622.800130000001,0.35224026119403246,365205.0,-1
2017-09-07,7888.0,7949.0,7858.5,7846.649901999999,7780.674316,389478.0,7684.179980500002,7739.821803927273,350.5498039999984,70.93113712224006,-1.303822904458609,-64.51477312894895,153.15437563416242,91347.5994863841,-140460.63085669556,0.0,32.0,-32.0,198.8999019999992,7884.716633999999,7910.933267999999,7975.216634,8001.433267999999,7820.433267999999,7794.216633999999,7729.933267999999,-0.13094030939227402,754683.0,+1
2017-09-08,7940.450195,7979.75,7892.0,7919.200195,7831.322265999999,341309.0,7718.795019500001,7782.552752018182,346.1503900000007,75.84722948161229,-0.7683254131903645,-34.39957611308273,151.655624491241,-116960.5244387676,-139392.4442013352,96.0,28.000000000000004,-32.0,277.44970699999885,7930.316731666667,7968.633463333334,8018.066731666666,8056.383463333334,7880.883463333334,7842.566731666667,7793.133463333334,0.3099737321937362,1095992.0,+1
2017-09-11,8000.0,8168.0,8000.0,7970.75,7999.969727,547463.0,7754.585009700001,7828.362748472727,357.8999019999992,78.7882868648187,-2.4445408352955758,7.493431964460797,181.8314446265471,-470777.2578269893,-154455.39027522856,96.0,24.0,-32.0,175.70019500000035,8046.25,8092.5,8214.25,8260.5,7924.5,7878.25,7756.5,-0.17410714285714285,1643455.0,+1
2017-09-12,8192.0,8192.0,8116.0,8142.399901999999,8011.85791,387447.0,7810.9249999,7898.874547072727,563.3999019999992,85.54906761212337,-0.6128765352774102,42.71013390743974,187.68443272777918,25571.693521689598,-146272.3410117323,96.0,20.0,-32.0,54.95019500000035,8150.1333006666655,8184.266601333331,8226.133300666665,8260.266601333331,8108.266601333331,8074.1333006666655,8032.266601333331,0.34736713157893684,2030902.0,+1
2017-09-13,8161.899901999999,8200.0,8100.149901999999,8154.5,7980.516113,371832.0,7874.2249999,7961.3427289090905,633.0,85.91423729084745,-0.5616590544377237,72.38201504520293,154.2243716423822,-33940.10625372062,-141166.33034091358,96.0,16.0,-32.0,134.0,8151.5499673333325,8202.950032666666,8251.400065333333,8302.800130666667,8103.099934666665,8051.699869333332,8003.249836666664,0.5443169219523486,2402734.0,+1
2017-09-14,8139.950195,8164.950195,8042.049805,8122.600098000001,7929.081543000001,293890.0,7930.7399902,8006.501837654546,565.1499030000004,79.78156498263937,-0.9554363905690557,111.3643242803073,116.48707621394588,-15361.28613507849,-135447.91924064836,96.0,12.0,-32.0,131.79980499999965,8109.8666993333345,8177.683593666669,8232.767089333334,8300.583983666671,8054.783203666669,7986.966309333334,7931.882813666668,0.6554112074013816,2108844.0,-1
2017-09-15,8076.950195,8119.100098000001,8043.5,8070.25,7958.065918000001,400099.0,7967.7350097,8031.867293981817,369.95019500000035,70.28197936362818,-1.6016541167757068,165.50587391234876,90.38874871454077,187997.31059769125,-120745.86333890565,92.0,8.0,68.0,133.1000980000008,8077.6166993333345,8111.733398666669,8153.216797333334,8187.33349666667,8036.133300666668,8002.016601333334,7960.533202666667,0.35383552016030084,1708745.0,-1
2017-09-18,8130.700195,8185.0,8130.700195,8099.75,8015.149414,219992.0,7996.4800292,8055.870019490909,287.45019500000035,72.41742875119809,-1.2375015430193803,215.14565564392979,92.9805741518998,514794.52468704066,-91857.6638831808,88.0,4.0,72.0,248.79980499999965,8138.483398333334,8146.266601666667,8192.783203333332,8200.566406666667,8091.9667966666675,8084.183593333334,8037.666991666668,-0.5699872218694072,1928737.0,+1
2017-09-19,8178.0,8184.950195,8124.450195,8157.850098000001,7989.457031,245577.0,8030.115039,8085.210032,336.3500980000008,76.2892664842418,-0.5203049253178521,244.86335454789514,84.04857797402322,320606.84511223156,-73109.27711066203,84.0,0.0,76.0,221.25,8155.750162666667,8187.050130333334,8216.250162666667,8247.550130333333,8126.550130333334,8095.250162666667,8066.050130333334,0.5520645123967016,2174314.0,+1
2017-09-20,8164.399901999999,8164.399901999999,8109.100098000001,8131.700195,7978.108887,185837.0,8061.565039,8103.680060363637,314.5,71.10570816161993,-0.8431033822984774,256.13601195182764,65.92507293228431,186401.0939222475,-61313.35115462068,80.0,20.0,80.0,99.8500980000008,8135.066731666667,8161.033365333333,8190.366535666666,8216.333169333331,8105.733561333334,8079.766927666668,8050.433757333336,0.40868313023315966,1988477.0,-1
2017-09-21,8101.0,8170.899901999999,8075.100098000001,8120.149901999999,8002.475098000001,258168.0,8088.915039000001,8114.331853636364,273.5,68.72582658065414,-0.9856819898778026,260.1676028461234,52.0798086151776,-260167.2784098493,-70352.16602985836,76.0,16.0,84.0,122.9003900000007,8122.0499673333325,8168.999836666664,8217.84977133333,8264.799640666663,8073.200032666666,8026.250163333334,7977.400228666667,0.4702494380886119,1730309.0,-1
2017-09-22,8145.0,8175.5,8050.0,8144.950195,7927.067870999999,366359.0,8111.490039000001,8124.520063818181,225.75,71.12053042493255,-0.6795433279841951,276.7784534738721,44.68660889611364,-810948.4990834501,-104015.63571411256,72.0,12.0,84.0,79.1000980000008,8123.483398333334,8196.966796666668,8248.983398333334,8322.466796666668,8071.4667966666675,7997.983398333334,7945.9667966666675,0.7565752589641462,2096668.0,+1
2017-09-25,8074.0,8089.0,7855.049805,8068.200195,7825.623535,626129.0,8121.235058500001,8116.649183090908,97.45019500000035,55.84987559982403,-1.6269572275027733,295.59221243115553,12.677513039344579,78031.10278157258,-95740.78396430869,68.0,8.0,84.0,114.75,8004.083333333333,8153.116861666666,8238.033528333333,8387.067056666667,7919.166666666666,7770.133138333333,7685.216471666666,0.9110930213159274,1470539.0,-1
2017-09-26,7980.0,7980.049805,7869.100098000001,7964.950195,7751.886719,440508.0,8103.490087800001,8088.233753363637,-177.44970699999885,41.88876873184976,-2.901491235649915,296.2421825848851,-7.104862957468483,35297.077375576104,-89784.51753976847,64.0,4.0,84.0,85.20019500000035,7938.033366000001,8006.966634,8048.983072999999,8117.916340999999,7896.0169270000015,7827.083659000002,7785.067220000003,0.8639058145507365,1030031.0,-1
2017-09-27,7949.0,7978.0,7715.0,7889.899901999999,7604.55957,564788.0,8077.030078000001,8049.399174127272,-264.6000980000008,34.62865390290885,-3.827923688433536,289.5687389256891,-30.03996639265258,-40042.615498879975,-87523.52199245535,60.0,0.0,60.0,55.2998039999984,7860.966633999999,8006.933267999999,8123.966634,8269.933267999999,7743.933267999999,7597.966633999999,7480.933267999999,0.665018638783267,465243.0,-1
2017-09-28,7735.100098000001,7920.0,7651.0,7739.950195,7759.206055,768225.0,8038.765087700001,7988.111922672726,-382.64990300000045,24.7424472569555,-5.678926120232066,248.47056626904123,-56.18486655188901,-607223.1349536662,-111146.23167251043,56.00000000000001,4.0,60.0,95.7998039999984,7770.316731666667,7889.633463333334,8039.316731666666,8158.633463333334,7620.633463333334,7501.316731666667,7351.633463333334,0.33066986988847713,-302982.0,-1
2017-09-29,7960.0,8007.799805,7925.0,7897.350098000001,7838.64209,486217.0,8021.475097500001,7962.400106363637,-172.8999019999992,44.078890717185956,-3.735957313911853,206.40818076092182,-14.792357929657477,-50163.603801746045,-108374.29404202112,52.0,0.0,60.0,125.5,7943.383300999999,7961.766601999998,8026.183105999999,8044.5664069999975,7878.966796999998,7860.583495999999,7796.166991999999,-0.3339368009381099,183235.0,+1
2017-10-03,8055.350098000001,8069.049805,7855.0,7978.200195,7750.313965,516298.0,8009.320117,7954.531942272727,-121.54980499999965,51.46927877464111,-2.7379311813356333,173.09234618558276,-11.555590786510635,-121290.98611933441,-108961.41640917174,48.0,4.0,60.0,289.9003900000007,7967.416666666667,8079.833333333334,8181.466471666667,8293.883138333335,7865.783528333334,7753.366861666667,7651.733723333335,0.5755678917810766,699533.0,+1
2017-10-04,7894.0,7933.899901999999,7830.600098000001,7888.299805,7709.933594,301347.0,7982.3650877,7932.528249181818,-269.55029300000115,44.007430495697186,-3.84767553388471,145.41536578504383,-40.83287048352917,576360.3976816812,-77810.4248595875,44.0,0.0,60.0,199.10009699999955,7884.266601666666,7937.933105333332,7987.566405666665,8041.23290933333,7834.633301333333,7780.966797666668,7731.333497333335,0.5585655031833336,398186.0,-1
2017-10-05,7836.0,7901.0,7807.200195,7847.200195,7694.065918000001,272177.0,7953.915087700001,7907.952814145455,-284.5,40.88103279581174,-4.177588486272565,108.59562097001799,-57.25353355796338,-440134.9420620072,-94279.72109606114,40.0,4.0,60.0,263.0,7851.8001300000005,7896.400065000001,7945.599934999999,7990.19987,7802.600260000001,7758.000325000001,7708.800455000001,0.42644011893201855,126009.0,-1
2017-10-06,7864.950195,7919.0,7845.049805,7831.049805,7764.954102,440453.0,7925.005078,7885.613671836364,-289.10009699999955,39.60528571985285,-4.37732123423201,56.9196797462173,-56.190429221392414,34678.796981797255,-88417.97027434029,36.0,0.0,52.00000000000001,269.0,7865.0332033333325,7885.016601666665,7938.983398333333,7958.966796666666,7811.066406666665,7791.083008333332,7737.116211666665,-0.18931660694065694,-314444.0,-1
2017-10-09,7909.0,7957.0,7866.700195,7903.200195,7758.567870999999,261839.0,7900.830078,7881.649147654546,-241.75,47.97413269828738,-3.485033452881519,9.446127446700302,-41.41930661271304,-2908.6026105190303,-84531.18083507568,32.0,76.0,52.0,267.8496099999993,7908.9667966666675,7951.233398333335,7999.266601666667,8041.533203333334,7860.933593333335,7818.666991666668,7770.633788333335,0.40420906778259535,-52605.0,+1
2017-10-10,7890.5,7934.899901999999,7885.299805,7896.700195,7755.620605,224485.0,7883.680078000001,7880.898259836365,-171.5,47.29291587000384,-3.5648253210641996,-30.78635863670752,-44.284780556508416,-210071.32006505044,-90237.55080007453,28.000000000000004,72.0,44.0,214.04980499999965,7905.633300666667,7925.966796333335,7955.233397666666,7975.5668933333345,7876.366699333335,7856.033203666668,7826.766602333336,0.22984612308320287,-277090.0,-1
2017-10-11,7892.0,7898.850098000001,7801.0,7893.700195,7688.269043000001,644166.0,7876.555078000001,7882.720099290908,-71.25,46.93797306905086,-3.489132730762083,-70.60167201908189,-63.15760337108181,221583.0707474967,-76063.88618427582,24.0,68.0,44.0,147.60009699999955,7864.516764333333,7928.033528666667,7962.366862333334,8025.883626666668,7830.183430666666,7766.666666333333,7732.333332666665,0.9473694650770773,-921256.0,-1
2017-10-12,7845.0,7918.0,7830.0,7825.149901999999,7765.985352,396436.0,7870.080078000001,7873.373703654545,-64.75,39.18425743801864,-4.337895103076838,-103.94397792289874,-64.0016644435369,76727.21128221168,-69118.83629943548,20.0,64.0,36.0,93.79980499999965,7857.716633999999,7885.433267999999,7945.716634,7973.433267999999,7797.433267999999,7769.716633999999,7709.433267999999,-0.05511475000000907,-1317692.0,-1
2017-10-13,7900.0,7940.0,7860.049805,7904.25,7736.411620999999,328108.0,7886.510058500001,7879.586416745455,164.29980499999965,50.14851544236746,-3.3585092552467035,-123.53436515473459,-36.507724185603244,-361049.0437450908,-82388.39118332892,16.0,60.0,36.0,73.95019500000035,7901.433268333333,7942.816731666667,7981.3834633333345,8022.766926666667,7862.866536666666,7821.483073333333,7782.916341666666,0.5528466190732888,-989584.0,+1
2017-10-16,7900.0,7935.0,7814.0,7874.149901999999,7704.824219,502632.0,7884.190038900001,7877.339115563637,-23.200196000001597,46.469983388933,-2.688987459324165,-132.67021617134105,-50.585875983087924,-534905.1822461254,-102957.33623163788,12.0,56.00000000000001,-44.0,125.95019500000035,7874.3833006666655,7934.766601333331,7995.383300666665,8055.766601333331,7813.766601333331,7753.3833006666655,7692.766601333331,0.49710662809916695,-1492216.0,-1
2017-10-17,7851.0,7902.299805,7830.899901999999,7842.0,7701.778809,304861.0,7870.570019400001,7869.6681994,-136.20019500000035,42.61731036849509,-2.848787781195047,-117.07312775110859,-51.01696819633726,-10008.590530213469,-98732.39324520949,8.0,52.0,-44.0,49.60009699999955,7858.399902333334,7885.899902666668,7929.799805333334,7957.299805666668,7814.4999996666675,7786.999999333333,7743.100096666667,0.1554637686272589,-1797077.0,-1
2017-10-18,7859.0,7873.049805,7748.200195,7838.899901999999,7647.888184,489207.0,7865.630029100001,7863.909996236363,-49.39990300000045,42.22778867459542,-2.8876846272104375,-119.28334562592045,-62.41080115576207,-659839.8477706338,-124237.2775418197,4.0,48.0,-44.0,97.8500980000008,7820.0499673333325,7891.899739666665,7944.899577333331,8016.749349666664,7767.050129666665,7695.200357333333,7642.200519666666,0.7264716886180049,-2286284.0,-1
2017-10-19,7803.0,7803.0,7690.0,7784.049805,7595.864745999999,115449.0,7859.3149901,7849.0772282181815,-63.1503900000007,35.58742247088949,-3.5758873152989032,-123.95801783131537,-89.16001007308617,-1127285.888393798,-169830.39621690963,0.0,44.0,-44.0,88.0,7759.016601666666,7828.0332033333325,7872.016601666666,7941.0332033333325,7715.0332033333325,7646.016601666666,7602.0332033333325,0.8322991592920324,-2401733.0,-1
2017-10-23,7748.799805,7860.0,7714.0,7731.100098000001,7681.73584,471496.0,7849.3200194,7825.765429654545,-99.94970699999885,30.28311900812436,-4.2402458612992175,-117.54261725855577,-76.35863664336003,-1340162.6672804982,-223027.31762889097,8.0,40.0,-44.0,114.8500980000008,7768.3666993333345,7822.733398666669,7914.366699333335,7968.733398666669,7676.733398666669,7622.3666993333345,7530.733398666669,0.11712395890411506,-2873229.0,-1
2017-10-24,7865.299805,7932.200195,7841.600098000001,7818.5,7737.24707,354257.0,7840.849999900001,7820.161789763637,-84.70019500000035,45.69807654541103,-3.143641647544255,-105.26373186850105,-5.77153332394502,-17196.490564178366,-213671.37094413128,4.0,36.0,-44.00000000000001,121.0,7864.100097666666,7886.600097333332,7954.700194666666,7977.200194333332,7796.0000003333325,7773.500000666667,7705.399903333333,-0.2549676961162736,-2518972.0,+1
2017-10-25,7930.0,7945.0,7810.299805,7875.0,7732.53125,254379.0,7838.679980400002,7826.370880690909,-21.70019500000035,53.38595613807357,-1.0435225248154747,-92.0481969218763,6.177220012171416,39602.77770174934,-202158.9096420458,0.0,32.0,-44.0,71.39990300000045,7876.766601666666,7943.233398333333,8011.466796666667,8077.933593333333,7808.5332033333325,7742.066406666666,7673.833008333332,0.4803274041288521,-2264593.0,+1
2017-10-26,7900.0,8086.0,7866.200195,7870.200195,7926.919922,684763.0,7836.3299804,7832.1018288000005,-23.5,52.65522786897841,-2.7018881307124034,-86.65836516170566,50.749944742268255,6284.952096574309,-192684.18865392669,0.0,28.000000000000004,-44.0,124.8496099999993,7940.8001300000005,8015.400065000001,8160.599934999999,8235.19987,7795.600260000001,7721.000325000001,7575.800455000001,0.01819837829246485,-2949356.0,-1
2017-10-27,8123.950195,8240.0,8062.600098000001,8068.049805,7972.508789,1201080.0,7860.6199707000005,7874.232705999999,242.89990300000045,71.32377119312696,-2.112150780002461,-71.65509161318005,179.14519870854235,143390.0955976036,-177408.08482431163,8.0,24.0,-44.0,148.8999019999992,8123.549967666667,8184.499837333333,8300.949869666665,8361.899739333332,8007.099935333334,7946.150065666668,7829.700033333334,0.030719898593849715,-1748276.0,+1
2017-10-30,8200.0,8279.0,8163.299805,8114.450195,8051.895508,726605.0,7881.6399902,7920.383655872728,210.20019500000035,74.08857338546,-2.0116113080684555,-55.838933189173986,194.64195557879043,-300629.035142093,-183009.0371114835,96.0,20.0,-32.0,146.0,8185.583333333333,8207.866861666665,8301.283528333333,8323.567056666667,8092.166666666666,8069.883138333333,7976.466471666666,-0.42220853646788714,-1021671.0,+1
2017-10-31,8195.0,8226.5,8167.200195,8195.25,8067.615234000001,318652.0,7913.75,7977.403657654546,321.1000980000008,78.29358109865959,-1.023838630806846,-27.80679629422866,170.4387275447166,157491.3495321711,-167531.7468094992,96.0,16.0,-32.0,201.10009699999955,8196.316731666668,8225.433268333334,8255.616536666665,8284.733073333335,8166.133463333335,8137.016926666668,8106.833658333336,0.4730168168343862,-703019.0,+1
2017-11-01,8251.0,8256.450195,8160.0,8211.25,8094.291015999999,631375.0,7950.674999999999,8031.494566745454,369.25,79.06966595369433,-0.8282396088019559,-6.816381843250383,152.68045548371643,-122639.10397567683,-165491.17213523455,92.0,12.0,-32.0,134.70019500000035,8209.233398333332,8258.466796666664,8305.683593333331,8354.916991666663,8162.016601666664,8112.7832033333325,8065.566406666665,0.5313623264317952,-71644.0,+1
2017-11-02,8250.0,8273.950195,8201.0,8238.400391,8081.910645,247753.0,7990.6250488999995,8083.808274200001,399.500489,80.4390197068478,-0.4963277383863176,15.909377101889731,145.2094071319845,147319.86046336184,-151272.48883529834,88.0,8.0,-28.000000000000004,219.79980499999965,8237.783528666665,8274.56705733333,8310.733723666664,8347.51725233333,8201.61686233333,8164.833333666666,8128.666667333331,0.5126839071506184,176109.0,+1
2017-11-03,8235.0,8242.900391,8175.0,8225.799805,8075.623047,288916.0,8034.800048900001,8126.567320763636,441.7500000000009,77.71623192201766,-0.650369132029333,38.408588598906135,114.08235205412761,180742.9236331338,-136180.87917764232,84.0,4.0,-16.0,369.79980499999965,8214.566732,8254.133463999999,8282.467122999999,8322.033854999998,8186.233072999999,8146.666341,8118.332682,0.748151877358131,-112807.0,-1
2017-11-06,8209.5,8370.549805,8199.349609,8219.400391,8164.834961,392588.0,8083.6300782,8160.131019327273,488.3002929999984,76.20466986678147,-1.8273409163133407,58.76948824362353,116.28512964891708,88626.6278143637,-125962.35613255114,80.0,0.0,76.0,210.95019500000035,8263.099935,8326.850261,8434.300131,8498.050457,8155.650065,8091.899739,7984.449869,0.1171189196535643,-505395.0,-1
2017-11-07,8348.0,8348.0,8210.0,8310.200195,8076.506836,348296.0,8132.800097700001,8201.32558601818,491.70019499999944,81.95169682177976,-0.7296046257682072,82.24456460175406,109.48904800224791,-236192.41043467316,-130972.81314628395,96.0,52.0,80.0,112.04980499999965,8289.400065,8368.80013,8427.400065000002,8506.80013,8230.80013,8151.400065,8092.80013,0.7260883695652133,-157099.0,+1
2017-11-08,8218.0,8285.049805,8204.900391,8220.299805,8088.001953,199176.0,8167.3300782000015,8217.23462370909,345.29980500000056,64.22972206009831,-1.8164673312995907,124.23338480565417,76.78339097021113,-62491.37288182589,-127860.02040699041,92.0,48.0,80.0,96.45019499999944,8236.750000333333,8268.599609666668,8316.899414333337,8348.749023666669,8188.450195666666,8156.600586333332,8108.300781666665,0.19213383144636698,-356275.0,-1
2017-11-09,8273.700195,8273.700195,8148.700195,8232.0,8061.277831999999,442672.0,8203.5100587,8228.99279130909,361.79980499999965,65.35478509098003,-1.6750162698198314,163.57178634922184,61.40773769908109,-334035.10574547667,-137231.61519510343,88.0,44.0,80.0,72.95019499999944,8218.133463333334,8287.566731666666,8343.133463333332,8412.566731666666,8162.566731666668,8093.1334633333345,8037.566731666669,0.666398440000002,86397.0,+1
2017-11-10,8198.799805,8234.900391,8111.049805,8204.799805,8040.350586,351694.0,8217.1850587,8229.227290636365,136.7500000000009,60.26989253236817,-2.0038566400193485,192.40910470030667,43.778107756595816,-734456.5785824995,-164378.20443998507,84.0,40.0,80.0,67.90039099999922,8183.5833336666665,8256.116862333332,8307.433919666666,8379.967448333333,8132.266276333334,8059.732747666667,8008.415690333334,0.7569604878575321,-265297.0,-1
2017-11-13,8185.0,8219.049805,8080.0,8183.5,7967.350586,181361.0,8224.0900392,8223.102734509092,69.04980499999965,56.31120922162715,-2.2613634616203653,222.04832188758883,31.819413871024206,-384441.1720498325,-174381.06660406906,80.0,36.0,80.0,171.20019599999978,8160.849935000001,8241.699870000002,8299.89974,8380.749675000003,8102.650065000002,8021.8001300000005,7963.600260000001,0.7443376134184408,-446658.0,-1
2017-11-14,8129.0,8186.0,8109.0,8109.200195,7980.860352,237427.0,8215.4850587,8202.213671927273,-86.04980499999965,44.537010564385554,-3.159620822714736,223.86651270678885,18.390523435096274,4479.915729126502,-166251.02195256017,76.0,32.0,44.0,138.0,8134.733398333334,8160.4667966666675,8211.733398333334,8237.466796666668,8083.4667966666675,8057.733398333334,8006.4667966666675,0.002599935064939597,-684085.0,-1
2017-11-15,8100.0,8180.0,8087.0,8122.950195,7985.084961,275441.0,8206.655078200001,8185.389151254545,-88.29980499999965,46.90747172333018,-2.9933883714310805,224.75956630374822,12.34425571734025,-565223.757313328,-184386.14628714055,72.0,28.000000000000004,44.0,105.29980400000022,8129.983398333334,8172.9667966666675,8222.983398333334,8265.966796666668,8079.9667966666675,8036.983398333334,7986.9667966666675,0.38656123655914354,-408644.0,+1
2017-11-16,8130.0,8234.849609,8129.25,8127.25,8020.897461,321844.0,8195.540039100002,8170.951864309092,-111.15039099999922,47.71379767436475,-2.9414053077807774,214.29643647112698,17.760517469190578,244900.35801133176,-164873.1233644827,68.0,24.0,44.0,124.99999999999909,8163.783203,8198.316406,8269.382812,8303.916015,8092.716796999999,8058.183593999999,7987.117187999998,-0.018939464065629116,-86800.0,+1
2017-11-17,8218.0,8362.450195,8218.0,8163.700195,8202.317383,419255.0,8189.330078100002,8165.162801745455,-62.09961000000021,54.476386199009085,-2.5007358339904258,201.7793886343634,39.24268055091794,-343432.0,-172989.43593882438,64.0,20.0,44.0,123.85058599999957,8248.05013,8278.10026,8392.500325,8422.550454999999,8133.650065,8103.599935,7989.19987,-0.3759067614965827,332455.0,+1
2017-11-20,8377.0,8449.0,8350.0,8348.349609,8278.265625,372037.0,8202.224999900001,8194.075443727274,128.94921800000157,74.07539213713204,-1.2053939041916075,185.1793233147946,79.24622615428687,14572.380655501058,-164463.8988209005,60.0,16.0,44.0,139.04980500000056,8382.449869666667,8414.899739333334,8481.449869666667,8513.899739333334,8315.899739333334,8283.449869666667,8216.899739333334,-0.016670616161608257,704492.0,+1
2017-11-21,8446.0,8449.450195,8401.0,8425.650391,8277.429688,255180.0,8213.770019500002,8234.698242109092,115.45019599999978,78.53853287627555,-0.2850122262180647,176.83342923661257,86.72784903499256,-292874.9735391419,-170300.76585354784,96.0,12.0,44.0,77.0,8425.366861999999,8449.733723999998,8473.817057,8498.183918999997,8401.283528999998,8376.916667,8352.833333999999,0.5087779522868691,959672.0,+1
2017-11-22,8448.0,8525.0,8444.0,8424.799805,8364.234375,383442.0,8234.2200195,8273.067294018183,204.5,78.36723768374087,-1.189178673154515,167.5919316215286,92.16513051154759,-75636.84422093834,-165997.86032479285,96.0,8.0,44.0,93.0,8464.599935,8485.19987,8545.599934999998,8566.19987,8404.19987,8383.599935,8323.19987,-0.23703944444443753,576230.0,-1
2017-11-23,8512.0,8519.0,8443.5,8513.150391,8315.355469,289808.0,8262.3350586,8323.781907018181,281.1503909999992,82.85016295090068,-0.1406314858770565,145.75379480682568,93.96853522503736,528426.2768120288,-134433.12681857368,96.0,4.0,44.0,111.89941400000043,8491.883463666667,8540.266927333334,8567.383463666665,8615.766927333334,8464.766927333334,8416.383463666667,8389.266927333334,0.9225217350993273,866038.0,+1
2017-11-24,8463.400391,8540.0,8463.400391,8463.400391,8339.474609,343432.0,8288.1951172,8360.339240181816,258.60058599999866,73.01875930503924,-0.9074707854519699,134.54280280062812,86.11529167361273,-384372.8785548756,-145794.02462476923,92.0,0.0,44.0,235.20019499999944,8488.933594,8514.466797000001,8565.533203000003,8591.066406000002,8437.867188,8412.333985,8361.267579,0.0,522606.0,-1
2017-11-27,8486.0,8524.200195,8445.0,8487.950195,8359.763672,172254.0,8318.6401367,8396.658345236363,304.45019499999944,74.72638387845822,-0.6166307901907423,119.06610683761846,81.04599340734136,104625.20454944449,-134411.3323895777,96.0,0.0,44.0,285.29980499999965,8485.716796666666,8526.433593333331,8564.916991666665,8605.63378833333,8447.233398333332,8406.516601666666,8368.033203333332,0.5422991067130547,694860.0,+1
2017-11-28,8490.599609,8658.0,8476.049805,8508.599609,8473.293945,456041.0,8358.580078100002,8431.19643110909,399.39941400000043,76.18895357382154,-1.7455355882696484,104.78298138325863,102.26107184728109,-81427.01861773175,-132002.95449085743,92.0,4.0,84.0,101.10058599999866,8547.549804666667,8619.049804333334,8729.499999666668,8800.999999333333,8437.099609333334,8365.599609666668,8255.149414333335,0.17889403196297934,1150901.0,+1
2017-11-29,8649.0,8696.0,8576.0,8624.150391,8519.666016,382984.0,8408.7000977,8479.481942545453,501.20019599999887,82.6658266376927,-0.835752111201591,102.54273033791287,126.68828244725462,-196272.5942288984,-134924.30175167747,96.0,0.0,88.0,99.34960900000078,8632.050130333333,8688.100260666666,8752.050130333333,8808.100260666666,8568.100260666666,8512.050130333333,8448.100260666666,0.4012532583333268,1533885.0,+1
2017-11-30,8650.0,8676.0,8575.0,8671.349609,8448.680664,582023.0,8463.110058600001,8527.236399145455,544.0996090000008,84.63558420081212,-0.2867324764452625,117.28664720204506,115.58254810796718,-844453.6250551121,-167175.63462910632,96.0,0.0,92.0,94.20019499999944,8640.783203,8706.566406000002,8741.783202999999,8807.566406000002,8605.566406000002,8539.783203,8504.566406000002,0.953956524752483,2115908.0,+1
2017-12-01,8660.0,8695.0,8593.0,8599.099609,8458.407227,436589.0,8506.650000000001,8551.961771945455,435.39941400000043,70.48817643660091,-1.1271419216005492,130.993725051796,96.42132841508129,-1158609.6980240617,-212240.81932887706,92.0,0.0,92.0,76.59960900000078,8629.033203,8665.066406000002,8731.033202999999,8767.066406000002,8563.066406000002,8527.033203,8461.066406000002,0.059800088235301786,1679319.0,-1
2017-12-04,8659.75,8659.950195,8480.549805,8609.0,8352.100586,242191.0,8532.715039100001,8570.570862854545,260.6503909999992,71.24807087527034,-1.0119809235779924,159.83108309097042,69.5843249974535,-1257643.5177993528,-259759.12380480778,88.0,40.0,96.0,79.20019499999944,8583.166666666666,8685.783528333332,8762.567056666665,8865.18391833333,8506.383138333333,8403.766276666667,8326.982748333334,0.7159973007862482,1921510.0,+1
2017-12-05,8519.950195,8554.950195,8476.5,8500.799805,8351.708008,213998.0,8540.229980500002,8564.768093018181,75.14941400000134,53.784351005648574,-2.2705617657322255,187.42367156295222,39.3171907297103,-211113.34076218944,-257547.95184832514,84.0,36.0,88.0,181.95019499999944,8510.75,8545.0,8589.200194999998,8623.450195,8466.549805,8432.299805,8388.099610000001,0.3097481784462197,1707512.0,-1
2017-12-06,8494.0,8638.75,8450.049805,8500.400391,8461.749023,420876.0,8547.790039100002,8557.526349472728,75.60058599999866,53.728257891412056,-2.275207735256494,197.12497013247594,39.57142222525262,51757.919601214846,-243488.5940551642,80.0,32.0,96.0,187.40039099999922,8529.733398666667,8609.416992333334,8718.433593666667,8798.117187333333,8420.716797333334,8341.033203666668,8232.016602333335,0.2668284789000817,1286636.0,-1
2017-12-07,8615.900391,8988.25,8614.549805,8612.400391,8727.025391,834850.0,8557.715039100001,8569.27368618182,99.25,65.40274697757636,-4.228136333211472,201.18621411886488,94.16889871112362,315393.61021448835,-218084.85749745267,76.0,28.000000000000004,96.0,101.0,8738.400065333333,8862.250325666666,9112.100260333335,9235.950520666665,8488.550130666667,8364.699870333334,8114.849935666667,-0.005751706926461053,2121486.0,+1
2017-12-08,8929.799805,9119.0,8899.0,8882.400391,8884.079102,1006694.0,8599.615039100001,8628.307386527273,419.0,79.6702450925037,-2.6230555321507847,215.16097736142547,142.67009491658814,-1102247.3877185471,-258274.06341659336,96.0,24.0,92.0,102.0,8966.800130333333,9034.600260666666,9186.800130333333,9254.600260666666,8814.600260666666,8746.800130333333,8594.600260666666,-0.07545276818182174,3128180.0,+1
2017-12-11,9108.0,9167.0,9089.75,9042.25,8974.027344,564023.0,8655.045019600002,8708.786470327272,554.2998050000006,84.1385661569552,-1.375716806352007,222.11890889105234,154.0420620999689,-4373.644117302139,-246733.13526662556,96.0,20.0,48.0,179.40038999999888,9099.666666666666,9109.583333333332,9176.916666666664,9186.833333333332,9032.333333333332,9022.416666666666,8955.083333333332,-0.6148867313915858,3692203.0,+1
2017-12-12,9150.0,9218.5,9100.0,9133.799805,8971.620117,491488.0,8717.5650392,8795.832794945454,625.2001959999998,86.15020221971398,-0.928781128351329,240.087675953313,140.2455473733468,-1356814.736548,-297191.38987032446,96.0,16.0,48.0,132.5,9150.766601666668,9201.533203333336,9269.26660166667,9320.033203333336,9083.033203333336,9032.266601666668,8964.533203333336,0.285230421940933,4183691.0,+1
2017-12-13,9091.0,9176.0,9075.0,9131.349609,8961.108398,446829.0,8768.284961000001,8871.066353090908,507.19921800000157,85.81411113943099,-0.9556487855693758,263.35922171354287,112.82697306179604,-384619.10241232585,-301165.3768040518,96.0,12.0,48.0,188.70019499999944,9127.449869666667,9179.899739333334,9228.449869666667,9280.899739333334,9078.899739333334,9026.449869666667,8977.899739333334,0.557916920792087,3736862.0,-1
2017-12-14,9127.0,9146.799805,9046.0,9120.650391,8953.345703,655484.0,8813.2150392,8935.132794909092,449.30078199999843,84.15984743312427,-1.0729712045616622,281.122437180391,91.60453753637856,165339.24546003976,-279960.6212465931,92.0,8.0,48.0,487.8496090000008,9104.483398666667,9162.966797333334,9205.283203666666,9263.766602333335,9062.166992333334,9003.683593666667,8961.367187333333,0.7405807084646523,3081378.0,-1
2017-12-15,9170.0,9236.299805,9147.299805,9112.75,9005.566406,620495.0,8864.5800783,8989.593696872727,513.6503909999992,82.79990560800357,-1.3521478734055892,286.0823342239728,90.33227066565499,-621307.6476312124,-295476.3951731667,88.0,4.0,72.0,506.5996090000008,9165.44987,9183.599935,9254.449869999999,9272.599935,9094.599935,9076.44987,9005.599935,-0.3882000561797816,2460883.0,-1
2017-12-18,9110.0,9344.0,8990.150391,9165.900391,9146.261719,658668.0,8920.2701174,9044.379208272727,556.9003909999992,84.71694623617944,-1.9264424986479263,285.9499241727299,78.6221301014746,68552.03738697954,-278929.64823861455,96.0,0.0,76.0,284.5996090000008,9166.683594,9343.216797000001,9520.533203000003,9697.066406000002,8989.367188,8812.833985,8635.517579,0.4966799327450991,3119551.0,+1
2017-12-19,9345.0,9858.0,9326.0,9309.099609,9630.047852,1275759.0,9001.1000978,9115.075479472727,808.2998040000002,88.64965400787574,-5.62455570242852,300.2776757624342,126.31914961890149,-72226.92030730992,-269534.06969628256,96.0,4.0,80.0,176.25,9497.699869666667,9669.399739333334,10029.699869666667,10201.399739333334,9137.399739333334,8965.699869666667,8605.399739333334,-0.03176765225563763,4395310.0,+1
2017-12-20,9966.0,9996.400391,9700.25,9801.5,9563.630859,1216280.0,9131.2100587,9260.602734418182,1301.0996090000008,94.38367589945759,-1.9692079061207624,324.66153697996015,162.52233926275503,-179230.97769657386,-265429.38369629584,96.0,0.0,84.0,101.0,9832.716797,9965.183593999998,10128.867187999997,10261.333984999997,9669.033202999999,9536.566406,9372.882812,0.341887105595617,5611590.0,+1
2017-12-21,9788.0,9817.400391,9610.049805,9733.900391,9462.580078,849633.0,9243.3600587,9370.182794836363,1121.5,87.39029544278193,-2.6522115871830247,369.014429071789,118.96609617614092,-636398.2226381557,-282291.6036481986,96.0,0.0,84.0,100.79980500000056,9720.450195666666,9830.850586333332,9927.800781666667,10038.20117233333,9623.500000333333,9513.099609666668,9416.149414333335,0.5973003905568873,4761957.0,-1
2017-12-22,9665.0,9824.799805,9605.0,9631.049805,9530.323242,814330.0,9318.225000100001,9440.671839618182,748.6494140000013,77.33127005667384,-3.6913792669459227,418.27517810152494,96.74955920007572,107926.89708056136,-264554.3990696186,92.0,0.0,84.0,115.64941400000134,9686.949870000002,9768.899740000004,9906.749675000003,9988.699545000005,9549.099935000004,9467.150065000002,9329.300130000003,0.11851605145873761,3947627.0,-1
2017-12-26,9741.0,9765.0,9616.200195,9700.0,9509.69043,542587.0,9384.000000099999,9510.085475963637,657.75,79.18460529046521,-2.994729719831532,463.25333609123663,83.22745115924384,140312.23941815828,-246151.37004744692,88.0,0.0,96.0,353.8496090000008,9693.733398333332,9771.266601666664,9842.53320333333,9920.066406666665,9622.466796666664,9544.933593333331,9473.666991666663,0.5631714705540121,4490214.0,+1
2017-12-27,9694.0,9750.700195,9629.099609,9679.0,9475.401367,402886.0,9438.520019599999,9563.721839581818,545.2001949999994,76.97305301836252,-3.2069066468061735,488.0108023121247,69.84751566648077,363060.8131143405,-218459.90717645656,84.0,0.0,92.0,692.0996090000008,9686.266601333335,9743.433593666668,9807.867187333333,9865.034179666667,9621.83300766667,9564.666015333336,9500.232421666671,0.41036307999370797,4087328.0,-1
2017-12-28,9693.5,9693.5,9615.799805,9644.099609,9460.761719,659995.0,9489.7950196,9601.099946745455,512.75,73.06017708686237,-3.5595284426439493,498.7402621291003,56.16774166412082,-102523.07917104458,-213190.05135802875,80.0,4.0,96.0,687.3007819999984,9651.133138000001,9686.466471000002,9728.833333,9764.166666000001,9608.766276000002,9573.432943000002,9531.066081000003,0.36421792763841104,3427333.0,-1
2017-12-29,9659.0,9769.0,9650.0,9629.200195,9559.356445,471554.0,9540.65,9626.446342272728,508.5498040000002,71.27540060718793,-3.7100671034174373,499.27451234668297,52.65448431020894,-1055071.9214829328,-251457.40909097897,76.0,0.0,96.0,207.35058599999866,9682.733398333332,9715.466796666664,9801.73339833333,9834.466796666664,9596.466796666664,9563.733398333332,9477.466796666664,-0.17478827731092908,2955779.0,-1
2018-01-01,9749.0,9789.0,9629.799805,9729.549805,9483.06543,426354.0,9602.3299805,9660.791761363636,616.7998050000006,75.85852214262681,-2.696168442802959,510.8018656457243,50.47902914994126,-220073.47196167914,-250030.8664941926,72.0,4.0,92.0,219.79980500000056,9716.116536666668,9802.433268333336,9875.316731666668,9961.633463333335,9643.233073333337,9556.916341666669,9484.032878333337,0.6265695842897702,3382133.0,+1
2018-01-02,9699.0,9718.599609,9525.0,9651.900391,9386.925781,451227.0,9650.929980500001,9669.804563272726,486.0,66.39956937854971,-3.4807119687030554,522.1535988294872,35.73852805682166,148976.77140344513,-231894.1556806636,68.0,0.0,88.0,148.79980500000056,9631.833333333334,9738.666666666668,9825.432942333333,9932.266275666669,9545.067057666667,9438.233724333333,9351.467448666666,0.6554785500625608,2930906.0,-1
2018-01-03,9597.0,9598.0,9402.0,9554.049805,9251.879883,658281.0,9675.4250001,9652.189985909092,244.95019599999978,56.20861776159699,-4.46936133251961,537.2520637198613,17.626446182052373,-10372.630396088598,-221824.99544045562,64.0,24.0,84.0,121.60058599999866,9518.016601666668,9634.033203333336,9714.01660166667,9830.033203333336,9438.033203333336,9322.016601666668,9242.033203333336,0.7757643112244926,2272625.0,-1
2018-01-04,9450.0,9488.0,9367.200195,9416.599609,9222.061523,562919.0,9636.934961,9605.13082389091,-384.9003909999992,45.0115710970792,-5.858111818202571,546.3353725647285,1.341457819815469,-15259.339950686755,-212435.6474636479,60.0,20.0,76.0,77.70019499999944,9423.933267999999,9480.666340999998,9544.733073000001,9601.466145999999,9359.866535999998,9303.133462999998,9239.066730999997,0.4089362064781571,1709706.0,-1
2018-01-05,9458.0,9532.0,9412.549805,9386.25,9268.828125,732512.0,9602.1699219,9559.551740072728,-347.6503909999992,42.83746855023646,-6.1647540454645755,544.5437169528159,-0.6183188640992417,-835266.2225260753,-240746.12814830372,56.00000000000001,16.0,76.0,124.90039099999922,9443.599935,9474.650065,9563.050129999998,9594.10026,9355.19987,9324.14974,9235.749675000001,-0.22017381386443685,977194.0,-1
2018-01-08,9488.0,9495.0,9425.0,9433.849609,9283.665039,294549.0,9582.4499023,9528.948046818181,-197.20019599999978,47.43233342367414,-5.683823628187687,478.15703198457595,-2.971799967822548,159515.765066433,-222552.40572945203,52.0,12.0,68.0,159.79980500000056,9451.283203,9477.566406000002,9521.283202999999,9547.566406000002,9407.566406000002,9381.283203,9337.566406000002,0.1264229857142969,1271743.0,+1
2018-01-09,9464.799805,9491.450195,9361.0,9448.950195,9219.40918,427590.0,9557.3449218,9504.675372763637,-251.04980500000056,48.934866646843396,-5.531252393283114,412.87590309417646,-8.24086567317535,27701.06584507274,-211177.24793060997,48.0,8.0,68.0,204.54980500000056,9433.800129999998,9506.600259999996,9564.250324999997,9637.050454999995,9376.150064999996,9303.349934999998,9245.699869999997,0.6742051631275815,1699333.0,+1
2018-01-10,9387.799805,9454.849609,9315.900391,9383.549805,9211.84375,394826.0,9527.799902300001,9473.076260618182,-295.45019499999944,42.81877399109268,-6.192035906289918,357.30755717986904,-19.229202003022113,66807.0406691322,-198541.5984488035,44.0,4.0,40.0,249.90039099999922,9384.766601666668,9453.632812333337,9523.715819666668,9592.582030333338,9314.683594333335,9245.817383666667,9175.734376333334,0.4868643017479996,1304507.0,-1
2018-01-11,9410.0,9430.0,9326.0,9375.849609,9176.423828,368996.0,9500.974902299999,9445.448934563636,-268.25,42.1038711494639,-4.616074821622341,281.77007825002147,-26.518066616619635,-820024.8307363904,-226790.83628005747,40.0,0.0,40.0,186.84961000000112,9377.283203,9428.566406000002,9481.283202999999,9532.566406000002,9324.566406000002,9273.283203,9220.566406000002,0.47932316346154596,935511.0,-1
2018-01-12,9387.0,9494.75,9355.099609,9339.799805,9293.6875,685141.0,9472.034863300001,9416.144371418182,-289.4003899999989,38.62064735081097,-4.986736409592383,203.7788079018901,-29.652546559965888,282589.01852815255,-203637.20651604794,36.0,0.0,40.00000000000001,119.45019499999944,9396.549804666667,9438.000000333333,9536.200195666668,9577.650391333333,9298.349609333334,9256.899413666668,9158.699218333335,-0.10955790306380386,250370.0,-1
2018-01-15,9499.950195,9508.549805,9340.0,9459.150391,9194.748047,385462.0,9444.994921900001,9413.801740090908,-270.39941400000134,53.360233069891585,-3.4040207327141463,136.2678863732781,-27.59261908575211,104282.90482925929,-189640.83781853394,32.0,0.0,40.0,108.75,9435.900065333333,9531.800130666667,9604.449870333334,9700.349935666667,9363.250325666666,9267.350260333333,9194.700520666665,0.7069150332152495,635832.0,+1
2018-01-16,9371.0,9408.650391,9300.0,9358.450195,9158.984375,364816.0,9415.649902300001,9398.0663352,-293.4501959999998,43.24921532253195,-4.443238441692472,81.53068408113177,-60.01551721070745,-399780.72233105573,-199192.6507509213,28.000000000000004,20.0,40.0,130.45019499999944,9355.700195333333,9411.400390666666,9464.350586333334,9520.050781666665,9302.749999666667,9247.049804333334,9194.099608666667,0.5379658044672831,271016.0,-1
2018-01-17,9316.0,9368.799805,9256.0,9322.049805,9150.977539,390461.0,9392.449902300003,9381.04813569091,-232.0,40.08150944142855,-4.818887461300304,18.03309655569865,-79.56048876267133,-233095.08385689277,-200733.6704375564,24.0,16.0,40.0,138.94921800000157,9315.616536666668,9375.233073333337,9428.41634166667,9488.032878333337,9262.433268333336,9202.816731666668,9149.633463333335,0.5855489289188065,-119445.0,-1
2018-01-18,9350.0,9518.900391,9332.0,9313.900391,9204.819336,686971.0,9382.179980500003,9366.766406363637,-102.69921800000157,39.3372255906948,-4.9029887409700805,-33.65541763487636,-51.34566352560545,404829.7559036562,-173208.06014931947,20.0,12.0,40.0,104.0,9388.266927333332,9444.533854666664,9575.167318333333,9631.434245666664,9257.633463666665,9201.366536333333,9070.733072666666,-0.09684093705293992,-806416.0,-1
2018-01-19,9325.0,9396.0,9282.0,9368.700195,9160.851563,542339.0,9380.425000000003,9364.315536272728,-17.54980500000056,46.97667434276471,-4.337459287925703,-74.10035968033844,-69.33826904633086,-3781584.9929511533,-337225.19345849386,16.0,8.0,36.0,139.65039099999922,9348.900065,9415.80013,9462.900065000002,9529.80013,9301.80013,9234.900065,9187.80013,0.7605280263157845,-264077.0,+1
2018-01-22,9349.0,9356.75,9271.599609,9323.950195,9147.244141,454188.0,9369.4350586,9354.04738990909,-109.89941400000134,41.99372887700311,-4.102555512089831,-99.53787721692606,-88.08096171260314,164194.3669746562,-314433.395256987,12.0,4.0,32.0,168.75,9317.433268,9363.266927,9402.583659,9448.417318,9278.116536000001,9232.282877000001,9192.966145000002,0.6148014751922765,-718265.0,-1
2018-01-23,9347.0,9429.299805,9290.0,9310.099609,9229.086914,561948.0,9355.550000000003,9343.259126345454,-138.85058599999866,40.461006277628314,-3.030849468365083,-122.8905347756172,-71.0669403800525,363954.4883152699,-283597.58236733894,8.0,0.0,8.000000000000004,159.15039099999922,9343.133138000001,9396.266276000002,9482.432943,9535.566081000003,9256.966471000002,9203.833333,9117.666666000001,0.14429028813070272,-1280213.0,-1
2018-01-24,9419.0,9519.950195,9340.450195,9393.400391,9269.910156,568489.0,9356.5350586,9350.141015618181,9.850585999998657,52.49361825988166,-1.4693057245839158,-148.7161815178515,-20.016601248917937,314559.31188033,-256408.63262880853,4.0,80.0,8.0,112.79980500000056,9417.933593666667,9495.416992333334,9597.433593666667,9674.916992333334,9315.916992333334,9238.433593666667,9136.416992333334,0.2949871643454027,-711724.0,+1
2018-01-25,9485.0,9485.0,9250.0,9434.950195,9115.902344,705224.0,9362.4451172,9364.398313145453,59.10058599999866,57.443472528223005,-1.0288328739531492,-168.0250542931335,-28.43234940943397,1185487.8727069297,-190867.88238627496,0.0,76.0,8.0,196.85058599999866,9389.983398333332,9529.966796666664,9624.98339833333,9764.966796666664,9294.966796666664,9154.983398333332,9059.966796666664,0.7870221063829763,-6500.0,+1
2018-01-29,9481.0,9714.0,9461.0,9278.200195,9462.236328,1546624.0,9356.2851562,9349.081054563636,-61.59961000000112,39.51938338647924,-4.5324992719708845,-152.139278845254,31.664646008523178,261026.45664240053,-170327.23061224422,4.0,96.0,8.0,114.0,9484.400065,9507.80013,9737.400065000002,9760.80013,9254.80013,9231.400065,9001.80013,-0.7225288735177888,-1553124.0,-1
2018-01-30,9620.0,9675.5,9550.0,9630.700195,9404.120117,573988.0,9373.440136599998,9398.974697981816,171.54980400000022,66.57878272153394,-0.86635262610505,-130.0271861315996,108.55486578722832,717978.0451383858,-129949.71807812466,0.0,92.0,8.0,97.10058599999866,9618.733398333332,9687.466796666664,9744.23339833333,9812.966796666664,9561.966796666664,9493.233398333332,9436.466796666664,0.6430294422310713,-979136.0,+1
2018-01-31,9558.049805,9585.0,9458.900391,9571.549805,9343.352539,462650.0,9394.7500976,9434.99463769091,213.09961000000112,61.27111054146693,-1.4815412896515803,-109.28141291352586,61.34793448135761,-126589.46256592324,-129796.9791912064,16.0,88.0,8.0,139.29980500000056,9538.483398666665,9618.066406333332,9664.583007666664,9744.166015333332,9491.96679733333,9412.383789666665,9365.86718833333,0.8933367430187721,-1441786.0,-1
2018-02-01,9545.0,9563.700195,9312.0,9509.700195,9237.388672,550971.0,9413.5151366,9455.8946554,187.65038999999888,55.894996936280855,-2.1248029641185706,-101.2716012511737,23.319598422861315,-422006.39873358264,-143079.2255340417,12.0,84.0,-76.0,209.85058599999866,9461.800129999998,9611.600259999996,9713.500324999997,9863.300454999995,9359.900064999996,9210.099934999998,9108.199869999997,0.7854590458302978,-1992757.0,-1
2018-02-02,9359.0,9359.0,8940.0,9401.849609,8833.332031,984189.0,9422.3100584,9453.773650381818,87.94921800000157,47.50789496144097,-3.2464939261570382,-82.86696034988199,-93.60836308761931,641342.4686709603,-107423.69397926885,8.0,80.0,-76.0,235.0,9233.616536333333,9527.233072666666,9652.616536333335,9946.233072666666,9108.233072666666,8814.616536333333,8689.233072666666,1.1022663699284028,-2976946.0,-1
2018-02-05,8850.150391,9120.0,8688.0,8990.599609,8921.757813,651062.0,9384.4999998,9375.2808414,-378.10058599999866,28.61590304744884,-7.523665013000512,-71.09341532043254,-236.59708501872245,-511300.4677104493,-125781.72914886798,4.0,96.0,-92.0,279.04980500000056,8932.866536333333,9177.733072666666,9364.866536333335,9609.733072666666,8745.733072666666,8500.866536333333,8313.733072666666,0.7004620578703722,-3628008.0,-1
2018-02-06,8700.0,9113.5,8661.599609,9080.599609,8827.436523,840339.0,9360.1649412,9320.02622489091,-243.35058599999866,35.12981119928298,-6.587627571502852,-56.83231907107438,-178.7474481719109,192321.1174907671,-111322.50884706638,0.0,96.0,-92.0,397.29980500000056,8951.899739333334,9242.199869666667,9403.800130333333,9694.100260666666,8790.299478666668,8499.999348333335,8338.399087666668,0.9271954801207524,-2787669.0,+1
2018-02-07,9170.0,9170.0,8873.0,8984.599609,8765.736328,509440.0,9327.6149412,9251.741619036364,-325.5,31.5827643033888,-7.5860675091003555,-46.28555673802475,-131.0625374218082,-247401.88663754615,-117507.93511027002,0.0,96.0,-72.0,171.79980400000022,9009.199869666667,9145.399739333334,9306.199869666667,9442.399739333334,8848.399739333334,8712.199869666667,8551.399739333334,0.37575625925926187,-3297109.0,-1
2018-02-08,8988.900391,9060.0,8915.0,8921.799805,8872.731445,465683.0,9280.4548826,9177.957048818182,-471.60058599999866,29.34621645825348,-8.239211596463852,-36.422866844541204,-134.39871600746667,393443.81107025914,-94282.85573842775,68.0,92.0,-72.0,259.54980500000056,8965.599935,9016.19987,9110.599934999998,9161.19987,8871.19987,8820.599935,8726.19987,0.04689520689655559,-3762792.0,-1
2018-02-09,8906.0,8986.549805,8870.0,9030.700195,8779.785156,364892.0,9240.0298826,9132.547105618181,-404.25,38.114878914195906,-7.106602236089449,-28.452003919828712,-117.12182723385095,291428.59466693504,-76750.51708363852,64.0,88.0,-72.0,569.7001949999994,8962.416666666666,9054.833333333332,9078.966471666667,9171.383138333333,8938.283528333332,8845.866861666665,8821.733723333331,1.3788113588006317,-3397900.0,+1
2018-02-12,8960.0,9150.0,8960.0,8936.099609,8958.356445,408523.0,9205.819824,9077.287055872728,-342.10058599999866,33.898058962027676,-8.090487685907428,-43.822694932459854,-85.82515834989427,133853.54775960793,-67177.60504530913,60.0,84.0,-92.0,713.8496090000008,9015.366536333333,9070.733072666666,9205.366536333335,9260.733072666666,8880.733072666666,8825.366536333333,8690.733072666666,-0.12579153157894324,-3806423.0,-1
2018-02-14,9149.900391,9157.5,8986.0,9117.849609,8844.139648,357737.0,9154.5347654,9061.292471327275,-512.8505859999987,46.91697141040914,-6.200212074882987,-64.56076747800762,-54.45665157316632,-314682.682515569,-78427.83583941185,56.00000000000001,80.0,-96.0,451.9003909999992,9087.116536333333,9188.233072666666,9258.616536333335,9359.733072666666,9016.733072666666,8915.616536333333,8845.233072666666,0.7688023848396547,-3448686.0,+1
2018-02-15,9049.0,9090.0,9001.0,9001.599609,8862.464844,250781.0,9097.5397458,9033.486079254546,-569.9501959999998,40.9628569208777,-7.409260436817465,-65.24079519611587,-66.199344200145,743743.9701492537,-41056.3901126543,52.0,76.0,-96.0,297.0,9030.866536333333,9060.733072666666,9119.866536333335,9149.733072666666,8971.733072666666,8941.866536333333,8882.733072666666,0.006737179775289691,-3699467.0,-1
2018-02-16,9039.900391,9070.0,8806.849609,9020.25,8682.371094,632659.0,9048.594726300002,9019.4333982,-489.45019499999944,42.3179550524353,-7.215288611544461,-115.82274299794153,-76.67673913422573,-852277.1527569814,-77930.06114194193,48.0,72.0,-24.0,145.0,8965.699869666667,9124.550130333333,9228.850260666666,9387.700521333332,8861.399739333334,8702.549478666668,8598.249348333335,0.8109446092367761,-3066808.0,+1
2018-02-19,8856.0,8865.849609,8691.650391,8836.950195,8572.230469,436138.0,8992.104784900002,8980.952574327272,-564.8994140000013,33.577792289149315,-9.121682839313578,-172.42024870723617,-110.4271452052944,-1161588.3893038016,-127187.25787657197,44.0,68.0,-24.0,116.54980500000056,8798.150065,8904.649739,8972.349283,9078.848957000002,8730.450520999999,8623.950846999998,8556.251302999997,0.8341013562988493,-3502946.0,-1
2018-02-20,8745.0,8768.950195,8650.0,8724.849609,8570.070313,517802.0,8965.529784900002,8932.360724163636,-265.75,29.30655753591759,-9.926908484310545,-229.7691229174361,-113.37335041622597,65394.09469027241,-118433.56003262449,40.0,64.0,-24.0,190.0,8714.599934666667,8779.199869333333,8833.550129666666,8898.150064333333,8660.249674333334,8595.649739666667,8541.299479333335,0.6292516712562021,-4020748.0,-1
2018-02-21,8771.0,8795.0,8708.200195,8722.650391,8629.118164,471756.0,8929.734863100002,8888.200834363637,-357.94921800000157,29.222413045700975,-9.09076121652963,-280.44355603381337,-92.78877712125505,320751.94597993355,-98470.5824865991,36.0,96.0,-23.999999999999993,221.40039099999922,8741.950195333333,8775.700195666666,8828.750000333332,8862.500000666667,8688.900390666666,8655.150390333332,8602.100585666665,0.16647728644090484,-4492504.0,-1
2018-02-22,8769.0,8769.0,8601.5,8782.75,8483.019531,638857.0,8909.5499022,8861.4763138,-201.84960900000078,35.098235347406245,-8.25118787611,-268.8299858567716,-85.2231450873469,-222338.82259381172,-104100.95703692696,32.0,92.0,-24.0,116.84960900000078,8717.75,8834.0,8885.25,9001.5,8666.5,8550.25,8499.0,1.0820895522388059,-3853647.0,+1
2018-02-23,8665.0,8738.950195,8655.049805,8634.049805,8546.636719,567960.0,8880.7749022,8811.385387036364,-287.75,28.37351985919392,-7.828835799136064,-280.49038895772355,-79.82491365055543,442611.23250216915,-79250.40296696803,28.000000000000004,96.0,-24.0,263.1503909999992,8676.016601666668,8696.983398333336,8759.916991666667,8780.883788333334,8613.083008333337,8592.11621166667,8529.182618333338,-0.25029681030088513,-4421607.0,-1
2018-02-26,8758.0,9055.0,8750.049805,8698.799805,8847.824219,869374.0,8847.584863200002,8778.299005727273,-331.9003899999989,34.66312172074778,-5.194578271414391,-281.299896366314,-39.68076575964432,200685.41065806616,-66526.04780219373,24.0,92.0,-24.0,328.5996090000008,8834.616536666668,8919.183268333336,9139.566731666668,9224.133463333335,8614.233073333337,8529.666341666669,8309.282878333337,-0.16806023029432754,-3552233.0,+1
2018-02-27,9093.0,9114.950195,8872.599609,9005.349609,8735.671875,684609.0,8854.5098632,8806.983504963637,69.25,55.84414774059606,-1.815129434461462,-266.79957582884344,-3.1181268160158737,-121517.46163585341,-69025.65752190554,20.0,88.0,-24.0,186.95019499999944,8997.633137666668,9122.666666333334,9239.983723666668,9365.017252333333,8880.316080333336,8755.282551666669,8637.965494333337,0.5477601774810676,-2867624.0,+1
2018-02-28,8870.0,8934.0,8772.0,8891.200195,8696.125,680125.0,8831.8449218,8813.65447438182,-226.64941400000134,49.016771086315046,-3.0735288832543333,-266.6726979503783,-24.731147124016324,-291902.05060799327,-79156.40266218226,16.0,84.0,-60.0,86.79980500000056,8865.733398333332,8959.466796666664,9027.73339833333,9121.466796666664,8797.466796666664,8703.733398333332,8635.466796666664,0.7358036728395028,-3547749.0,-1
2018-03-01,8874.0,8936.049805,8811.349609,8850.950195,8718.231445,609369.0,8816.7799804,8817.128160418182,-150.64941400000134,46.69414791083312,-3.384112215046647,-257.8521336092599,-17.984191937610536,90511.79082339119,-71444.21204920164,12.0,80.0,-60.0,167.5,8866.116536333333,8920.883463666665,8990.816732333333,9045.583659666665,8796.183267666665,8741.416340333333,8671.483071666666,0.31756634929426036,-4157118.0,-1
2018-03-05,8867.0,8867.0,8775.0,8873.450195,8641.251953,388180.0,8802.099999900001,8827.4318358,-146.79980500000056,48.27502775499429,-3.135726720759514,-275.4792283427014,-18.42876363203358,-561687.4888379974,-93727.99735778329,8.0,76.0,-68.0,127.70019499999944,8838.483398333332,8901.966796666664,8930.48339833333,8993.966796666664,8809.966796666664,8746.483398333332,8717.966796666664,1.0701108152173853,-3768938.0,+1
2018-03-06,8855.549805,8885.0,8600.0,8795.099609,8465.776367,543686.0,8797.914941300001,8826.159037454545,-41.85058599999866,43.13504284680254,-4.000666677706014,-275.80147531291004,-34.97978803512761,271276.08434541774,-77136.9027349105,4.0,72.0,-68.0,420.95019499999944,8760.033203,8920.066406000002,9045.033202999999,9205.066406000002,8635.066406000002,8475.033203,8350.066406000002,0.6845600315789501,-4312624.0,-1
2018-03-07,8621.799805,8713.849609,8552.0,8616.5,8527.28125,598715.0,8787.079980400002,8793.174502672728,-108.34960900000078,33.698107416032556,-5.972291218192857,-282.14700308163447,-70.15113327556512,-240371.58759647748,-84556.661137709,0.0,96.0,-68.0,416.1503899999989,8627.449869666667,8702.899739333334,8789.299478666668,8864.749348333335,8541.050130333333,8465.600260666666,8379.200521333332,0.39851810825196177,-4911339.0,-1
2018-03-08,8700.200195,8775.0,8651.0,8679.099609,8576.652344,533856.0,8782.724902200001,8773.541707872726,-43.550781999998435,39.087572707026474,-4.834216877570037,-272.8485142618556,-44.186699409656406,70472.06664305851,-77509.90078403775,0.0,96.0,-68.0,233.34960900000078,8701.699869666667,8752.399739333334,8825.699869666667,8876.399739333334,8628.399739333334,8577.699869666667,8504.399739333334,0.2266097500000063,-4377483.0,+1
2018-03-09,8760.0,8774.0,8650.0,8729.349609,8509.105469,323450.0,8777.384863100002,8763.837109109092,-53.40039099999922,43.35251116319009,-4.27687129653669,-224.25244222928632,-36.13988947183838,444504.24267426104,-53781.98517229687,0.0,92.0,-68.0,124.70019599999978,8717.783203,8785.566406000002,8841.783202999999,8909.566406000002,8661.566406000002,8593.783203,8537.566406000002,0.6399162016129095,-4054033.0,+1
2018-03-12,8719.0,8826.799805,8681.099609,8660.599609,8656.186523,438339.0,8780.0398435,8742.603426545455,26.549804000000222,39.037576231112176,-5.039408783025101,-178.6236452145913,-32.533255267037376,-891983.0074667053,-91882.03164022455,0.0,88.0,-68.0,92.0,8722.833007666666,8764.566406333332,8868.533203666666,8910.266602333331,8618.866210333332,8577.132811666666,8473.166014333332,-0.14069987936049194,-4492372.0,-1
2018-03-13,8810.0,8848.0,8691.0,8810.299805,8602.884766,521943.0,8791.1898435,8748.105237727274,111.5,51.23270145440729,-3.3790158930663754,-139.67891831080124,-13.120750819621497,-123972.43438914027,-93340.68631062981,0.0,84.0,-68.0,285.0,8783.099935,8875.19987,8940.099934999998,9032.19987,8718.19987,8626.099935,8561.19987,0.7598713694267551,-3970429.0,+1
2018-03-14,8735.0,8874.0,8725.049805,8756.049805,8691.556641,411769.0,8766.2598631,8741.716139818183,-249.29980400000022,47.278044438703645,-3.980727291495413,-86.00617956781025,-10.16818879229162,-710893.3907815781,-121411.26378658203,8.0,80.0,-96.0,243.09960900000078,8785.033203333334,8845.016601666668,8933.983398333332,8993.966796666668,8696.066406666669,8636.083008333335,8547.11621166667,0.20812325891886288,-4382198.0,-1
2018-03-15,8839.900391,8875.0,8800.950195,8846.299805,8682.958984,313431.0,8761.769824100002,8756.268856527273,-44.90038999999888,54.08170578281995,-2.9797235365051713,-61.99232130036398,18.619825652797363,322151.06596605555,-101249.33970691665,4.0,76.0,-96.0,158.5,8840.75,8880.549805,8914.799805,8954.599610000001,8806.5,8766.700195,8732.450195,0.6124203838214128,-4068767.0,+1
2018-03-16,8869.0,8869.0,8649.400391,8837.549805,8524.776367,622932.0,8760.429785100001,8770.047034872729,-13.400389999998879,53.31206961374486,-3.076773762058242,-74.5847076437567,-0.9260537901091755,1378688.2375750244,-33979.44983046473,0.0,72.0,-92.0,124.0,8785.316732,8921.233073,9004.916341,9140.832682,8701.633463999999,8565.717122999999,8482.033854999998,0.856783920776474,-4691699.0,-1
2018-03-19,8711.5,8800.0,8703.549805,8676.549805,8620.030273,571830.0,8740.739746100002,8754.7961294,-196.90038999999888,40.94204969653035,-4.86249791223474,-82.98675428331444,-33.52414050019653,-437415.71502590674,-52317.461884803015,12.0,68.0,-88.0,145.70019599999978,8726.699870000002,8749.849935000004,8823.150065000003,8846.300130000003,8653.399740000004,8630.249675000003,8556.949545000005,-0.2799372256323604,-5263529.0,-1
2018-03-20,8764.450195,8845.5,8735.0,8773.5,8648.425781,408924.0,8738.579785200001,8760.7525392,-21.599609000000783,49.1414086787735,-3.787179250273126,-88.52855390758668,8.021075132355564,-436532.0538371873,-69781.76151900232,8.0,64.0,-84.0,187.40039099999922,8784.666666666666,8834.333333333332,8895.166666666664,8944.833333333332,8723.833333333332,8674.166666666666,8613.333333333332,0.34841628959276016,-4854605.0,+1
2018-03-21,8839.900391,8945.0,8825.049805,8802.400391,8719.411133,516020.0,8757.169824300001,8772.356285709091,185.90039099999922,51.45938881287845,-1.6120236151933167,-90.54356803327755,59.637245609446104,-761268.6097121154,-101212.98189141658,4.0,60.0,-72.0,148.95019499999944,8857.483398666667,8889.916992333334,8977.433593666667,9009.867187333333,8769.966797333334,8737.533203666668,8650.016602333335,-0.18882348628113066,-4338585.0,+1
2018-03-22,8870.0,8910.5,8684.400391,8874.650391,8544.425781,471749.0,8776.724902500002,8793.716388745455,195.55078199999843,57.099524225551534,-0.7952702803527106,-86.32158535441886,30.359218946124432,-1308520.190141129,-156090.58226640357,0.0,56.00000000000001,-72.0,118.95019499999944,8823.183594,8961.966797000001,9049.283203000003,9188.066406000002,8735.867188,8597.083985,8509.767579,0.8414432950213521,-3866836.0,+1
2018-03-23,8612.549805,8640.5,8542.099609,8696.549805,8456.688477,644482.0,8773.444922100001,8779.139098290909,-32.79980400000022,42.916128224717916,-2.8086162672394237,-49.54116681957021,-129.22717038503774,4530.715109615421,-148789.61420385723,32.0,52.0,-72.0,219.59960900000078,8626.383138,8710.666666999998,8724.783528999997,8809.067057999997,8612.266275999998,8527.982747,8513.865885,1.5696095760432598,-4511318.0,-1
2018-03-26,8607.0,8798.0,8605.0,8607.25,8611.972656,447858.0,8768.109961200002,8748.921839727273,-53.34960900000078,37.523677311727866,-3.8181098801718294,-29.038437093291577,-86.08148373680186,-223021.4642654967,-152163.78920665904,28.000000000000004,96.0,-56.0,134.0,8670.083333333334,8735.166666666668,8863.083333333336,8928.166666666668,8542.166666666668,8477.083333333334,8349.166666666668,0.011658031088082901,-4959176.0,-1
2018-03-27,8815.0,8887.0,8767.150391,8765.299805,8697.451172,423455.0,8763.609961200002,8748.410902236363,-45.0,50.281464523841564,-2.0314288378928267,-9.445902080755332,21.390243146135056,-397640.8599370171,-163321.8378762208,24.0,92.0,-56.0,168.95019499999944,8806.483398666665,8845.816406333332,8926.333007666664,8965.666015333332,8725.96679733333,8686.633789666665,8606.11718833333,-0.015440901438390548,-4535721.0,+1
2018-03-28,8812.0,9084.0,8801.0,8852.299805,8706.097656,1194227.0,8773.234961200002,8764.536328381819,96.25,55.98953174827513,-2.5787445186421754,11.711201622576482,132.52426035189302,-16842.767353309915,-156663.69830699757,20.0,88.0,-56.0,171.5,8912.433268333334,9023.866536666668,9195.433268333334,9306.866536666668,8740.866536666668,8629.433268333334,8457.866536666668,0.1812713957597193,-3341494.0,+1
2018-04-02,8990.0,9088.0,8953.25,8861.099609,8850.625,552649.0,8774.714941600001,8780.51171889091,14.799804000000222,56.571431166035445,-2.524200589609514,6.451062231068136,184.4743565889834,-277727.0603063276,-162166.5783978762,16.0,84.0,-56.00000000000001,226.09960900000078,8967.449869666667,8981.649739333334,9102.199869666667,9116.399739333334,8846.899739333334,8832.699869666667,8712.149739333334,-0.6838618998144654,-2788845.0,+1
2018-04-03,9008.950195,9060.0,8955.0,9008.200195,8868.555664,339709.0,8791.7799806,8822.963583145454,170.65038999999888,65.39622751225181,-0.8877495271999172,12.386555906816284,204.0833552823782,120705.99339678293,-149308.7342253917,12.0,80.0,-20.0,332.55078199999843,9007.733398333332,9060.466796666664,9112.73339833333,9165.466796666664,8955.466796666664,8902.733398333332,8850.466796666664,0.5066685238095184,-2449136.0,+1
2018-04-04,9078.0,9149.400391,8980.599609,9026.450195,8855.832031,488280.0,8826.7700196,8865.630894854545,349.9003899999989,66.37435654660379,-1.3585055985176666,10.676117899129167,211.93594905560062,-26190.35247106269,-143712.44414564947,8.0,76.0,-68.0,193.0,9052.150065,9123.700520999999,9220.950846999996,9292.501302999997,8954.899739,8883.349283000001,8786.098957000002,0.27162543595324745,-1960856.0,+1
2018-04-05,9050.0,9157.650391,9050.0,9013.5,8972.848633,236956.0,8850.7700196,8899.581800381819,240.0,64.87295205941919,-1.591300964028994,0.6286500053774944,182.01985152042525,369850.24150764575,-120368.6857068633,96.0,72.0,-68.0,279.75,9073.716797,9097.433593999998,9181.367187999997,9205.083984999997,8989.783202999999,8966.066406,8882.132812,-0.33906054275269903,-2197812.0,-1
2018-04-06,9165.0,9230.0,9042.549805,9132.599609,9045.162109,429514.0,8883.7899414,8950.823543909091,330.19921800000157,71.67259505034407,-1.0667001533238332,20.659725010258626,176.3123677588549,81219.46144547178,-111205.58810902988,96.0,68.0,-68.0,318.70019499999944,9135.049804666667,9227.549804333334,9322.499999666668,9414.999999333333,9040.099609333334,8947.599609666668,8852.649414333335,0.48039322658480293,-1768298.0,+1
2018-04-09,9220.0,9308.150391,9184.700195,9206.200195,9130.099609,426170.0,8916.9449218,9009.443590018182,331.5498040000002,75.10831389193672,-1.1070532206709816,50.707934920921616,188.25107431124036,-93514.07770983502,-110401.42854543011,96.0,64.0,-68.0,235.70019499999944,9233.016926999999,9281.333658999998,9356.467123,9404.783854999998,9157.883462999998,9109.566730999999,9034.433266999999,0.17415930226631668,-1342128.0,+1
2018-04-10,9290.0,9315.450195,9239.0,9292.650391,9111.234375,299119.0,8976.5549804,9077.753675327274,596.1005859999987,78.62233043931262,-0.24738162218214238,74.32370170654758,165.78897686598484,276981.5690885973,-92793.11047115612,96.0,60.0,-68.0,198.90039099999922,9282.366861999999,9325.733723999998,9358.817057,9402.183918999997,9249.283528999998,9205.916667,9172.833333999999,0.7017691844997859,-1043009.0,+1
2018-04-11,9290.0,9350.0,9208.549805,9273.450195,9139.777344,318010.0,9043.1749999,9131.734623436363,666.2001949999994,75.87728915970516,-0.8274760025943202,87.10759843833148,131.38088735573675,-9127.209374410631,-88990.11496675859,96.0,56.00000000000001,-68.0,168.80078199999843,9277.333333333334,9346.116861666667,9418.783528333335,9487.567056666667,9204.666666666668,9135.883138333335,9063.216471666668,0.45882149543872414,-1361019.0,-1
2018-04-12,9290.0,9290.0,9181.099609,9302.5,9043.441406,300797.0,9096.8950194,9178.884623454545,537.2001949999994,77.26314731309675,-0.5134580045400498,129.2406647321186,101.54553598291767,-19358.704103671706,-85825.05083661826,96.0,52.0,24.0,131.20019599999978,9257.866536333333,9334.633463666665,9366.766927333334,9443.533854666664,9225.733072666666,9148.966145333334,9116.832681666667,1.114783793567831,-1060222.0,+1
2018-04-13,9267.0,9267.0,9106.25,9204.450195,8964.349609,366224.0,9132.110058400001,9198.440109927273,352.1503899999989,63.13688567670468,-1.5733413144524977,181.11750648558154,68.1047747791425,109179.23075439842,-76961.2198552084,92.0,48.0,28.0,216.5,9192.566731666666,9278.883463333332,9353.316731666666,9439.633463333332,9118.133463333332,9031.816731666666,8957.383463333332,0.610887682737166,-1426446.0,-1
2018-04-16,9100.0,9245.0,9065.0,9123.950195,9070.509766,271057.0,9158.395117,9196.9564984,262.85058599999866,53.81588773528478,-2.4435175116203713,202.51047173562984,46.34230186541622,-205490.07770298084,-82803.4406664708,88.0,44.0,32.0,175.55078199999843,9144.650065,9224.30013,9324.650065000002,9404.30013,9044.30013,8964.650065,8864.30013,0.3275010833333302,-1697503.0,-1
2018-04-17,9241.0,9242.0,9137.549805,9232.0,9000.113281,342578.0,9180.775097500002,9210.3392044,223.79980500000056,62.41042800449407,-1.275537779699492,221.33408989797863,57.01122211068841,-122688.6927723506,-84616.4066712835,84.0,40.0,36.0,109.25,9203.849935,9270.150065,9308.300129999998,9374.60026,9165.69987,9099.39974,9061.249675000001,0.9042605904182366,-1354925.0,+1
2018-04-18,9178.0,9227.450195,9095.900391,9160.349609,8961.942383,452854.0,9194.1650389,9206.625479218183,133.89941400000134,54.63156416550989,-2.050052869959996,243.09167026920113,37.81470856415438,463422.38973645336,-59705.55228911363,80.0,36.0,39.99999999999999,141.45019499999944,9161.233398333334,9226.566405666668,9292.783202333336,9358.116209666669,9095.016601666668,9029.683594333334,8963.466797666668,0.48992256955397256,-1807779.0,-1
2018-04-19,9144.0,9183.75,9068.0,9121.5,8918.860352,256088.0,9204.9650389,9193.413653963637,108.0,50.67964065817051,-2.4700032428926604,241.3634073580015,22.318252370146812,-12156.683505725698,-57544.2400716869,76.0,32.0,44.0,108.90039099999922,9124.416666666666,9180.833333333332,9240.166666666664,9296.583333333332,9065.083333333332,9008.666666666666,8949.333333333332,0.46220302375809935,-2063867.0,-1
2018-04-20,9082.0,9108.150391,9012.950195,9077.650391,8867.130859,303913.0,9199.470117100002,9170.265536163637,-54.949218000001565,46.3162392892158,-2.9440018268295405,246.26340729421827,4.141302496575261,181211.3898948545,-46691.711436844096,72.0,28.000000000000004,44.0,196.25,9066.250325666666,9119.550456333332,9161.450521666664,9214.750652333332,9024.350260333333,8971.050129666666,8929.150064333333,0.6796225083402132,-2367780.0,-1
2018-04-23,9039.900391,9125.0,9005.950195,9025.0,8906.283203,302205.0,9181.350097600001,9138.54369669091,-181.20019499999944,41.3803076710307,-3.5131337152740243,249.2705271297964,-2.9454711724249365,-338124.7281409564,-59938.66674157648,68.0,24.0,44.0,180.0,9051.983398333332,9098.016601666664,9171.03320333333,9217.066406666665,8978.966796666664,8932.933593333331,8859.916991666663,0.1600154237967922,-2669985.0,-1
2018-04-24,9095.0,9142.549805,9031.0,9064.849609,8906.086914,312103.0,9158.5700194,9117.361789672726,-227.80078199999843,46.37147435160274,-3.0823737001405167,242.93645494759403,-1.6810617595047432,-275154.0217218348,-69721.18287704278,64.0,20.0,44.0,118.04980500000056,9079.466471333335,9127.93294266667,9191.016276333336,9239.48274766667,9016.38313766667,8967.916666333334,8904.833332666669,0.3034483924019465,-2357882.0,+1
2018-04-25,9059.0,9068.799805,8908.0,9064.650391,8778.311523,488641.0,9137.690039,9100.2854936,-208.79980400000022,46.34871034980574,-3.0845271754405013,225.37700797844627,-29.183588489674655,-41093.43434343434,-68419.92158006057,60.0,16.0,44.0,136.09960900000078,9013.816732000001,9119.633464000002,9174.616537000002,9280.433269000003,8958.833659000002,8853.016927,8798.033854000001,0.9741951552739674,-2846523.0,-1
2018-04-26,8949.0,8981.0,8890.0,8934.599609,8789.955078,614321.0,9100.899999899999,9063.359960872729,-367.9003909999992,33.83689114682943,-4.490329596800337,180.76782766292308,-60.97469816085127,223160.5983612756,-55166.2615827271,56.00000000000001,12.0,44.0,115.75,8935.199869666667,8980.399739333334,9026.199869666667,9071.399739333334,8889.399739333334,8844.199869666667,8798.399739333334,0.490105593406602,-3460844.0,-1
2018-04-27,9015.0,9137.0,8715.099609,8946.450195,8629.708008,1873816.0,9075.0999999,9035.278178163637,-258.0,35.66296612513388,-4.3622290022700305,142.03880833755466,-65.17008619380887,-229297.57769291257,-63081.32140591736,52.0,8.0,44.0,108.54980500000056,8932.849934666667,9150.600260333333,9354.750325666664,9572.500651333332,8728.699869333333,8510.949543666668,8306.799478333334,0.5483535709735786,-1587028.0,+1
2018-04-30,8790.0,8904.200195,8760.299805,8783.349609,8660.754883,497504.0,9041.0399413,8982.232652545455,-340.60058599999866,24.795310725533398,-6.125287979677864,93.74127520396178,-114.05667713741411,-30668.177717302835,-61607.99669279852,48.0,4.0,44.0,119.04980500000056,8815.949869666667,8871.599934333333,8959.850259666668,9015.500324333332,8727.699544333334,8672.049479666668,8583.799154333336,0.16017888485222592,-2084532.0,-1
2018-05-02,8915.0,8998.0,8725.0,8814.950195,8591.537109,806846.0,8999.334960799999,8941.125425945454,-417.04980500000056,29.591858767134298,-5.783696951680906,60.67443221743815,-103.38417089089546,175873.28091366275,-50813.39316523208,44.0,0.0,44.0,117.54980500000056,8845.983398333332,8966.966796666664,9118.98339833333,9239.966796666664,8693.966796666664,8572.983398333332,8420.966796666664,0.3294878937728917,-1277686.0,+1
2018-05-03,8765.0,8799.0,8700.0,8744.5,8602.787109,406825.0,8957.749999900001,8894.79179670909,-415.8496090000008,25.42111554976765,-5.935153954955935,23.14120145659399,-144.93574803024006,-49623.39564169901,-50759.302368707846,40.0,0.0,44.0,160.79980500000056,8747.833333333334,8795.666666666668,8846.833333333336,8894.666666666668,8696.666666666668,8648.833333333334,8597.666666666668,0.4494949494949495,-1684511.0,-1
2018-05-04,8784.0,8790.0,8665.0,8755.950195,8526.397461,490244.0,8921.1950194,8858.10092309091,-365.54980500000056,27.34157773413466,-5.574277977748697,-38.04960114414098,-141.10018701041744,-240040.41723898676,-59362.98940826598,36.0,96.0,44.00000000000001,174.65039099999922,8736.983398333332,8808.966796666664,8861.98339833333,8933.966796666664,8683.966796666664,8611.983398333332,8558.966796666664,0.7276015599999955,-1194267.0,+1
2018-05-07,8693.0,8770.0,8660.0,8678.200195,8590.750977,342702.0,8881.249999799998,8813.920045927272,-399.4501959999998,22.751365501180615,-6.1972425650557685,-85.73730981110202,-140.19306315734846,201981.52019257104,-47483.69351731884,32.0,96.0,44.0,421.9003909999992,8702.733398333332,8745.466796666664,8812.73339833333,8855.466796666664,8635.466796666664,8592.733398333332,8525.466796666664,0.16545631818181308,-1536969.0,-1
2018-05-08,8785.0,8806.200195,8690.0,8743.700195,8621.701172,404969.0,8853.120019299999,8788.910990509092,-281.29980500000056,33.589075578129666,-5.450068959860008,-124.71441066569605,-103.83462565127202,112041.12479493768,-40232.56541221627,28.000000000000004,96.0,44.0,186.15038999999888,8746.633463333332,8803.266926666663,8862.83365833333,8919.467121666663,8687.066731666664,8630.433268333332,8570.866536666665,0.462135153903999,-1132000.0,+1
2018-05-09,8795.0,8795.0,8705.0,8775.200195,8565.844727,314057.0,8824.1550779,8774.743749727273,-289.64941400000134,38.38579921845256,-4.954291148433001,-159.4483815095591,-86.78852025763953,220947.65963965966,-28360.73700076735,24.0,92.0,44.0,273.0,8758.400065,8811.80013,8848.400065000002,8901.80013,8721.80013,8668.400065,8631.80013,0.7800021666666604,-817943.0,+1
2018-05-10,8758.0,8758.0,8690.0,8718.349609,8552.679688,298598.0,8789.524999700001,8755.506391745455,-346.30078199999843,33.36705213139338,-5.122875048845584,-181.80617188302313,-86.72137766541213,-131468.7277741661,-33047.46385410366,20.0,88.0,40.0,114.95019499999944,8722.116536333333,8754.233072666666,8790.116536333335,8822.233072666666,8686.233072666666,8654.116536333333,8618.233072666666,0.41690601470589383,-1116541.0,-1
2018-05-11,8738.0,8765.0,8702.049805,8704.950195,8597.235352,264405.0,8766.560058300001,8740.129154527272,-229.64941400000134,32.22136146019794,-4.838803560943082,-211.43753462029417,-72.04043446856386,458559.903930131,-10701.674409365703,16.0,84.0,-60.0,125.0,8724.0,8745.950195,8786.950195,8808.900389999999,8683.0,8661.049805,8620.049805,0.04607436084985765,-1380946.0,-1
2018-05-14,8751.0,8760.0,8688.099609,8750.299805,8554.693359,276620.0,8746.9450193,8737.172744836364,-196.15038999999888,40.23503854540411,-4.337345494389081,-243.8360736717932,-57.11634426611038,782724.5593098484,25363.15439605315,12.0,80.0,-64.0,110.0,8732.799804666667,8777.500000333333,8804.700195666668,8849.400391333333,8705.599609333334,8660.899413666668,8633.699218333335,0.8650884249016177,-1104326.0,+1
2018-05-15,8725.0,8750.349609,8639.0,8707.0,8573.950195,506107.0,8739.3100584,8729.910014054545,-76.34960900000078,35.598149435897625,-4.816137627275449,-254.52486615196358,-57.52821842177806,-192022.25871203194,15481.999254776545,8.0,76.0,-68.0,128.0,8698.783203,8758.566406000002,8810.132812000003,8869.916015000003,8647.216797000001,8587.433594,8535.867188,0.6106891673054687,-1610433.0,-1
2018-05-16,8675.0,8733.450195,8675.0,8726.599609,8543.493164,288597.0,8730.4749998,8727.599023254545,-88.35058599999866,39.25448367868445,-4.540831942907714,-263.49192536943156,-43.63575905377425,368519.545347689,31529.16044081803,4.0,96.0,-68.0,90.0,8711.683267999999,8748.366535999998,8770.133462999998,8806.816730999997,8689.916340999998,8653.233073,8631.466145999999,0.8827961822882076,-1321836.0,+1
2018-05-17,8725.0,8766.450195,8661.200195,8695.599609,8545.360352,379606.0,8725.584960700002,8721.258043109092,-48.90039099999922,35.56910073616767,-4.88382818101349,-246.25520148709074,-37.5706584951631,189041.7918050353,38688.82550282791,0.0,92.0,-68.0,85.20019499999944,8707.749999666667,8754.299804333334,8812.999999666665,8859.549804333334,8649.049804333334,8602.499999666667,8543.799804333334,0.32683528741093915,-1701442.0,-1
2018-05-18,8700.799805,8725.0,8496.0,8697.5,8362.073242,603507.0,8719.739941200001,8716.151686618181,-58.45019499999944,35.99415284969834,-4.86280150475769,-234.41612627836548,-50.3909852463693,-428588.29027711356,17448.956603739643,0.0,88.0,-68.0,62.95019499999944,8639.5,8783.0,8868.5,9012.0,8554.0,8410.5,8325.0,0.8799126637554585,-1097935.0,+1
2018-05-21,8518.0,8524.799805,8255.5,8510.950195,8281.06543,872463.0,8703.014941200001,8678.189914581819,-167.25,20.60082860977603,-5.473084672435111,-215.67218823043004,-100.22343756918141,-473242.51715748245,-4855.201294497741,0.0,96.0,-68.0,71.90039099999922,8430.416666666666,8605.333333333332,8699.716471666667,8874.633138333333,8336.033528333332,8161.1168616666655,8066.733723333331,0.948571778579635,-1970398.0,-1
2018-05-22,8416.0,8586.400391,8371.25,8428.5,8410.90332,410467.0,8671.494921700001,8628.27810709091,-315.20019499999944,16.912336447652663,-6.399595460164063,-206.81756493188914,-81.30927806882359,-421522.05498243286,-23794.603734858443,0.0,96.0,-68.0,111.34960900000078,8462.050130333333,8552.850260666666,8677.200521333332,8768.000651666665,8337.699869666667,8246.899739333334,8122.549478666668,0.26609293961264613,-2380865.0,-1
2018-05-23,8560.0,8564.799805,8458.200195,8560.650391,8348.760742,399631.0,8650.039941300001,8608.124556054547,-214.54980400000022,37.58075898800499,-2.820077619680826,-189.19325962742732,-54.81622997156897,993531.4677121342,22447.49042182308,0.0,92.0,-92.0,58.45019499999944,8527.883463666667,8597.566732333335,8634.483073666668,8704.166342333336,8490.967122333333,8421.283853666666,8384.367512333332,0.961074773162854,-1981234.0,+1
2018-05-24,8500.099609,8518.299805,8400.0,8497.400391,8263.625977,292331.0,8627.9450195,8580.371910545455,-220.94921800000157,33.04163267854884,-3.546487930498309,-175.26559083175744,-65.11133626490708,118112.66353986965,26795.907381734294,0.0,88.0,-92.0,105.25,8471.900065333333,8543.800130666667,8590.199870333334,8662.099935666667,8425.500325666666,8353.600260333333,8307.200520666665,0.8233351779404772,-2273565.0,-1
2018-05-25,8412.0,8574.0,8395.150391,8410.75,8398.62207,519151.0,8598.525000000001,8540.881906999999,-294.20019499999944,27.744493074004055,-4.541645834984727,-172.95653756602587,-63.585537329071535,-1411963.3005595845,-38602.23843378025,0.0,84.0,-88.0,229.0,8459.966797,8524.783202999999,8638.816406000002,8703.632812,8345.933593999998,8281.117187999998,8167.0839849999975,0.08722193516230005,-2792716.0,-1
2018-05-28,8560.0,8785.0,8555.099609,8548.150391,8556.953125,446264.0,8578.3100586,8531.722887181817,-202.14941400000134,44.131868847895,-2.9636369696447553,-162.7805516888675,-10.32507348468952,172552.71072568573,-29004.286199259062,8.0,80.0,-96.0,442.0,8629.416666666666,8703.733724333331,8859.317057666663,8933.63411533333,8473.833333333332,8399.516275666667,8243.932942333333,-0.03022708212793596,-2346452.0,+1
2018-05-29,8718.0,8840.0,8680.0,8709.299805,8562.456055,665121.0,8578.5400391,8555.539204709092,2.2998050000005605,57.252109875937414,-1.4952544903329075,-149.6832842531603,27.135163829514838,-27529.59528567582,-28937.25479409619,4.0,76.0,-96.0,215.15039099999922,8743.099935,8806.19987,8903.099934999998,8966.19987,8646.19987,8583.099935,8486.19987,0.1831237812500035,-1681331.0,+1
2018-05-30,8669.0,8669.0,8572.849609,8714.900391,8437.97168,508262.0,8577.370117299999,8580.331995963636,-11.699218000001565,57.65092738836609,-1.4311818899439512,-146.08869941967714,0.6681148963741728,-324395.92818187526,-42367.1944935407,0.0,72.0,-92.0,136.29980500000056,8652.25,8731.650391,8748.400391,8827.800781999998,8635.5,8556.099609,8539.349609,1.477381220425818,-1173069.0,+1
2018-05-31,8639.0,8639.099609,8515.900391,8588.200195,8387.864258,679959.0,8566.6301759,8582.301101,-107.39941400000134,46.360730212296566,-2.880675037181107,-137.63163579140019,-22.994312429707982,-441870.40913805534,-60526.43152283683,8.0,68.0,-88.0,160.65039099999922,8581.066731666666,8646.233072333333,8704.265949666667,8769.432290333334,8523.033854333331,8457.867513666664,8399.83463633333,0.5868527834324346,-1853028.0,-1
2018-06-01,8610.0,8848.400391,8590.049805,8537.200195,8654.761719,1002010.0,8550.6001954,8576.950195381818,-160.29980500000056,42.49547060735608,-3.5568174056831756,-133.7643171005966,8.241220349155371,5464.993670886076,-57526.82128675851,4.0,64.0,-84.0,178.84960900000078,8658.550130333331,8727.050455666662,8916.900716333332,8985.40104166666,8468.699869666663,8400.199544333333,8210.349283666665,-0.2045654736777001,-2855038.0,-1
2018-06-04,8840.0,8840.0,8726.049805,8808.849609,8596.792969,380690.0,8580.3901368,8623.904634218181,297.89941400000134,61.97813409480261,-0.4520399139657848,-127.6475425180306,64.3643928222031,-278401.7754785572,-67566.59193184027,0.0,60.0,-72.0,374.25,8791.633138000001,8857.216471000002,8905.583333,8971.166666000001,8743.266276000002,8677.682943000002,8629.316081000003,0.7266315252905063,-2474348.0,+1
2018-06-05,8750.0,8830.0,8680.0,8749.849609,8656.285156,400886.0,8612.5250977,8654.715447345456,321.3496090000008,57.127663423798026,-1.1263718380218593,-122.6454151321177,48.617404822756434,78996.40163148602,-60904.63767896181,4.0,56.00000000000001,-72.0,291.8496090000008,8753.283203,8826.566406000002,8903.283202999999,8976.566406000002,8676.566406000002,8603.283203,8526.566406000002,0.4656640600000052,-2875234.0,-1
2018-06-06,8829.0,8870.0,8810.0,8810.400391,8687.674805,328784.0,8637.5000977,8690.6927734,249.75,60.763859685813905,-0.6795075704024716,-99.95158049867314,82.55093024560412,-10818.894864628499,-58628.01300558302,0.0,52.0,-72.0,136.45019599999978,8830.133463666667,8850.266927333334,8890.133463666665,8910.266927333334,8790.266927333334,8770.133463666667,8730.266927333334,0.006673183333320291,-2546450.0,+1
2018-06-07,8874.0,8934.799805,8865.0,8842.349609,8755.370117,267961.0,8671.9950195,8727.93813909091,344.94921800000157,62.69040437502082,-1.0463138373470626,-60.64866938478917,99.38670633479967,16221.620791232934,-55225.75692390957,96.0,48.0,-60.0,199.0,8880.716471333335,8896.43294266667,8950.516276333336,8966.23274766667,8826.63313766667,8810.916666333334,8756.833332666669,-0.3245050756230485,-2278489.0,+1
2018-06-08,8894.0,8950.0,8871.0,8911.25,8776.200195,287823.0,8722.045019500001,8771.439044636363,500.5,66.75259186099838,-0.43780363800700484,-39.47451732617992,106.11033673278428,105653.6170212766,-47913.05810821928,96.0,44.0,-60.0,260.2001959999998,8910.75,8950.5,8989.75,9029.5,8871.5,8831.75,8792.5,0.509493670886076,-1990666.0,+1
2018-06-11,8960.0,9046.0,8921.5,8932.450195,8864.822266,337828.0,8760.474999900001,8809.694531090909,384.2998040000002,67.98994020985742,-1.2691383145188393,-5.89976604412368,131.71880039760924,-231066.10714125534,-56238.19670063001,96.0,40.0,-60.0,302.79980500000056,8966.650065,9011.80013,9091.150065000002,9136.30013,8887.30013,8842.150065,8762.80013,0.0879533734939714,-1652838.0,+1
2018-06-12,9039.0,9065.0,8955.0,9022.650391,8859.025391,343452.0,8791.810058500001,8857.362784018182,313.35058599999866,72.93486719365289,-0.47233559000670067,40.749433915867485,146.37505470574658,302127.997981543,-39948.82421507668,96.0,36.0,-52.00000000000001,150.0,9014.216797,9073.433593999998,9124.216797000001,9183.433593999998,8963.433593999998,8904.216797,8853.433593999998,0.6150035545454474,-1309386.0,+1
2018-06-13,9030.0,9094.950195,8943.0,9016.75,8810.489258,369407.0,8821.995019400001,8898.2609552,301.8496090000008,72.09425578793665,-0.8692822137172741,76.54682831323953,133.39643709559775,-328420.62352468685,-53061.178729149884,96.0,32.0,-52.0,120.15039099999922,9018.233398333332,9093.466796666664,9170.183593333331,9245.416991666663,8941.516601666664,8866.283203333332,8789.566406666665,0.4853564024712194,-1678793.0,-1
2018-06-14,8932.049805,9019.950195,8908.0,8967.349609,8801.302734,269078.0,8859.9099608,8924.689062399999,379.14941400000134,64.8713714183692,-1.4184225483031219,93.57169753023118,101.38685535564323,135771.61229838294,-44477.8700460802,96.0,28.000000000000004,48.0,124.39941400000134,8965.099934666667,9022.199869333333,9077.050129666666,9134.150064333333,8910.249674333334,8853.149739666667,8798.299479333335,0.5301429711667861,-1947871.0,-1
2018-06-15,8995.0,8995.0,8901.0,8958.0,8795.013672,496572.0,8901.9899413,8942.523614981817,420.79980500000056,63.48245947373163,-1.522353859585807,107.62680558805914,88.22562479859418,120565.73090221244,-36975.88818479417,92.0,24.0,52.0,107.65039099999922,8951.333333333334,9001.666666666668,9045.333333333336,9095.666666666668,8907.666666666668,8857.333333333334,8813.666666666668,0.6063829787234043,-2444443.0,-1
2018-06-18,8947.5,9050.400391,8937.950195,8951.599609,8816.482422,305144.0,8916.2649413,8951.543554563636,142.75,62.42672871542386,-1.5935013299614946,140.39364721294805,82.16478319413237,288759.13004525396,-22169.75099251924,88.0,20.0,56.0,134.75,8979.983398333334,9022.016601666668,9092.433594333334,9134.466797666668,8909.566405666668,8867.533202333334,8797.116209666669,0.12138186046382142,-2749587.0,-1
2018-06-19,8970.0,8984.799805,8820.049805,8973.450195,8707.571289,350407.0,8938.624999900001,8961.940873418182,223.60058599999866,64.73680129200872,-1.350607744221732,187.2900532556232,50.31616517026536,-246072.84787254996,-32347.1644870661,84.0,16.0,60.0,132.54980500000056,8926.099935,9032.150065,9090.849935,9196.900065,8867.400065,8761.349935,8702.650065,0.931110106221541,-2399180.0,+1
2018-06-20,8873.0,8970.0,8863.0,8862.599609,8791.772461,325981.0,8943.844921700002,8948.118075072727,52.199218000001565,47.60444974342291,-2.5828353977453147,194.28143205744527,32.098876605873535,-80478.86955685767,-34534.969262965715,80.0,12.0,64.0,151.95019499999944,8898.533203,8934.066406000002,9005.533202999999,9041.066406000002,8827.066406000002,8791.533203,8720.066406000002,-0.0037419719626095088,-2725161.0,-1
2018-06-21,8978.0,8986.0,8852.950195,8948.299805,8708.013672,313349.0,8954.439941300001,8948.928053854546,105.95019599999978,57.61148950301387,-1.6301823245031748,214.02227003652115,34.295982343788516,396526.2264150944,-14941.2785503266,76.0,8.0,68.0,111.95019499999944,8929.083333333334,9005.216471666668,9062.133138333336,9138.266276666669,8872.166666666668,8796.033528333333,8739.116861666667,0.7166459958359257,-2411812.0,+1
2018-06-22,8865.0,8887.0,8810.0,8863.049805,8719.65625,319027.0,8949.6199218,8932.311665436364,-48.20019499999944,47.25290893795957,-2.577830968082621,223.02800572889282,2.178922992112739,-330083.7608619343,-29265.93683721787,72.0,4.0,68.0,94.0,8853.349935,8896.69987,8930.349934999998,8973.69987,8819.69987,8776.349935,8742.69987,0.6889585064935138,-2730839.0,-1
2018-06-25,8869.0,8869.0,8780.0,8874.900391,8639.189453,254954.0,8943.864941400001,8918.7262962,-57.54980400000022,48.7314570624365,-2.4460985135545235,228.97253143777925,-5.485165397322452,-185489.40878909294,-36367.003744121284,68.0,0.0,68.0,112.45019599999978,8841.300130333333,8902.600260666666,8930.300130333333,8991.600260666666,8813.600260666666,8752.300130333333,8724.600260666666,1.0662965280898788,-2475885.0,+1
2018-06-26,8793.0,8985.349609,8750.0,8793.0,8775.118164,387769.0,8920.8999023,8891.296306854545,-229.65039099999922,39.828656182925506,-3.3565125245782825,211.96986958411435,-6.928759828165237,-157802.15808171258,-41886.78348673907,64.0,0.0,68.0,164.75,8842.783203,8935.566406000002,9078.132812000003,9170.916015000003,8700.216797000001,8607.433594,8464.867188,0.18270691072191184,-2863654.0,-1
2018-06-27,8935.950195,9012.0,8873.0,8931.349609,8742.646484,501622.0,8912.359863200001,8893.196253527272,-85.40039099999922,55.628726625035505,-1.8186026206651167,189.48259895055708,23.616336616652774,-555976.8874397271,-65254.51548460218,60.0,8.0,68.0,110.45019499999944,8938.783203,9004.566406000002,9077.783202999999,9143.566406000002,8865.566406000002,8799.783203,8726.566406000002,0.41978135971223585,-2362032.0,+1
2018-06-28,8892.0,8894.049805,8735.049805,8898.299805,8617.869141,376404.0,8905.4548828,8890.639879309092,-69.04980400000022,51.87416456885334,-2.185987980561501,160.7028402910546,-19.195183856569496,-939858.405544514,-105009.23776005274,56.00000000000001,4.0,68.0,133.04980500000056,8842.466471666667,8949.883138333333,9001.466471666668,9108.883138333333,8790.883138333333,8683.466471666667,8631.883138333333,1.0267295597484276,-2738436.0,-1
2018-06-29,8750.299805,8900.0,8750.299805,8771.299805,8671.21875,458807.0,8886.7848633,8866.248046981818,-186.70019499999944,39.926052637600314,-3.5977343469496486,123.60222452444759,-40.05633091588481,66519.94711027089,-97212.45662958348,52.0,0.0,68.0,138.29980500000056,8807.199870000002,8864.099935000004,8956.900065000003,9013.800130000003,8714.399740000004,8657.499675000003,8564.699545000005,0.1402803783922932,-3197243.0,-1
2018-07-02,8878.0,8935.0,8800.049805,8825.599609,8666.748047,298529.0,8874.1848633,8855.12345529091,-126.0,46.055708698285315,-2.994131583228476,86.92586441551794,-22.990755566630572,-640702.3615271455,-121916.54321583633,48.0,12.0,68.0,89.0,8853.549804666667,8907.049804333334,8988.499999666668,9041.999999333333,8772.099609333334,8718.599609666668,8637.149414333335,0.18932765528794032,-2898714.0,+1
2018-07-03,8825.0,8995.0,8750.0,8821.049805,8818.15332,375718.0,8858.9448243,8845.4625356,-152.40038999999888,45.60581235226796,-3.044707719171614,57.998553665082,-28.829852600770785,-515607.61284586595,-139811.59183538315,44.0,8.0,64.0,235.34960900000078,8855.349935,8960.69987,9100.349934999998,9205.69987,8715.69987,8610.349935,8470.69987,0.28999920408163493,-3274432.0,-1
2018-07-04,9014.0,9249.25,8952.5,8975.150391,9059.505859,656141.0,8870.199902500002,8866.590820454545,112.55078199999843,60.63407974027031,-2.99554229665857,42.309752744558864,98.00600314271625,334885.74554625474,-118234.44013621777,40.0,4.0,52.0,219.0,9058.966797,9165.433593999998,9355.716797000001,9462.183593999998,8868.683593999998,8762.216797,8571.933593999998,0.07632819208087352,-2618291.0,+1
2018-07-05,9228.0,9395.0,9225.75,9220.799805,9183.546875,887919.0,8897.4499025,8930.336257272727,272.5,73.89835743669386,-1.8739263661789956,29.288461679654574,256.47928463952195,-117727.84998960535,-118211.41331137174,96.0,0.0,52.00000000000001,196.29980400000022,9280.516601666668,9335.283203333336,9449.76660166667,9504.533203333336,9166.033203333336,9111.266601666668,8996.783203333336,-0.029247828655831254,-1730372.0,+1
2018-07-06,9315.0,9413.950195,9260.0,9347.049805,9154.513672,508241.0,8945.849902500002,9012.08169409091,484.0,78.2452662560137,-0.7182044841840283,27.073770425868133,258.7320117422003,-628589.3596986817,-141410.4108744313,96.0,0.0,52.0,149.70019499999944,9340.333333333334,9420.666666666668,9494.283528333333,9574.616861666667,9266.716471666668,9186.383138333335,9112.766276666669,0.5654413428966484,-1222131.0,+1
2018-07-09,9395.0,9419.849609,9350.0,9317.5,9210.910156,331872.0,8990.1098634,9079.654439090908,442.5996090000008,74.87755026562081,-1.0980716704319993,9.905475370171189,232.54555675986182,12331.614660410627,-134422.13698648394,96.0,4.0,36.0,163.70019499999944,9362.449869666667,9374.899739333334,9432.299478666668,9444.749348333335,9305.050130333333,9292.600260666666,9235.200521333332,-0.4652853532794956,-1554003.0,-1
2018-07-10,9380.0,9545.900391,9380.0,9374.900391,9364.279297,485745.0,9048.2999025,9149.6163532,581.9003909999992,77.0878509135999,-1.8101175297975047,23.672079661047974,227.00515930496815,-193254.18261031448,-137096.32087847622,96.0,0.0,36.0,245.0,9433.600260666666,9487.200521333332,9599.500651666665,9653.100912333332,9321.300130333333,9267.699869666667,9155.399739333334,-0.030738981199874366,-1068258.0,+1
2018-07-11,9529.0,9529.349609,9361.0,9531.0,9220.539063,328446.0,9108.2649416,9237.38000729091,599.6503909999992,82.04480022457896,-0.1577278301165822,38.28836387888623,198.33247407315488,108792.02240263321,-125919.57800206213,96.0,64.0,36.0,428.20019499999944,9473.783203,9586.566406000002,9642.132812000003,9754.916015000003,9418.216797000001,9305.433594,9249.867188,1.009803355112035,-739812.0,+1
2018-07-12,9448.0,9508.0,9325.25,9384.700195,9183.499023,336960.0,9156.9049806,9287.640962454545,486.4003899999989,66.48911801802954,-1.7063818747742294,67.43593105888067,136.464346773915,-119990.72849249734,-125650.08484253647,92.0,60.0,96.0,419.8496090000008,9405.983398333332,9486.716796666664,9588.73339833333,9669.466796666664,9303.966796666664,9223.233398333332,9121.216796666664,0.32530886456908037,-1076772.0,-1
2018-07-13,9408.0,9495.0,9362.25,9347.0,9266.078125,511150.0,9214.475000100001,9322.203693254545,575.7001949999994,62.94083497071315,-2.105456634109219,81.60395650065766,110.41836764985035,-44006.71488613622,-121939.02257179099,88.0,56.00000000000001,96.0,193.15038999999888,9401.416666666666,9440.583333333332,9534.166666666664,9573.333333333332,9307.833333333332,9268.666666666666,9175.083333333332,-0.11487758945386065,-1587922.0,-1
2018-07-16,9429.0,9498.900391,9355.0,9431.049805,9221.12793,216426.0,9275.020019700001,9361.580930509092,605.4501959999998,67.41422494274121,-1.2157488831936458,109.29349593242114,100.56499534558156,-521142.7414098696,-140084.64615534004,84.0,52.0,92.0,72.79980400000022,9428.316732,9501.633463999999,9572.217122999999,9645.533854999998,9357.733073,9284.416341,9213.832682,0.5284892172391733,-1371496.0,+1
2018-07-17,9351.150391,9479.700195,9347.0,9385.299805,9280.177734,457123.0,9331.445019699999,9381.631800563637,564.25,62.66351843897432,-1.7000347135342062,158.79475870423812,78.33277476317429,-926008.5882352942,-175808.46170442892,80.0,48.0,96.0,228.40039099999922,9404.0,9461.0,9536.700194999998,9593.700195,9328.299805,9271.299805,9195.599610000001,0.28861905591020964,-1828619.0,-1
2018-07-18,9482.299805,9534.0,9296.900391,9445.400391,9202.952148,430624.0,9378.470019700002,9402.350958981819,470.25,66.26681133207308,-1.0638410043546738,213.19633743460872,72.24355450966237,193752.43778640145,-159010.23900030027,76.0,44.0,32.0,168.34960900000078,9425.433594,9553.966797000001,9662.533203000003,9791.066406000002,9316.867188,9188.333985,9079.767579,0.6263190421372627,-1397995.0,+1
2018-07-19,9408.0,9434.0,9350.0,9366.799805,9224.861328,199983.0,9393.0700197,9400.229101763636,146.0,57.842943488179046,-1.8958661421965097,271.5428033974531,52.56560755258064,871426.3106621716,-112172.2140156424,72.0,40.0,32.0,205.75,9383.599935,9417.19987,9467.599934999998,9501.19987,9333.19987,9299.599935,9249.19987,0.19999767857143524,-1597978.0,-1
2018-07-20,9392.0,9464.0,9335.0,9389.099609,9234.540039,272916.0,9397.275000100002,9399.50720890909,42.04980400000022,59.52717638010852,-1.6598119542932994,311.2800512223221,47.492227966082346,266293.8193509248,-94969.21249898025,68.0,36.0,31.999999999999993,132.75,9396.033203,9457.066406000002,9525.033202999999,9586.066406000002,9328.066406000002,9267.033203,9199.066406000002,0.41937681395349447,-1325062.0,+1
2018-07-23,9448.0,9750.0,9372.0,9398.950195,9531.305664,607813.0,9405.4200196,9399.8117898,81.45019499999944,60.334875508219845,-3.63744487617864,319.9393515308184,62.81349813007543,-52528.436962990345,-93040.08633825344,64.0,32.0,32.0,151.90039099999922,9506.983398333332,9641.966796666664,9884.98339833333,10019.966796666664,9263.966796666664,9128.983398333332,8885.966796666664,0.07129681216931069,-717249.0,+1
2018-07-24,9778.0,9929.0,9725.0,9701.0,9660.457031,749626.0,9438.029980500001,9453.55360441818,326.0996090000008,76.75064883135742,-2.3194303153611395,319.47888550565585,107.74128510541706,-308048.7990402744,-102813.20964289078,96.0,28.000000000000004,32.0,132.70019499999944,9785.0,9845.0,9989.0,10049.0,9641.0,9581.0,9437.0,-0.11764705882352941,32377.0,+1
2018-07-25,9853.0,9875.849609,9701.0,9832.450195,9588.242188,384750.0,9468.175000000001,9525.266370690908,301.45019499999944,80.75094785040599,-0.982195371312315,329.15401021116304,94.58733861526363,373431.7475919749,-81165.7115867605,96.0,24.0,32.0,237.09960900000078,9803.099934666667,9905.199869333333,9977.94954366667,10080.049478333334,9730.350260333333,9628.250325666666,9555.500651333332,0.7517900426074092,417127.0,+1
2018-07-26,9819.799805,9831.700195,9361.0,9758.950195,9231.886719,1261317.0,9505.6,9578.134587963636,374.25,72.68257541344369,-1.7299064598168927,323.9310650469706,55.70330213481076,998605.7924020647,-32085.188678177503,92.0,20.0,32.0,95.40039099999922,9650.550129999998,9940.100259999996,10121.250324999997,10410.800454999995,9469.400064999996,9179.849934999998,8998.699869999997,0.8454430213269827,-844190.0,-1
2018-07-27,9402.0,9442.200195,9290.0,9396.25,9147.539063,672141.0,9510.525000000001,9558.252769781819,49.25,46.32667740114636,-5.419633774160732,293.529152401612,-0.9716576665574375,-560435.4163855592,-56101.10811942215,88.0,16.0,32.0,129.0,9376.150065,9462.30013,9528.35026,9614.500324999999,9310.099935,9223.94987,9157.89974,0.6980937179482615,-1516331.0,-1
2018-07-30,9320.0,9404.5,9233.0,9310.400391,9217.788086,539464.0,9498.460058600002,9521.866477236365,-120.64941400000134,42.152164300655194,-6.292976693794515,274.58160591020714,-18.235427944925245,-299493.18,-67164.38411399387,84.0,12.0,32.0,378.0,9315.966797,9398.933593999998,9487.466797000001,9570.433593999998,9227.433593999998,9144.466797,9055.933593999998,0.45131423323614706,-2055795.0,-1
2018-07-31,9400.0,9548.849609,9355.0,9381.900391,9354.012695,426388.0,9498.1201172,9500.673810400001,-3.399414000001343,46.762259727901956,-5.565611485249245,263.0368922555899,-0.9950307402018974,-303028.6837682859,-77885.48864373442,80.0,8.0,68.0,530.0498050000006,9428.583333333334,9502.166666666668,9622.432942333333,9696.016275666669,9308.317057666667,9234.733724333333,9114.467448666666,0.1387693848791777,-1629407.0,+1
2018-08-01,9535.0,9587.75,9300.0,9520.549805,9178.192383,700719.0,9505.6350586,9504.751935454546,75.14941400000134,54.81867220493093,-4.155139318413015,238.06380120551694,3.9701716808790963,458436.6543032988,-53507.20941886926,76.0,4.0,72.0,174.84960900000078,9469.433268333334,9638.866536666668,9757.183268333334,9926.616536666668,9351.116536666668,9181.683268333334,9063.366536666668,0.7664632667245893,-928688.0,+1
2018-08-02,9327.0,9327.0,9120.0,9341.599609,8982.477539,875157.0,9503.115039,9474.927308254544,-25.200195999999778,44.73665118873607,-5.975588921668354,223.18753104670395,-52.33859139061455,421623.5310128211,-31910.35758106513,72.0,0.0,72.0,471.45019499999944,9262.866536333333,9405.733072666666,9469.866536333335,9612.733072666666,9198.733072666666,9055.866536333333,8991.733072666666,1.0705295120772984,-1803845.0,-1
2018-08-03,9150.0,9230.0,9150.0,9142.400391,9026.296875,470958.0,9478.445117199999,9409.3428268,-246.69921800000157,36.1881683223563,-8.002030610376407,192.23976588235018,-77.85706722838978,-93308.62050028115,-34701.187713756764,68.0,8.0,72.0,468.95019499999944,9174.133463666667,9198.266927333334,9254.133463666665,9278.266927333334,9118.266927333334,9094.133463666667,9038.266927333334,-0.09499511250000978,-2274803.0,-1
2018-08-06,9247.5,9300.0,9200.0,9187.0,9123.958984,237693.0,9457.250097700002,9356.35280549091,-211.95019499999944,39.19003669009039,-7.548321464903357,163.8549789476001,-61.44324053316033,200094.50474093464,-24028.656238543514,64.0,4.0,72.0,171.5,9229.0,9258.0,9329.0,9358.0,9158.0,9129.0,9058.0,-0.13,-2037110.0,+1
2018-08-07,9316.0,9420.0,9271.0,9286.400391,9246.870117,381993.0,9415.790136800002,9325.289222454545,-414.5996090000008,45.752610830793934,-6.537127253306213,137.2116106123558,-32.19711250374922,-132519.3727423302,-28960.05244326109,60.0,0.0,72.0,238.44921800000157,9325.800130333333,9380.600260666666,9474.800130333333,9529.600260666666,9231.600260666666,9176.800130333333,9082.600260666666,0.10335832885905515,-1655117.0,+1
2018-08-08,9449.0,9449.0,9183.049805,9411.5,9046.34082,638498.0,9373.6951173,9324.509197581818,-420.95019499999944,53.10226809940343,-5.264496439471007,111.20988852348455,-25.090689621354056,-171917.02881193435,-35458.09682365533,56.00000000000001,0.0,72.0,287.75,9347.849935,9512.650065,9613.800129999998,9778.60026,9246.69987,9081.89974,8980.749675000001,0.8589961552763664,-1016619.0,+1
2018-08-09,9239.0,9239.0,9060.0,9207.400391,8986.063477,651728.0,9318.5401369,9294.2737928,-551.5498040000002,42.31093702454677,-7.3407895116988895,45.78234057991176,-82.85929565438263,-46992.14977520425,-35982.37195781665,52.0,80.0,72.0,400.54980500000056,9168.800130333333,9277.600260666666,9347.800130333333,9456.600260666666,9098.600260666666,8989.800130333333,8919.600260666666,0.8234658715083755,-1668347.0,-1
2018-08-10,9150.0,9210.0,9105.0,9146.049805,8988.224609,427827.0,9293.5201174,9262.911914272727,-250.20019499999944,39.525078029311004,-7.964905340793484,-29.608759776378065,-82.64169739817935,70366.3977687354,-31148.3369702461,48.0,96.0,60.0,191.59960900000078,9153.683268333334,9202.366536666668,9258.683268333334,9307.366536666668,9097.366536666668,9048.683268333334,8992.366536666668,0.39095052380952916,-2096174.0,-1
2018-08-13,9119.450195,9185.0,9012.200195,9148.25,8922.003906,348201.0,9277.3050783,9236.499165654544,-162.15039099999922,39.68939806308665,-7.942522889114954,-93.30493937907158,-91.46402406833973,-151666.16592992292,-36626.420104776866,44.0,92.0,60.0,157.59960900000078,9115.150065,9218.099935,9287.949870000002,9390.89974,9045.30013,8942.35026,8872.500324999999,0.7873261488923562,-1747973.0,+1
2018-08-14,9079.0,9158.799805,9046.25,9080.849609,9052.599609,344056.0,9247.2000001,9200.779989418183,-301.05078199999843,36.21154373207939,-8.131453707420938,-114.79820800188645,-101.9860772780001,-624410.2155477932,-63343.86535218672,40.0,96.0,60.0,233.0,9095.299804666667,9144.349609333334,9207.849609666668,9256.899414333335,9031.799804333334,8982.749999666667,8919.249999333333,0.30741598352836425,-2092029.0,-1
2018-08-16,9124.0,9235.950195,9085.0,9132.599609,9200.549805,465479.0,9208.404980500001,9179.943554672727,-387.9501959999998,40.80674897117608,-7.183007510692141,-121.16597072397053,-83.3306734359165,71604.45263003341,-57209.85089844944,36.0,92.0,56.00000000000001,265.95019499999944,9151.183267999999,9217.366535999998,9302.133462999998,9368.316730999997,9066.416340999998,9000.233073,8915.466145999999,0.31533320642613916,-1626550.0,+1
2018-08-17,9243.0,9286.5,9130.0,9200.549805,9152.099609,477538.0,9194.3000001,9178.515340945456,-141.04980400000022,46.63148449180509,-4.080623844025815,-127.00772956560468,-60.054243329646404,-646822.6420074275,-84010.43231249391,32.0,88.0,-28.0,351.5,9205.683268333334,9281.366536666668,9362.183268333334,9437.866536666668,9124.866536666668,9049.183268333334,8968.366536666668,0.45079747603834225,-1149012.0,+1
2018-08-20,9170.700195,9217.799805,9062.0,9152.099609,9074.349609,449317.0,9195.2699219,9170.842542563636,9.699218000001565,43.139057016516745,-4.591230573047021,-164.45332894313105,-76.05186043028316,-505283.94816414686,-103159.22848756908,28.000000000000004,84.0,-48.0,105.0,9143.966471333335,9225.93294266667,9299.766276333336,9381.73274766667,9070.13313766667,8988.166666333334,8914.333332666669,0.5783037340772054,-1598329.0,-1
2018-08-21,9110.0,9130.0,9050.400391,9074.349609,9113.299805,380824.0,9184.0048828,9148.857031127272,-112.65039099999922,37.885282271546984,-5.410621957581338,-184.48268711379933,-87.29338036673177,161551.70428805368,-91126.9133614044,24.0,80.0,-48.0,172.79980500000056,9084.916666666666,9119.432942333333,9164.516275666665,9199.032551333334,9039.833333333332,9005.317057666665,8960.233724333331,0.3008710507610826,-1979153.0,-1
2018-08-23,9145.0,9256.0,9100.099609,9113.299805,9223.299805,751705.0,9166.694824200002,9136.001562436364,-173.10058599999866,41.9704259894438,-5.000133790014485,-171.81352587684887,-44.072514892887014,660612.5644782374,-56956.93709596611,20.0,76.0,-56.0,112.54980500000056,9156.466471333333,9212.833333666666,9312.366862333332,9368.733724666665,9056.932942666666,9000.566080333334,8901.032551666667,0.08467070489900083,-1227448.0,+1
2018-08-24,9240.0,9279.900391,9142.099609,9223.299805,9163.799805,401110.0,9147.874804700003,9146.293377127275,-188.20019499999944,52.21192068187594,-2.4139058288769992,-164.8818660394263,-12.861556562777816,277125.6487046881,-41771.36501411818,16.0,72.0,-56.0,155.10058599999866,9215.099935,9288.100261,9352.900717,9425.901042999998,9150.299479000001,9077.299153000002,9012.498697000003,0.5892578751839065,-826338.0,+1
2018-08-27,9209.0,9274.0,9200.0,9163.799805,9245.25,326945.0,9143.514746100002,9149.188831727275,-43.60058599999866,47.031393080128076,-3.050269465240636,-169.51384816360405,-6.7351781833172435,808738.0182192782,-3111.8475944183115,12.0,68.0,-56.0,156.5,9212.599935,9225.19987,9286.599934999998,9299.19987,9151.19987,9138.599935,9077.19987,-0.48919182432431674,-1153283.0,-1
2018-08-28,9277.549805,9446.5,9215.0,9245.25,9427.950195,684054.0,9153.4347656,9167.686150618183,99.20019499999944,54.207969204703474,-2.1791443850267376,-195.89535817587057,29.067608288960212,-97880.54086870649,-7419.515470522323,8.0,64.0,-56.0,155.79980500000056,9302.25,9389.5,9533.75,9621.0,9158.0,9070.75,8926.5,0.1306695464362851,-469229.0,+1
2018-08-29,9421.0,9468.299805,9339.650391,9427.950195,9368.099609,433440.0,9181.404785100001,9217.598046872727,279.70019499999944,66.09670027454291,-0.43065768883250205,-189.58812230331205,74.28960217537052,-11091.533365607573,-7586.425374844381,4.0,60.0,-56.0,101.69921800000157,9411.966797,9484.283202999999,9540.616211,9612.932617,9355.633788999998,9283.317382999998,9226.984374999996,0.6863599394242037,-35789.0,+1
2018-08-30,9370.0,9370.0,9182.650391,9368.099609,9205.799805,674292.0,9210.1297851,9251.542560309092,287.25,60.18997137401194,-1.0694523399339528,-174.8508995947268,32.227738737029206,253235.33920342065,4269.109378713129,0.0,56.00000000000001,-56.0,181.65039099999922,9306.916666666666,9431.182942333333,9494.266275666665,9618.532551333334,9243.833333333332,9119.567057666665,9056.483724333331,0.9898564453369144,-710081.0,-1
2018-08-31,9208.0,9255.0,9080.299805,9205.799805,9096.400391,634522.0,9217.4498047,9250.7552912,73.20019599999978,47.03746163628787,-2.8017034939997845,-144.29880796480757,-12.77036005016218,396964.4137649434,22118.89594172361,0.0,52.0,-56.0,166.60058599999866,9180.366536666668,9280.433268333336,9355.066731666668,9455.133463333335,9105.733073333337,9005.666341666669,8931.032878333337,0.7183735541909406,-1344603.0,-1
2018-09-03,9100.0,9118.950195,8875.0,9096.400391,8902.150391,992161.0,9207.034863300001,9228.74630689091,-104.14941400000134,40.20456609147145,-3.9693405242677184,-97.09374560025753,-75.28548351109106,292807.8539728748,34422.93948859413,0.0,48.0,-56.0,74.0,9030.116861999999,9185.233723999998,9274.067057,9429.183918999997,8941.283528999998,8786.166667,8697.333333999999,0.9075639025416632,-2336764.0,-1
2018-09-04,8912.0,8999.0,8835.450195,8902.150391,8868.5,530967.0,9182.039941500001,9173.312766472727,-249.94921800000157,30.983431541789628,-6.042601109827559,-64.49460632915907,-126.22174514977763,249094.87951978095,44180.75494455717,12.0,96.0,-56.0,282.70019499999944,8912.200195333333,8988.950195666666,9075.750000333332,9152.500000666667,8825.400390666666,8748.650390333332,8661.850585666665,0.40782803745928986,-2867731.0,-1
2018-09-05,8871.0,8950.0,8790.599609,8868.5,8896.099609,491163.0,9161.454980600001,9116.305504381819,-205.84960900000078,29.6252793822689,-6.401756988071966,-64.3857795452841,-137.1818286088281,432775.0164897153,61844.130469337106,8.0,96.0,-56.0,223.04980500000056,8869.699869666667,8948.800130333333,9029.100260666666,9108.200521333332,8789.399739333334,8710.299478666668,8629.999348333335,0.48870890787212434,-3358894.0,-1
2018-09-06,8967.700195,8967.700195,8741.0,8896.099609,8759.849609,687535.0,9139.734961,9068.059073181817,-217.20019599999978,32.42841270887381,-6.107182051049755,-63.002744169483776,-125.86237648891493,-1843338.188874066,-24755.065864454024,4.0,96.0,-56.00000000000001,245.29980400000022,8868.266601333333,8995.533202666666,9094.966796333334,9222.233397666665,8768.833007666666,8641.566406333333,8542.132812666667,0.6841617802754919,-2671359.0,+1
2018-09-07,8775.0,8789.0,8634.25,8759.849609,8719.200195,636918.0,9093.389941399999,8998.989009181818,-463.4501959999998,26.431470262685764,-7.561399578887738,-50.036863551122224,-169.4426303318547,226924.23109334148,-13315.097820917854,0.0,96.0,-52.0,287.7998040000002,8727.699869666667,8821.149739333334,8882.449869666667,8975.899739333334,8666.399739333334,8572.949869666667,8511.649739333334,0.8116291373182603,-3308277.0,-1
2018-09-10,8700.0,8750.0,8625.0,8719.200195,8639.400391,577299.0,9048.9299804,8930.954509836363,-444.5996100000011,24.849536939262478,-7.99525712263192,-34.840675849269246,-154.3669656413485,232025.18670243703,-2163.2667062198957,68.0,96.0,-48.0,330.79980500000056,8698.066731666666,8771.133463333332,8823.066731666666,8896.133463333332,8646.133463333332,8573.066731666666,8521.133463333332,0.7536015599999956,-3885576.0,-1
2018-09-11,8668.0,8699.900391,8479.599609,8639.400391,8517.049805,552622.0,8988.3450195,8856.494584490909,-605.8496090000008,21.88288333245292,-8.846972892869248,-49.01331783739079,-165.5251863627348,592156.1071294388,24851.250286310064,64.0,96.0,-84.0,260.9501959999998,8606.300130333333,8733.000651666665,8826.600912333332,8953.301433666664,8512.699869666667,8385.999348333335,8292.399087666668,0.7253754641687997,-4438198.0,-1
2018-09-12,8539.0,8539.0,8401.0,8517.049805,8493.950195,634678.0,8897.254980500002,8770.80454549091,-910.9003899999989,18.067060701786446,-10.152839804446838,-72.98813344000519,-181.6245826188683,1125691.5670174141,74889.44650136029,60.0,96.0,-88.0,159.40039099999922,8485.683268333334,8570.366536666668,8623.683268333334,8708.366536666668,8432.366536666668,8347.683268333334,8294.366536666668,0.8409406159420331,-5072876.0,-1
2018-09-14,8593.0,8700.0,8580.349609,8493.950195,8626.700195,754169.0,8809.8400391,8697.476402672726,-874.1494140000013,17.405871271596695,-10.399385549387926,-109.46069549240747,-120.20183651229513,1577083.2371309188,143170.98243906753,56.00000000000001,96.0,-92.0,226.70019499999944,8591.433268,8602.516927,8711.083659,8722.167318,8482.866536000001,8471.782877000001,8363.216145000002,-0.7220988855774145,-5827045.0,-1
2018-09-17,8587.0,8659.700195,8517.0,8626.700195,8537.799805,422191.0,8751.9300781,8664.1782492,-579.0996100000011,33.53494885043939,-8.982524068136605,-166.85808997308413,-98.00986798805178,-384424.01738601865,119189.39153792724,52.0,92.0,-96.0,261.8496090000008,8601.133463333332,8685.266926666663,8743.83365833333,8827.967121666663,8542.566731666664,8458.433268333332,8399.866536666665,0.7687459361916069,-5404854.0,+1
2018-09-18,8537.700195,8596.5,8380.200195,8537.799805,8399.150391,507455.0,8696.0700195,8625.245472272729,-558.6005859999987,29.138125589732553,-9.93137181396876,-216.73470549231934,-103.50974411530967,244125.83994585386,124868.3210110148,48.0,88.0,-28.0,134.84960900000078,8504.833333333334,8629.466471666668,8721.133138333336,8845.766276666669,8413.166666666668,8288.533528333333,8196.866861666667,0.7286165144716645,-5912309.0,-1
2018-09-19,8425.5,8448.400391,8191.049805,8399.150391,8210.349609,959340.0,8645.770019500002,8571.260085272728,-503.0,23.575658325948908,-11.411198662139526,-266.343176252547,-120.30956186257814,1287322.8037129703,177707.161133831,44.0,96.0,-32.0,239.60058599999866,8346.200195666666,8501.350586333334,8603.550781666669,8758.701172333333,8244.000000333333,8088.849609666667,7986.649414333334,0.8086268200687132,-6871649.0,-1
2018-09-21,8260.0,8325.0,7599.649901999999,8210.349609,8040.149901999999,1646047.0,8579.954980400002,8492.092737909092,-658.1503909999992,18.13590943034383,-12.508363617732707,-315.06435335527567,-159.8971128588128,656839.6647202339,199485.9112968493,40.0,96.0,-36.0,238.40039099999922,8044.999837,8490.349772000001,8770.349935,9215.699870000002,7764.999674000001,7319.6497389999995,7039.649576,0.8419378568830095,-8517696.0,-1
2018-09-24,8070.0,8070.0,7590.700195,8040.149901999999,7793.049805,1801469.0,8494.360009700002,8393.94636001818,-855.9497070000016,14.625689686200133,-13.26834969418961,-346.234515662396,-152.55271966487044,18171.89317265492,191244.36501847685,36.0,96.0,-39.99999999999999,182.95019499999944,7900.283365666667,8209.866536333335,8379.583170666665,8689.166341333334,7730.566731333334,7420.9835606666675,7251.266926333335,0.9377214476438169,-10319165.0,-1
2018-09-25,7750.0,8018.25,7680.0,7793.049805,7999.450195,1159438.0,8397.680029300001,8266.43541370909,-966.7998040000011,11.044651215828765,-14.699642030562229,-387.8488800629584,-131.87414835300783,1760367.2749430456,262568.13365141186,32.0,96.0,-40.0,165.75,7830.433268333333,7980.866536666666,8168.683268333334,8319.116536666666,7642.616536666666,7492.183268333333,7304.366536666666,0.3342196747967469,-11478603.0,-1
2018-09-26,8075.0,8089.899901999999,7822.549805,7999.450195,7842.549805,754963.0,8325.705029300001,8194.02998929091,-719.7499999999991,28.02858150544789,-11.230896685393255,-430.58127549606616,-91.48354946251295,756793.415730337,285032.9192004539,28.000000000000004,92.0,-40.0,246.5,7970.633300666667,8118.716796333335,8237.983397666667,8386.066893333335,7851.366699333335,7703.283203666668,7584.016602333336,0.6616806651093192,-10723640.0,+1
2018-09-27,7850.0,7878.0,7510.200195,7842.549805,7553.049805,1594739.0,8246.019970700001,8106.183584872728,-796.8505859999996,24.008042345684487,-12.686756404668383,-459.41866905771894,-105.10222461327778,1330811.6217737435,332568.3147719671,24.0,88.0,-52.0,346.7500000000009,7743.583333333333,7976.966471666666,8111.383138333332,8344.766276666665,7609.166666666666,7375.783528333333,7241.366861666666,0.9036155144236676,-12318379.0,-1
2018-09-28,7620.0,7648.200195,7292.649901999999,7553.049805,7347.950195,1413254.0,8149.6199707000005,7980.189009290908,-964.0000000000009,18.391462918452646,-15.951045349323593,-498.00811659180545,-115.54919434899067,294997.4865862921,330860.5498544364,20.0,96.0,-56.0,799.500489,7497.966633999999,7703.283366,7853.516927000001,8058.833659000001,7347.7330729999985,7142.416340999998,6992.182779999997,0.7323855671805046,-13731633.0,-1
2018-10-01,7354.0,7485.0,7206.0,7347.950195,7463.950195,1034603.0,8035.0199707,7834.430868254545,-1145.999999999999,15.438919844651181,-16.58285161104718,-541.6152811202246,-111.87339103317737,690354.188172043,347201.169777964,16.0,96.0,-60.0,619.6494140000004,7346.316731666667,7486.633463333334,7625.316731666666,7765.633463333334,7207.633463333334,7067.316731666667,6928.633463333334,0.5087820609319009,-14766236.0,-1
2018-10-03,7400.0,7410.700195,7211.0,7463.950195,7246.0,1148091.0,7918.7449707000005,7730.599999945454,-1162.749999999999,23.45793781054735,-14.865909201248407,-569.0471891780471,-93.40840961574447,-1331629.444068827,270890.6873303825,12.0,96.0,-64.0,360.1499019999992,7361.8834633333345,7512.766926666669,7561.583658333335,7712.467121666669,7313.066731666669,7162.183268333334,7113.366536666668,1.2666497145884104,-13618145.0,+1
2018-10-04,7150.0,7288.0,7021.0,7246.0,7198.75,1104174.0,7789.5649902000005,7608.282732545455,-1291.7998050000006,19.45767297921836,-16.9050110452273,-597.2301974458478,-96.28722213550081,1124259.8390532644,309680.1942268772,8.0,92.0,-64.0,296.85009699999955,7185.0,7349.0,7452.0,7616.0,7082.0,6918.0,6815.0,0.8426966292134831,-14722319.0,-1
2018-10-05,7054.799805,7220.0,6801.850098000001,7198.75,6904.350098000001,1481376.0,7669.5249511,7500.861825236364,-1200.4003909999992,18.661622213435024,-17.45436577142193,-655.6150757340101,-92.8589605348461,-1471188.2313829786,228731.62942642914,4.0,96.0,-64.0,489.25,7073.533366000001,7345.216634,7491.683267999999,7763.3665359999995,6927.066732000001,6655.383464000001,6508.916830000002,0.9491809040290052,-16203695.0,-1
2018-10-08,6915.0,6989.0,6774.25,6904.350098000001,6889.75,1393849.0,7538.925,7361.7391246727275,-1305.999511,14.420249831850782,-20.87722243925124,-712.7950706886149,-95.96518614608256,345503.08779522544,234039.4229886472,0.0,96.0,-76.0,549.8999030000004,6889.2000326666675,7004.150065333335,7103.9500326666675,7218.900065333335,6789.400065333335,6674.4500326666675,6574.650065333335,0.6058211781140899,-17597544.0,-1
2018-10-09,6819.75,6940.0,6661.0,6889.75,6699.450195,1079041.0,7423.885009800001,7243.707306490909,-1150.3999019999992,14.23511673739749,-20.675297051446382,-748.6882936056172,-86.68868010385748,-156153.6895764608,216303.3724175059,0.0,96.0,-80.0,347.04980499999965,6830.25,6999.5,7109.25,7278.5,6720.5,6551.25,6441.5,0.8198924731182796,-18676585.0,-1
2018-10-10,6748.0,7050.0,6723.25,6699.450195,6985.850098000001,1162309.0,7314.525048800001,7111.991885618182,-1093.5996099999993,11.931381847455597,-22.32479911738746,-774.7498499394806,-75.01894199072414,530261.5702530339,230574.1995918481,0.0,96.0,-84.0,199.70019500000035,6824.233398333334,6925.2167966666675,7150.983398333334,7251.9667966666675,6598.4667966666675,6497.483398333334,6271.7167966666675,-0.07283796480489564,-19838894.0,-1
2018-10-11,6800.0,6950.0,6705.200195,6985.850098000001,6875.5,869569.0,7213.165039100001,7052.232803654546,-1013.6000969999996,31.251755092445563,-17.516830245397184,-787.098360667831,-61.172602395084596,328607.3553997653,235030.2521285716,0.0,92.0,-84.0,442.95019500000035,6880.350097666666,7055.5000003333325,7125.149902666665,7300.299805333332,6810.700195333333,6635.550292666667,6565.900390333333,1.1464465954129368,-18969325.0,+1
2018-10-12,6950.0,7326.0,6950.0,6875.5,7287.200195,1053651.0,7116.460058600001,6990.8391601818175,-967.0498049999997,28.47460237980377,-17.62095793824459,-779.6306740904047,-42.293378431255235,-482937.3021473906,202395.36329784602,0.0,88.0,-92.0,444.1499019999992,7050.5,7151.0,7426.5,7527.0,6775.0,6674.5,6399.0,-0.1981382978723404,-20022976.0,-1
2018-10-15,7320.0,7340.0,7126.049805,7287.200195,7182.0,682234.0,7089.875097600001,7021.882821345454,-265.8496099999993,48.2653803427686,-10.045172844664158,-807.2722849942893,-24.109620297102907,389908.38969424355,210918.68267950046,4.0,84.0,-96.0,424.5,7251.083333333333,7376.116861666666,7465.0335283333325,7590.067056666667,7162.166666666666,7037.133138333333,6948.216471666666,0.7532145039643475,-19340742.0,+1
2018-10-16,7214.0,7278.0,7123.799805,7182.0,7150.899901999999,637012.0,7073.2800781,7038.6328036,-165.95019500000035,44.62486489106805,-11.361672817009833,-823.5363959782017,-24.183958692668742,-113239.5292058486,196184.2185028937,0.0,80.0,-96.0,279.0,7194.599934999999,7265.400064999999,7348.800129999999,7419.600259999999,7111.199869999999,7040.399739999999,6956.999674999998,0.3774326939080733,-19977754.0,-1
2018-10-17,7237.649901999999,7245.0,6853.450195,7150.899901999999,6885.600098000001,1021019.0,7041.9750488,7052.745498854545,-313.05029300000115,43.50551822144614,-11.750866754881798,-802.7180411039171,-28.14922069860133,564410.0543465399,212921.7564957867,0.0,76.0,-96.0,326.75,7083.116699000001,7312.783203000002,7474.666504000002,7704.333008000001,6921.233398000002,6691.566894000001,6529.6835930000025,0.7596727241378631,-20998773.0,-1
2018-10-19,6830.0,6965.0,6715.5,6885.600098000001,6756.450195,903940.0,7005.9350586,7024.313689618182,-360.3999019999992,34.89110819924157,-12.757422573595568,-770.0621012018855,-40.73322804790644,448825.6863225106,223644.6623970014,0.0,72.0,-92.0,250.54980499999965,6855.3666993333345,6995.233398666669,7104.866699333335,7244.733398666669,6745.733398666669,6605.8666993333345,6496.233398666669,0.6817639198396825,-21902713.0,-1
2018-10-22,6818.0,6905.0,6722.049805,6756.450195,6812.200195,774016.0,6961.705078100001,6978.9528053272725,-442.29980499999965,31.39889594111885,-11.812509629703891,-760.9281767778048,-40.559366197883065,-282351.69482874806,200644.82797764914,8.0,68.0,-88.0,376.0,6794.5,6866.950195,6977.450195,7049.900390000001,6684.0,6611.549805,6501.049805,0.18803144757512083,-22676729.0,-1
2018-10-23,6779.0,6857.0,6666.0,6812.200195,6771.299805,734440.0,6952.490087800001,6951.770099309091,-92.14990300000045,34.65641896896663,-9.109122732196042,-727.5772597161485,-38.33809096637331,212007.55741935485,201161.31567954487,4.0,64.0,-80.0,464.5,6778.400065000001,6890.800130000001,6969.400065000002,7081.800130000001,6699.800130000001,6587.400065000001,6508.800130000001,0.7654460471204206,-21942289.0,+1
2018-10-24,6850.0,6885.0,6690.0,6771.299805,6768.299805,681526.0,6940.6450683,6918.826411527272,-118.45019500000035,33.31718880249829,-8.744893430357624,-697.1831810307885,-35.11035240703014,678115.246153846,222841.03979201315,0.0,60.0,-80.0,163.4003900000007,6782.099934999999,6874.199869999999,6977.099934999998,7069.199869999999,6679.199869999999,6587.099934999999,6484.199869999999,0.41692207692307515,-22623815.0,-1
2018-10-25,6700.0,6853.700195,6620.200195,6768.299805,6723.200195,2101936.0,6947.530029300001,6887.49090910909,68.8496099999993,33.20858036625705,-7.895321019196248,-627.1630178925061,-35.2536894783907,-644692.2641819032,183407.70779319873,0.0,56.00000000000001,-76.0,391.54980499999965,6747.400065000001,6874.599935000001,6980.900065000001,7108.099935000001,6641.099935000001,6513.900065000001,6407.599935000001,0.6342595717344723,-24725751.0,-1
2018-10-26,6750.0,6795.0,6500.0,6723.200195,6717.299805,874526.0,6921.265039,6846.703666509091,-262.64990300000045,31.431295933965956,-8.518157782074294,-545.1775266304176,-38.9091700548487,-2177662.825780016,76086.31990350706,0.0,96.0,-72.0,435.3999019999992,6672.733398333334,6845.4667966666675,6967.733398333334,7140.4667966666675,6550.4667966666675,6377.733398333334,6255.4667966666675,0.7566108305084758,-25600277.0,-1
2018-10-29,6722.0,6810.0,6691.049805,6717.299805,6798.700195,505428.0,6905.4450195,6809.61907850909,-158.20019500000035,31.17939478629539,-8.59964362657092,-438.56080802620545,-28.76730318178832,-234355.59017965035,61975.32399063626,0.0,96.0,-60.0,182.95019500000035,6739.4498699999995,6787.849934999999,6858.400065000001,6906.80013,6668.899739999999,6620.499674999999,6549.949544999999,0.22068059661440592,-26105705.0,-1
2018-10-30,6798.0,6868.950195,6675.200195,6798.700195,6697.0,771389.0,6856.5950195000005,6790.2109286,-488.5,38.9657648273573,-7.475484118215711,-374.06218986037857,-22.330379349604033,236079.59840425535,69889.15464580078,0.0,92.0,-60.0,191.0,6780.950195,6886.700195,6974.700195,7080.450195,6692.950195,6587.200195,6499.200195,0.6374193548387097,-25334316.0,+1
2018-10-31,6760.0,6760.0,6500.0,6697.0,6616.399902,1315746.0,6808.0950195000005,6761.1936523272725,-485.0,33.50158359954342,-8.879988951802236,-306.3394072441788,-39.1575702807846,-199680.77358490566,57635.97608985958,8.0,88.0,-60.0,195.0,6652.333333333333,6804.666666666666,6912.333333333332,7064.666666666666,6544.666666666666,6392.333333333333,6284.666666666666,0.7576923076923077,-26650062.0,-1
2018-11-01,6648.950195,6739.950195,6600.0,6616.399902,6711.75,842039.0,6754.645019500001,6726.339994600001,-534.4999999999991,29.69382252945583,-9.99309622980251,-307.826917338376,-38.34971629655566,-359870.98186328245,38658.38709198947,4.0,84.0,-56.00000000000001,233.5,6652.116699000001,6704.233398000002,6792.066894000001,6844.1835930000025,6564.283203000002,6512.166504000001,6424.333008000001,0.11718384529582163,-27492101.0,-1
2018-11-02,6769.799805,7159.0,6750.049805,6711.75,7135.450195,1834118.0,6737.2600097,6718.5409001454545,-173.8500980000008,39.136492488184,-8.67628780555172,-311.0149717291697,0.6083136110489266,371745.3826955075,53798.705073967576,0.0,80.0,-96.0,295.0,6873.599934999999,6997.150064999999,7282.550129999999,7406.100259999999,6588.199869999999,6464.649739999999,6179.249674999998,-0.0936539594998839,-25657983.0,+1
2018-11-05,7138.0,7254.700195,7060.049805,7135.450195,7177.25,1040315.0,6775.160009700001,6790.939115654545,379.0,63.95689933501065,-2.824883372462362,-288.75767785581047,57.45095850395535,-54810.13499188088,48861.939616429,0.0,76.0,-96.0,118.95019500000035,7150.066731666667,7240.083658333334,7344.7171216666675,7434.734048333335,7045.433268333333,6955.416341666666,6850.7828783333325,0.3873631591490797,-24617668.0,+1
2018-11-06,7195.0,7238.0,7050.0,7177.25,7075.0,667413.0,6811.664990200001,6864.046386618182,365.04980499999965,65.55583531351812,-1.4033988020615684,-238.17023200072526,56.472864981610435,-1401269.381146617,-17053.120418254963,0.0,72.0,-92.0,193.75,7155.083333333333,7260.166666666666,7343.083333333332,7448.166666666666,7072.166666666666,6967.083333333333,6884.166666666666,0.6768617021276596,-23950255.0,+1
2018-11-07,7140.0,7143.0,7090.0,7075.0,7127.899901999999,127507.0,6842.035009700001,6911.925479309091,303.70019500000035,58.26087549110291,-2.5112873667564317,-187.69100839844123,43.06686779301153,-638321.4156831709,-45292.58838484207,0.0,68.0,-80.0,298.70019500000035,7102.666666666667,7115.333333333334,7155.666666666668,7168.333333333334,7062.333333333334,7049.666666666667,7009.333333333334,-0.2830188679245283,-24077762.0,-1
2018-11-09,7130.0,7315.0,7040.850098000001,7127.899901999999,7283.5,986090.0,6877.995019400001,6963.900914272728,359.60009699999955,60.86081242183654,-2.5928505820399224,-153.7266376584039,53.901028753437586,367313.45755693584,-26537.768114761242,0.0,64.0,-80.0,139.95019500000035,7161.25,7281.649901999999,7435.399901999999,7555.799803999998,7007.5,6887.100098000001,6733.350098000001,0.31752629989996733,-23091672.0,+1
2018-11-12,7300.0,7352.5,7052.0,7283.5,7087.799805,687443.0,6934.024999900002,7037.629092563636,560.2998049999997,67.69117226029513,-0.9512649065968153,-100.38075103982374,69.38392894188098,-205541.3057288025,-34674.29255176312,28.000000000000004,60.0,-80.0,542.6000979999999,7229.333333333333,7406.666666666666,7529.833333333332,7707.166666666666,7106.166666666666,6928.833333333333,6805.666666666666,0.7703826955074875,-22404229.0,+1
2018-11-13,7049.950195,7168.75,7021.0,7087.799805,7150.450195,572295.0,6971.074999900002,7065.588148036362,370.5,54.01221320770505,-3.64927545322948,-61.64540802011925,38.465905633991675,322098.40748619725,-18457.35164094673,96.0,56.00000000000001,-76.0,542.9501950000003,7092.516601666666,7164.0332033333325,7240.266601666666,7311.7832033333325,7016.2832033333325,6944.766601666666,6868.5332033333325,0.4521137394247015,-22976524.0,-1
2018-11-14,7180.100098000001,7409.0,7180.100098000001,7150.450195,7369.049805,1112945.0,7006.249999900002,7098.201819872727,351.75,57.20653657452694,-3.5369330369357,-14.973078784931204,82.9727164965749,-675609.9936740485,-48327.92627881501,92.0,52.0,-72.0,188.0,7246.516764333333,7312.933430666666,7475.416666333333,7541.833332666665,7084.033528666667,7017.616862333334,6855.133626666668,-0.1295321786551073,-21863579.0,+1
2018-11-15,7378.899901999999,7515.100098000001,7333.549805,7369.049805,7478.299805,1048278.0,7073.454980400002,7164.165420799999,672.0498049999997,66.55837933622284,-1.9693678762425078,23.40499263946822,125.40678670071536,43880.67195362638,-44136.62635915858,96.0,48.0,-68.0,87.25,7405.899902666667,7478.250000333334,7587.450195666667,7659.8002933333355,7296.699707333333,7224.349609666666,7115.149414333332,0.19553810359314472,-20815301.0,+1
2018-11-16,7500.0,7544.049805,7302.549805,7478.299805,7341.200195,806420.0,7159.6449707,7237.773570727273,861.8999029999995,70.30104396152456,-0.8831371410818923,56.274472729065565,126.62225674310523,-674667.249109023,-72797.10921142517,96.0,44.0,-64.0,274.1499019999992,7441.633138333334,7580.7164716666675,7683.133138333334,7822.2164716666675,7339.2164716666675,7200.133138333334,7097.7164716666675,0.727743271221532,-20008881.0,+1
2018-11-19,7360.0,7449.0,7290.0,7341.200195,7411.649901999999,577408.0,7222.589990200001,7270.78361150909,629.4501950000003,60.497294006187225,-2.724623948973022,92.10500099873298,95.31267209024243,-245164.97214010716,-80632.0120718198,96.0,40.0,-31.999999999999996,300.5,7360.066731666667,7430.133463333334,7519.066731666666,7589.133463333334,7271.133463333334,7201.066731666667,7112.133463333334,0.3220138050314487,-20586289.0,-1
2018-11-20,7411.649901999999,7444.5,7311.649901999999,7411.649901999999,7333.950195,637243.0,7250.2099609,7305.158140927273,276.19970699999885,63.51409365834259,-1.7783615485162017,164.12490632887057,92.19740418200946,341531.58265873126,-61442.75776588564,92.0,36.0,39.99999999999999,262.5,7389.266601333333,7466.883300666666,7522.116699333334,7599.733398666667,7334.033202666666,7256.416503333332,7201.183104666665,0.7527280860568082,-19949046.0,+1
2018-11-21,7340.0,7466.0,7331.5,7333.950195,7424.5,701156.0,7265.879980399999,7320.383638036365,156.70019500000035,57.888126251028076,-2.8220040900048664,220.85045118325797,77.65161921418452,-160802.33173540083,-65959.10203722723,88.0,32.0,40.0,321.20019500000035,7377.150065000001,7422.800130000001,7511.650065000002,7557.300130000001,7288.300130000001,7242.650065000001,7153.800130000001,0.018217063197028618,-20650202.0,-1
2018-11-22,7393.950195,7480.0,7361.200195,7424.5,7411.100098000001,668352.0,7300.8299804,7349.2236416000005,349.5,62.370163699083015,-1.6057623270661205,251.37321442138546,79.52039013727077,-1127939.4629332847,-114230.9366234117,84.0,28.000000000000004,48.0,364.64990300000045,7421.900065000001,7482.599935000001,7540.699870000001,7601.399740000001,7363.800130000001,7303.100260000001,7245.000325000002,0.5328275160047597,-19981850.0,+1
2018-11-26,7425.0,7577.75,7387.299805,7411.100098000001,7554.700195,899481.0,7329.15,7369.27275389091,283.2001960000016,61.256925448794924,-2.2283122446932873,271.3462500764954,77.75258199948554,-486284.0966137683,-131142.44389570065,80.0,24.0,52.0,241.5,7458.716634333333,7530.133463666666,7649.166829333334,7720.583658666666,7339.683268666666,7268.2664393333325,7149.233073666665,0.12496859349501377,-20881331.0,-1
2018-11-27,7570.0,7657.799805,7500.75,7554.700195,7647.600098000001,783389.0,7356.2700195,7410.281880254546,271.20019500000035,68.2617231598616,-1.363967993064202,309.46661994702754,86.05294309855522,485537.6182631264,-103111.53197939032,96.0,20.0,56.0,188.29980499999965,7571.083333333333,7641.416666666666,7728.133138333333,7798.466471666666,7484.366861666666,7414.033528333333,7327.317056666667,0.34352283977684955,-20097942.0,+1
2018-11-28,7658.0,7680.5,7549.600098000001,7647.600098000001,7574.200195,686734.0,7412.2500488000005,7463.250985436364,559.8002930000011,72.03581233611317,-0.4339497724724553,329.4092816439879,85.70864975637845,587393.7014259875,-71724.93046096402,96.0,16.0,56.0,132.8500980000008,7625.900065333334,7702.2000326666675,7756.799967333334,7833.099934666667,7571.300130666668,7495.000163333335,7440.400228666669,0.748663662101142,-19411208.0,+1
2018-11-29,7613.0,7642.0,7531.0,7574.200195,7546.75,725583.0,7454.625048800001,7492.696466563637,423.75,64.99040379988224,-1.402094638264191,320.05314175594685,66.39553000289311,1931386.1231127789,19325.57197420618,96.0,12.0,56.0,134.5,7582.400065000001,7633.800130000001,7693.400065000002,7744.800130000001,7522.800130000001,7471.400065000001,7411.800130000001,0.3891909459459491,-20136791.0,-1
2018-11-30,7574.0,7727.0,7570.049805,7546.75,7661.600098000001,869715.0,7472.395068300002,7509.4464576909095,177.70019500000035,62.35860915982406,-2.363004719454641,342.21305655411925,61.49972851604209,-608405.791064621,-9207.671800285985,92.0,8.0,56.0,146.04980499999965,7614.599934999999,7659.150064999999,7771.550129999999,7816.100259999999,7502.199869999999,7457.649739999999,7345.249674999998,-0.14845349507211253,-21006506.0,-1
2018-12-03,7688.5,7800.0,7630.100098000001,7661.600098000001,7779.950195,772869.0,7490.725097600001,7543.847372181818,183.30029300000115,68.5139817764673,-1.7971679262433347,359.2780148591719,66.31976944890809,219459.18115271354,1186.2760612140023,96.0,4.0,56.0,190.45019500000035,7697.233398666667,7764.366699333334,7867.133300666666,7934.266601333333,7594.466797333334,7527.333496666668,7424.566895333335,0.18540328528264924,-20233637.0,+1
2018-12-04,7780.0,7784.950195,7701.0,7779.950195,7721.649901999999,551195.0,7534.600097600001,7596.4337535272725,438.75,73.63939825409958,-0.2603532658096306,351.2333812612587,68.20542149786594,901337.5803491131,42102.24443793672,96.0,0.0,76.0,246.69970699999885,7755.3001300000005,7809.600260000001,7839.250325000001,7893.550455000001,7725.650065000001,7671.349935,7641.69987,0.9404408768794404,-19682442.0,+1
2018-12-05,7696.700195,7739.899901999999,7520.0,7721.649901999999,7554.049805,704296.0,7565.6000976000005,7630.442808872727,310.0,67.40291023222359,-1.0174016101805063,324.36449740412536,43.789473258665076,-580337.9695639944,13809.50743784892,92.0,8.0,80.0,130.8999019999992,7660.516601333333,7801.033202666666,7880.416503333332,8020.933104666665,7581.133300666666,7440.616699333334,7361.233398666667,0.917007693800609,-20386738.0,-1
2018-12-06,7450.049805,7486.299805,7180.0,7554.049805,7209.700195,1339030.0,7587.610058600001,7628.342755672728,220.0996099999993,52.62073871258713,-3.1937436047266634,311.9987148168693,-4.243499867505471,-925956.5055461329,-28907.129515968467,88.0,4.0,84.0,116.6000980000008,7406.7832033333325,7633.566406666665,7713.083008333331,7939.866211666665,7327.266601666665,7100.483398333333,7020.966796666666,1.2211885182231836,-21725768.0,-1
2018-12-07,7244.0,7349.950195,7201.0,7209.700195,7313.950195,688881.0,7566.130078100001,7559.631871381818,-214.79980499999965,34.620830047332845,-7.665235748604073,286.6214099101062,-36.704513712528346,493456.1744298435,-5163.342972976993,84.0,0.0,84.0,156.95019500000035,7253.5501300000005,7306.100260000001,7402.500325000001,7455.050455000001,7157.150065000001,7104.599935,7008.19987,0.05841009472998896,-22414649.0,-1
2018-12-10,7200.0,7395.0,7170.0,7313.950195,7350.5,785024.0,7556.4150878,7513.7809835454555,-97.14990300000045,41.59923649418531,-6.311515452538627,267.6397460334874,-32.15939411960088,-596904.9787334475,-32060.6900529984,80.0,0.0,92.0,253.25,7292.983398333334,7415.9667966666675,7517.983398333334,7640.9667966666675,7190.9667966666675,7067.983398333334,6965.9667966666675,0.639778644444446,-21629625.0,+1
2018-12-11,7240.5,7346.0,7215.549805,7350.5,7305.350098000001,843166.0,7535.995068300002,7476.341876672728,-204.20019500000035,44.01655237716522,-5.836904298143098,231.66675863621276,-32.20658189781416,142425.8993968426,-24129.481441641987,76.0,0.0,96.0,123.35009699999955,7304.016601666666,7392.483398333333,7434.466796666667,7522.933593333333,7262.0332033333325,7173.566406666666,7131.583008333332,1.0344959239041382,-20786459.0,+1
2018-12-12,7340.0,7507.299805,7295.0,7305.350098000001,7471.850098000001,643037.0,7501.770068300001,7434.406427527273,-342.25,41.56435416273628,-6.423190520711586,201.37814252928092,-21.88888775481435,-944149.5588375147,-65948.57586872714,72.0,20.0,84.0,259.95019500000035,7369.216634333333,7443.433268666666,7581.5164393333325,7655.733073666665,7231.133463666666,7156.916829333333,7018.833658666666,0.048752272758803596,-21429496.0,-1
2018-12-13,7477.5,7700.0,7477.5,7471.850098000001,7670.5,881204.0,7491.5350586,7428.966432927272,-102.35009699999955,52.7622012540718,-4.261133644981161,180.72129593326554,18.330528820574905,1004710.3660771031,-17282.26032573482,68.0,16.0,84.0,541.6499019999992,7549.783366000001,7622.066732000001,7772.283366,7844.566732000001,7399.566732000001,7327.283366000001,7177.066732000001,-0.0253928179775245,-20548292.0,+1
2018-12-14,7684.0,7690.0,7545.950195,7670.5,7662.149901999999,676653.0,7503.9100586,7461.505513181819,123.75,62.62247997677251,-1.6815997922347745,153.43468864955685,39.859005158296654,1037603.626192091,30667.098152348215,64.0,12.0,84.0,353.04980499999965,7635.483398333334,7725.016601666667,7779.533203333333,7869.066406666667,7580.9667966666675,7491.433593333334,7436.916991666668,0.8646301534389439,-19871639.0,+1
2018-12-17,7691.899901999999,7800.0,7650.0,7662.149901999999,7734.049805,712296.0,7503.965039000001,7490.276393800001,0.549803999998403,61.99484628097322,-1.7900285417478352,128.41385334096958,58.14808706626506,33810.89506361962,30809.99801195146,60.0,8.0,80.0,225.0,7704.0499673333325,7758.099934666665,7854.0499673333325,7908.099934666665,7608.099934666665,7554.0499673333325,7458.099934666665,0.08099934666666134,-20583935.0,-1
2018-12-18,7710.0,7785.0,7655.0,7734.049805,7772.350098000001,658919.0,7499.375000000002,7532.109987618182,-45.9003900000007,65.436580502275,-0.8563848201532314,111.53751225338237,62.806841739154066,168943.76942132856,37088.805803286785,56.00000000000001,4.0,76.0,130.45019500000035,7724.683268333333,7794.366536666666,7854.683268333334,7924.366536666666,7664.366536666666,7594.683268333333,7534.366536666666,0.6080754230769204,-19925016.0,+1
2018-12-19,7781.0,7949.75,7781.0,7772.350098000001,7936.0,856358.0,7504.445019600002,7581.741823618182,50.7001960000016,67.25900048442227,-2.2596554724070845,88.76536180433231,96.35478027182839,-36981.20068197494,33721.98732668398,52.0,0.0,52.0,212.29980499999965,7834.3666993333345,7887.733398666669,8003.116699333335,8056.483398666669,7718.983398666669,7665.6166993333345,7550.233398666669,-0.05125867851851379,-19068658.0,+1
2018-12-20,7850.0,7919.0,7763.649901999999,7936.0,7807.049805,824303.0,7542.640039100001,7660.2063655090915,381.95019500000035,74.01409182281226,-0.17514250230869663,39.665754212401225,102.41803819965203,-480451.0436716619,10350.485917668237,96.0,68.0,52.0,394.6499019999992,7872.8833006666655,7982.116699333332,8028.233398666665,8137.466797333333,7826.766601333331,7717.533202666665,7671.41650333333,1.1094302496030606,-18244355.0,+1
2018-12-21,7830.0,7835.0,7515.0,7807.049805,7536.299805,1257227.0,7602.375000100002,7708.2808684,597.3496099999993,62.32330075751404,-1.8176632168901106,-3.2936027986761474,46.18070597493683,-20078.292552823033,8967.359623554998,92.0,64.0,52.0,218.1499019999992,7719.016601666666,7923.0332033333325,8039.016601666666,8243.033203333332,7603.0332033333325,7399.016601666666,7283.0332033333325,0.9126556406249989,-19501582.0,-1
2018-12-24,7560.0,7595.649901999999,7470.0,7536.299805,7529.149901999999,611297.0,7624.6099611,7696.2671965636355,222.3496099999993,45.07461876183604,-5.266378307804991,-17.980013694139416,-18.70846206641046,265304.24242424243,20619.036114495342,88.0,60.0,52.0,150.0,7533.983235666667,7597.966471333333,7659.633137666666,7723.616373333332,7472.316569333334,7408.333333666667,7346.666667333335,0.5276550474348963,-20112879.0,-1
2018-12-26,7488.0,7600.0,7402.0,7529.149901999999,7569.100098000001,594156.0,7642.474951300001,7678.910822181817,178.6499019999992,44.69768065169069,-5.357451173454775,22.517298166292676,-29.819614154441943,1030573.6786149972,66526.06531906364,84.0,56.00000000000001,52.00000000000001,130.0,7510.3833006666655,7618.766601333331,7708.383300666665,7816.766601333331,7420.766601333331,7312.3833006666655,7222.766601333331,0.6421712222222182,-20707035.0,-1
2018-12-27,7649.0,7668.850098000001,7479.299805,7569.100098000001,7499.950195,704523.0,7668.8499513,7665.569939763636,263.75,47.52674399264219,-4.84858009744291,44.466491486659834,-3.2577623051020956,435.4436078956507,63521.946150374184,80.0,52.0,52.0,215.70019500000035,7572.416667,7665.533529000001,7761.966960000001,7855.083822000002,7475.983236,7382.866373999999,7286.432942999999,0.4737544404639913,-20002512.0,+1
2018-12-28,7548.0,7580.0,7490.0,7499.950195,7505.549805,616845.0,7671.659960999999,7634.860893163635,28.10009699999955,43.1210970192171,-5.729386428048271,66.61264273170855,-24.133385379744826,-326440.0280042646,45796.40187061787,76.0,48.0,28.0,155.3500980000008,7523.316731666667,7556.633463333334,7613.316731666666,7646.633463333334,7466.633463333334,7433.316731666667,7376.633463333334,0.1105577222222261,-20619357.0,-1
2018-12-31,7550.0,7572.75,7443.100098000001,7505.549805,7465.5,547975.0,7655.1649415,7604.659046618182,-164.95019500000035,43.60951492163526,-5.658060631149894,92.96438022619259,-30.97658007345855,-1529972.9906542057,-25829.479607783258,72.0,44.0,28.0,421.0,7507.133301000001,7571.166504000001,7636.783203000001,7700.816406,7441.5166020000015,7377.483399000002,7311.866700000002,0.4816795542197883,-20071382.0,+1
2019-01-01,7449.75,7494.0,7395.0,7465.5,7476.799805,625360.0,7635.4999513,7570.1745118,-196.6499019999992,40.723640123074524,-6.168200490399006,103.32105444895933,-54.32579475044096,-205647.449051367,-34003.023673400705,68.0,40.0,28.0,337.04980499999965,7451.5,7508.0,7550.5,7607.0,7409.0,7352.5,7310.0,0.7121212121212122,-20696742.0,-1
2019-01-02,7445.0,7460.0,7244.0,7476.799805,7267.850098000001,891844.0,7609.774951300001,7541.319939745454,-257.25,41.97372463412737,-6.024267681431715,85.98626256429179,-75.9258434947973,-412148.8695652174,-51191.47121393784,64.0,36.0,27.999999999999993,198.0,7393.599934999999,7543.199869999999,7609.599934999998,7759.199869999999,7327.199869999999,7177.599934999999,7111.199869999999,1.0777768749999983,-19804898.0,+1
2019-01-03,7280.0,7350.0,7185.600098000001,7267.850098000001,7203.950195,715168.0,7559.3249513,7479.1517846,-504.5,28.948139759368374,-8.685793102569809,72.28456659065614,-126.77015366366338,344062.7263331136,-33225.37132543548,60.0,32.0,28.0,189.55029300000115,7267.816732,7350.033366,7432.2166339999985,7514.433267999999,7185.6334640000005,7103.416830000001,7021.233562000001,0.5003044344880473,-20520066.0,-1
2019-01-04,7239.0,7309.0,7161.200195,7203.950195,7234.5,774445.0,7486.1199708,7414.538192545455,-732.0498049999997,26.091087143079463,-9.499726841384577,50.87833125463112,-131.0829476819999,418865.0383576676,-12675.80724893078,56.00000000000001,28.000000000000004,28.0,90.0,7224.7167966666675,7288.233398333335,7372.516601666667,7436.033203333334,7140.433593333335,7076.916991666668,6992.633788333335,0.2892426008275187,-21294511.0,-1
2019-01-07,7310.0,7407.0,7300.0,7234.5,7362.049805,687845.0,7428.8649903,7368.7891069454545,-572.5498049999997,29.907249394097292,-9.110594529185109,17.382924548094707,-85.9348242480628,-118695.38494328619,-17494.878962310573,52.0,96.0,28.0,129.6499019999992,7313.833333333333,7327.666666666666,7420.833333333332,7434.666666666666,7220.666666666666,7206.833333333333,7113.666666666666,-0.6121495327102804,-20606666.0,+1
2019-01-08,7380.0,7454.799805,7322.100098000001,7362.049805,7439.5,516841.0,7411.439990299999,7356.640891436364,-174.25,43.86931366586903,-7.4859114734261105,-41.65050760215672,-59.734762648949314,97598.36579372773,-12263.3678370361,48.0,92.0,28.0,110.54980499999965,7379.649902666667,7437.199707333333,7512.349609666666,7569.899414333332,7304.500000333334,7246.950195666668,7171.8002933333355,0.3010534680381713,-20089825.0,+1
2019-01-09,7460.5,7529.0,7414.0,7439.5,7492.899901999999,740580.0,7402.475000099999,7361.7427113818185,-89.6499019999992,50.7436305957196,-6.499379040219087,-78.8020862577805,-29.29945727141805,160944.66835834886,-4390.275282700413,44.0,88.0,28.0,221.5,7460.833333333333,7507.666666666666,7575.833333333332,7622.666666666666,7392.666666666666,7345.833333333333,7277.666666666666,0.2217391304347826,-19349245.0,+1
2019-01-10,7500.0,7511.0,7360.149901999999,7492.899901999999,7391.600098000001,452699.0,7394.854980499999,7378.1836026363635,-76.2001960000016,55.116639992209066,-5.448850358056276,-72.37800729694573,-37.920675937143095,-434895.7810464484,-23958.70736287079,40.0,84.0,28.0,291.19970699999885,7454.683268,7549.216634,7605.5333660000015,7700.066732000001,7398.3665359999995,7303.833169999999,7247.516437999999,0.8800126865015314,-18896546.0,+1
2019-01-11,7382.700195,7400.0,7282.0,7391.600098000001,7320.5,488399.0,7384.0199708,7377.5918058181815,-108.35009699999955,46.148685430550024,-5.731642993795233,-71.51661808679819,-91.9763884850438,-137440.89083537296,-29116.988429802717,36.0,80.0,28.000000000000004,147.79980499999965,7357.8666993333345,7433.733398666669,7475.866699333335,7551.733398666669,7315.733398666669,7239.8666993333345,7197.733398666669,0.9288143898305152,-19384945.0,-1
2019-01-14,7330.0,7433.350098000001,7257.0,7320.5,7408.700195,424152.0,7365.5149903,7366.042720218182,-185.04980499999965,40.775635196280646,-4.6018097252947845,-89.57592540217229,-93.81902680139181,522734.13958644046,-4032.846247246188,32.0,76.0,-44.0,203.04980499999965,7336.9500326666675,7416.900065333335,7513.300130666668,7593.250163333336,7240.549967333334,7160.599934666667,7064.1998693333335,0.3600791874808015,-19809097.0,-1
2019-01-15,7430.0,7470.0,7317.0,7408.700195,7355.149901999999,491196.0,7359.835009800001,7373.894575618181,-56.79980499999965,49.235591993425295,-3.4366585815052484,-119.31019477589325,-48.070286492640655,1302275.717783925,55344.815754170726,28.000000000000004,72.0,-44.0,220.29980499999965,7398.566731666667,7480.133463333334,7551.566731666666,7633.133463333334,7327.133463333334,7245.566731666667,7174.133463333334,0.5993476797385644,-19317901.0,+1
2019-01-16,7349.5,7384.0,7291.100098000001,7355.149901999999,7310.25,424769.0,7347.670019500001,7373.042737836364,-121.64990300000045,44.756742988563644,-4.144074082561859,-146.61590426590374,-65.87759919452608,-128048.75538550003,47008.744338731136,24.0,68.0,-44.0,166.95019500000035,7343.416666666667,7395.733235333333,7436.316568666667,7488.633137333332,7302.833333333334,7250.516764666668,7209.933431333335,0.6894496401083281,-19742670.0,-1
2019-01-17,7339.0,7398.950195,7307.5,7310.25,7336.25,462725.0,7351.910009700001,7366.239097927273,42.3999019999992,41.136436234584885,-3.6058013634540838,-169.1572935761269,-52.09656361930573,-134536.1560329069,38756.70341274758,20.0,64.0,-44.0,150.8500980000008,7338.900065000001,7370.300130000001,7430.350260000001,7461.750325000002,7278.849935000001,7247.44987,7187.399740000001,0.030071012970502572,-20205395.0,-1
2019-01-18,7345.0,7379.950195,7318.0,7336.25,7357.950195,334555.0,7365.139990200001,7363.391823436363,132.29980499999965,44.15464854280895,-3.1644087640073595,-197.32596585781084,-35.69389167902339,2279915.7796699265,140627.5705153467,16.0,60.0,-44.0,210.8999019999992,7344.733398333334,7371.4667966666675,7406.683593333335,7433.416991666668,7309.516601666667,7282.783203333333,7247.566406666667,0.2945914859509304,-19870840.0,+1
2019-01-21,7358.0,7380.0,7161.0,7357.950195,7208.399901999999,654537.0,7377.485009700001,7362.0845879454555,123.45019500000035,46.7824716621387,-2.3021508075370076,-186.64600054847415,-46.588020157279836,813034.6869250186,171191.53035215,12.0,56.00000000000001,-44.0,176.3500980000008,7299.650065000001,7438.300130000001,7518.650065000002,7657.300130000001,7219.300130000001,7080.650065000001,7000.300130000001,0.8993159589041112,-19216303.0,+1
2019-01-22,7180.0,7180.0,7054.5,7208.399901999999,7068.850098000001,896521.0,7362.1200194,7331.341841090909,-153.64990300000045,34.04391684527681,-4.314940753701222,-157.12475159797395,-108.11741165098444,-285050.3593677264,150453.26263761017,8.0,96.0,-44.0,153.0,7147.6333006666655,7240.766601333331,7273.133300666665,7366.266601333331,7115.266601333331,7022.1333006666655,6989.766601333331,1.226294039840631,-20112824.0,-1
2019-01-23,7050.0,7132.25,7025.0,7068.850098000001,7045.399901999999,702474.0,7325.055029200001,7278.0200372,-370.6499019999992,26.32583992314035,-6.193134616419909,-134.17567816974406,-126.08653065541601,-307207.69535661995,129650.4918196906,4.0,96.0,-44.0,117.60009699999955,7075.3666993333345,7125.733398666669,7182.616699333335,7232.983398666669,7018.483398666669,6968.1166993333345,6911.233398666669,0.40885872261073003,-20815298.0,-1
2019-01-24,7059.899901999999,7098.0,7014.399901999999,7045.399901999999,7040.600098000001,520703.0,7280.305029200001,7227.173650436364,-447.5,25.217344055908725,-6.508749636608354,-124.43720056075654,-122.86212847435282,-109298.05377349677,118789.19429272754,0.0,96.0,-44.0,91.45019500000035,7052.599934666666,7090.7999673333325,7136.200032666666,7174.400065333333,7007.199869333332,6968.999836666665,6923.599771333331,0.37081296244413137,-21336001.0,-1
2019-01-25,7054.0,7133.0,6410.0,7040.600098000001,6513.399902,3062762.0,7245.205029200001,7183.590935672726,-351.0,24.969042939961284,-6.573349959623139,-123.94394831218142,-192.64948255890087,-2650659.7994682305,-7094.850878225201,0.0,96.0,-44.0,69.70019500000035,6861.2000326666675,7312.400065333335,7584.2000326666675,8035.400065333335,6589.400065333335,6138.2000326666675,5866.400065333335,0.8721993056708172,-24398763.0,-1
2019-01-28,6512.5,6610.0,6317.700195,6513.399902,6511.049805,2398091.0,7164.495019400001,7050.535458,-807.1000979999999,11.107726589261759,-13.668911144010764,-135.90266417001567,-303.2400540610314,119376.78750190978,-1346.1400427645149,0.0,96.0,-44.00000000000001,219.0,6480.366699000001,6643.033203000002,6772.666504000002,6935.333008000001,6350.733398000002,6188.066894000001,6058.4335930000025,0.6695170631400181,-26796854.0,-1
2019-01-29,6480.0,6619.149902,6447.399902,6511.049805,6526.950195,1101399.0,7074.729980400001,6931.7272372,-897.6503900000007,11.07610034705381,-13.70054098250337,-145.50648367579106,-210.97157519884263,-654157.1298107144,-31019.366850398623,8.0,96.0,-88.0,303.45019500000035,6525.866536333334,6604.333170666668,6697.616536333334,6776.083170666668,6432.583170666668,6354.116536333334,6260.833170666668,0.37059623289664945,-27898253.0,-1
2019-01-30,6559.0,6588.0,6508.0,6526.950195,6548.25,583773.0,6991.910009700001,6832.130912581818,-828.1997069999989,13.009685086181221,-13.276440974096056,-165.01401036201605,-160.30581657292794,-370385.7732412228,-46445.1125954361,4.0,92.0,-92.0,183.3999019999992,6540.983398333334,6573.9667966666675,6620.983398333334,6653.9667966666675,6493.9667966666675,6460.983398333334,6413.9667966666675,0.23687743750000437,-27314480.0,+1
2019-01-31,6575.0,6660.049805,6460.049805,6548.25,6641.149902,926270.0,6915.7100097,6751.465456272727,-762.0,15.838307182295736,-12.505087505087506,-200.57231626481553,-127.93644177242183,-707571.0634034278,-76496.29217761756,0.0,88.0,-96.0,83.6000980000008,6556.1165366666655,6652.183268333331,6756.1165366666655,6852.183268333331,6452.183268333331,6356.1165366666655,6252.183268333331,0.44100097500000174,-26388210.0,+1
2019-02-01,6679.0,7204.0,6652.549805,6641.149902,6962.299805,2545419.0,6846.1999999,6701.54543669091,-695.1000979999999,27.673820221565506,-11.24474424094424,-228.58970852429957,-55.87391824742713,590849.9309899481,-46162.37294272819,0.0,84.0,-96.0,723.0,6832.566569,7012.583333,7384.016763999999,7564.033528,6461.133137999999,6281.116373999999,5909.682942999999,-0.020672588573478576,-23842791.0,+1
2019-02-04,6975.0,7039.0,6851.649901999999,6962.299805,6988.200195,658776.0,6806.6349609,6722.654492163636,-395.6503900000007,53.66485607802334,-6.887806199972871,-250.67200386883724,-27.26329024231196,23554.097310418605,-42993.44247667606,0.0,80.0,-96.0,722.8999030000004,6950.983235666667,7050.316569333334,7138.333333666667,7237.666667333335,6862.966471333333,6763.633137666666,6675.616373333332,0.5906049913035005,-23184015.0,+1
2019-02-05,6995.0,7125.0,6985.399901999999,6988.200195,7093.600098000001,681498.0,6784.6149902,6755.666352909091,-220.19970699999885,55.164193775623076,-5.626750717851987,-278.7676120538881,-7.300392045879832,-10422.030551385827,-41512.92375279923,24.0,76.0,-88.0,171.75,7032.866698999999,7080.333495999999,7172.466796999999,7219.933594,6940.7333979999985,6893.266600999998,6801.133299999998,0.02005939136232649,-22502517.0,+1
2019-02-06,7120.0,7220.0,7067.0,7093.600098000001,7183.399901999999,567827.0,6787.0899902,6811.845463418183,24.75,61.07798601352779,-4.182906579405773,-313.69783954188824,14.99117275509077,1149115.9766645127,12606.571720714992,20.0,72.0,-88.0,80.0,7126.8666993333345,7186.733398666669,7279.866699333335,7339.733398666669,7033.733398666669,6973.8666993333345,6880.733398666669,0.17385684967320783,-21934690.0,+1
2019-02-07,7201.0,7320.0,7185.100098000001,7183.399901999999,7302.549805,690174.0,6800.889990200001,6883.901811018181,138.0,65.54553819790851,-2.700179892871869,-328.5187706346351,38.37060668276015,369622.3403152693,28834.561202285655,16.0,68.0,-88.0,200.0,7229.5,7273.899901999999,7364.399901999999,7408.799803999998,7139.0,7094.600098000001,7004.100098000001,-0.012603389437611356,-21244516.0,+1
2019-02-08,7270.0,7300.0,7100.0,7302.549805,7134.25,576159.0,6827.0849609,6975.112686436363,261.94970699999885,70.69520599437763,-1.0637301881609718,-335.86607214662035,39.62844875465048,127772.39697362985,33331.735555528576,12.0,64.0,-84.0,655.75,7234.183268333333,7368.366536666666,7434.183268333334,7568.366536666666,7168.366536666666,7034.183268333333,6968.366536666666,1.0127490249999982,-20668357.0,+1
2019-02-11,7150.0,7209.950195,7051.100098000001,7134.25,7177.899901999999,502244.0,6889.1699707,7030.960875363637,620.8500979999999,56.84736908769094,-2.5723583991136962,-349.1145992561778,20.815929834721032,-5110.772923995939,31584.348806459275,8.0,60.0,-80.0,397.8500979999999,7131.766764333333,7212.433430666666,7290.616861333334,7371.283527666666,7053.5833336666665,6972.916667333334,6894.733236666667,0.5234488588319807,-21170601.0,-1
2019-02-12,7193.0,7230.0,7127.950195,7177.899901999999,7162.5,494592.0,6955.8549804,7083.457226509092,666.8500969999996,59.23686930323179,-1.9678728430965349,-360.0549291680345,32.9944154683894,-532367.9550103819,5950.153178421018,4.0,56.00000000000001,-52.0,162.70019500000035,7178.616699000001,7229.283203000002,7280.666504000002,7331.333008000001,7127.233398000002,7076.566894000001,7025.1835930000025,0.4894640122046193,-20676009.0,+1
2019-02-14,7036.700195,7111.200195,6990.0,7162.5,7017.5,622311.0,7019.4099609,7121.029048254545,635.5498049999997,57.93101853042034,-2.181138346489406,-289.0645016256285,17.81176208087418,461687.85361363774,26665.503198203616,0.0,52.0,-52.0,231.79980499999965,7087.900065000001,7185.800130000001,7209.100260000001,7307.000325000002,7064.599935000001,6966.69987,6943.399740000001,1.4232650368260504,-21298320.0,-1
2019-02-15,7027.399901999999,7058.700195,6900.0,7017.5,6930.049805,768798.0,7066.334960900001,7120.681782636363,469.25,46.73753617976895,-4.189170475003462,-210.53692327941917,1.716542832525282,-987616.9633098547,-19438.24527943544,0.0,48.0,-52.0,226.3999019999992,6992.066731666667,7084.133463333334,7150.766926666667,7242.833658333334,6925.433268333333,6833.366536666666,6766.733073333333,0.7403897644864251,-22067118.0,-1
2019-02-18,6964.700195,6997.799805,6817.0,6930.049805,6842.700195,509963.0,7095.2249512,7095.902663381818,288.89990299999954,41.19802842995054,-5.400224276416013,-126.87214627568392,-11.389697509320657,-130136.16448564499,-24469.968879717697,8.0,44.0,-52.0,200.0,6914.9498699999995,7012.899739999999,7095.749674999999,7193.699544999999,6832.099934999999,6734.150065,6651.30013,0.6252761445179649,-22577081.0,-1
2019-02-19,6855.0,6915.899901999999,6771.0,6842.700195,6804.549805,493861.0,7083.264990199999,7049.989071345454,-119.5996099999993,36.24669806104268,-6.609885126713746,-48.45430641490202,-28.31303522343593,257920.1988433995,-11634.052165030542,4.0,40.0,-52.0,251.44970699999885,6843.200032333333,6915.400064666666,6988.0999343333315,7060.299966666666,6770.500162666667,6698.300130333334,6625.600260666668,0.4948256969835683,-23070942.0,-1
2019-02-20,6842.0,6888.0,6804.399901999999,6804.549805,6849.899901999999,534284.0,7064.8999512,6999.313583127274,-183.6503900000007,34.176737849822715,-7.138210704888524,17.313499629976832,-32.8757056213801,-457217.7475740603,-31887.85650180464,0.0,36.0,-52.00000000000001,102.04980499999965,6832.316569,6860.233236,6915.9166669999995,6943.833334000001,6776.633137999999,6748.716470999999,6693.033039999998,0.0017930959841751394,-23605226.0,-1
2019-02-21,6868.950195,6879.649901999999,6715.0,6849.899901999999,6801.549805,722938.0,7040.529931599999,6960.222665090909,-243.7001960000016,38.958070353926374,-6.510180002769711,48.87273979540987,-43.228975989225404,414351.66527196654,-11604.241875724118,4.0,32.0,-52.0,187.8999019999992,6814.849934666666,6914.699869333332,6979.499836666666,7079.349771333331,6750.0499673333325,6650.200032666667,6585.400065333333,0.8193135881732857,-22882288.0,+1
2019-02-22,6827.0,6939.0,6819.049805,6801.549805,6912.399901999999,764535.0,7002.3449218999995,6916.771732981818,-381.85009699999955,35.76239146520763,-7.179756197202608,73.61600155957876,-27.83789684576712,-738129.3104637023,-44628.10862972315,0.0,28.000000000000004,-48.0,262.5,6853.1998699999995,6887.349934999999,6973.150065000001,7007.30013,6767.399739999999,6733.249674999999,6647.449544999999,-0.1458938853746753,-23646823.0,-1
2019-02-25,6948.0,6984.899901999999,6870.049805,6912.399901999999,6924.899901999999,495728.0,6963.329931599999,6900.418093,-390.14990300000045,47.2162664046206,-5.644648912892962,84.2243246756525,12.436811318208148,-579696.2189709055,-68949.38637250419,4.0,24.0,-36.0,200.5,6922.449869666666,6974.849934333332,7037.299966666665,7089.700031333332,6859.999837333333,6807.5997726666665,6745.149740333333,0.368742370326424,-23151095.0,+1
2019-02-26,6885.0,6975.0,6812.600098000001,6924.899901999999,6904.299805,673415.0,6942.3949218,6893.4308148909095,-209.3500980000008,48.41307461290532,-5.471542694917613,83.75398467399918,-15.621146522136312,332914.4954108767,-50682.846291441405,0.0,20.0,-36.0,159.04980499999965,6904.166666666667,6995.733235333333,7066.566568666667,7158.133137333332,6833.333333333334,6741.766764666668,6670.933431333335,0.6915016734431216,-22477680.0,+1
2019-02-27,6943.0,7048.0,6853.200195,6904.299805,6968.5,961829.0,6915.034912099999,6886.504430018181,-273.60009699999955,46.41200612539465,-5.756823085445234,65.69585250668206,-7.921443906789241,84614.39262854548,-44532.97179507835,48.0,16.0,-36.0,83.6000980000008,6935.166666666667,7017.133138333334,7129.9664716666675,7211.932943333333,6822.333333333334,6740.366861666667,6627.533528333334,0.26231858907661326,-23439509.0,-1
2019-02-28,7010.0,7040.0,6801.0,6968.5,6829.700195,1031563.0,6895.634912099999,6896.225355090909,-194.0,53.34627395111417,-4.867746849466833,60.7979995285059,-22.910048497045615,539674.0201556712,-17978.10852458972,44.0,12.0,-28.0,164.6499019999992,6936.5,7072.0,7175.5,7311.0,6833.0,6697.5,6594.0,0.700836820083682,-22407946.0,+1
2019-03-01,6876.799805,6950.0,6827.25,6829.700195,6935.149901999999,768822.0,6876.854931600001,6884.237224709091,-187.79980499999965,40.32829897910659,-6.531034647965556,35.858319955455045,-102.33287916663964,-792698.4843880489,-53192.67106383789,40.0,8.0,-28.000000000000004,119.95019500000035,6868.983398333334,6910.7167966666675,6991.733398333334,7033.4667966666675,6787.9667966666675,6746.233398333334,6665.2167966666675,0.01996085539715152,-23176768.0,-1
2019-03-05,6950.0,7158.149901999999,6894.450195,6935.149901999999,7117.75,838538.0,6877.364941300001,6894.836310236364,5.1000969999995505,50.84364247070377,-4.134765082036191,11.341342830004578,6.571729385158294,-1000712.0577500979,-96261.73409503156,36.0,4.0,-20.0,183.35009699999955,6995.9166663333335,7097.383137666667,7259.6163733333315,7361.082844666666,6833.683430666668,6732.216959333335,6569.983723666669,0.15434111574495996,-22338230.0,+1
2019-03-06,7137.850098000001,7144.899901999999,7010.0,7117.75,7056.899901999999,557197.0,6904.8699218,6938.542684545455,275.04980499999965,63.64427414225488,-1.5741130276258588,9.211614384789755,105.50569113989059,214937.60254107628,-82116.30970248119,32.0,0.0,-20.0,162.3999019999992,7090.8833006666655,7171.766601333331,7225.783202666666,7306.66650333333,7036.866699333332,6955.983398666666,6901.966797333333,0.79874038752082,-21781033.0,+1
2019-03-07,7078.0,7092.5,7002.0,7056.899901999999,7029.049805,396771.0,6930.104931500002,6966.184499127274,252.35009699999955,57.85164648977982,-1.4343086831363907,-15.691497896413239,64.84536697810591,-76289.49129509089,-81851.45432032709,28.000000000000004,0.0,32.0,194.79980499999965,7050.466633999999,7098.933267999999,7140.966634,7189.433267999999,7008.433267999999,6959.966633999999,6917.933267999999,0.6066287513812066,-22177804.0,-1
2019-03-08,6975.0,7025.0,6951.0,7029.049805,6967.700195,486432.0,6948.0199218,6984.174476127273,179.14990300000045,55.19852530477356,-1.8288334826750585,-29.843422147477213,13.67197724388501,-394543.23874794436,-96064.71724885516,24.0,4.0,32.0,239.0,7001.683268333333,7052.366536666666,7075.683268333334,7126.366536666666,6978.366536666666,6927.683268333333,6904.366536666666,1.05472709459459,-22664236.0,-1
2019-03-11,6980.0,7121.600098000001,6975.0,6967.700195,7081.899901999999,720905.0,6964.6349608,6987.752707618181,166.1503900000007,49.435942452062626,-2.697912774823504,-38.95055129728735,51.84378031755777,1592082.957957863,-19330.732012186087,20.0,0.0,32.0,141.25,7021.433431,7067.866862000001,7168.033529,7214.466960000002,6921.266764,6874.833333,6774.666665999999,-0.049793998091321956,-23385141.0,-1
2019-03-12,7097.0,7232.0,7096.0,7081.899901999999,7157.200195,828847.0,6981.584960800001,7009.073606018181,169.5,58.69720575121704,-2.10430531333241,-49.69165472806071,205.94572631147165,942755.7495080102,24400.47169327742,16.0,0.0,32.0,328.44970699999885,7136.6333006666655,7177.266601333331,7272.633300666665,7313.266601333331,7041.266601333331,7000.6333006666655,6905.266601333331,-0.10367719117647646,-22556294.0,+1
2019-03-13,7177.0,7202.950195,7050.0,7157.200195,7091.049805,534982.0,7004.8149901,7041.003648599999,232.30029300000115,63.748818630199786,-1.048644399270989,-45.155351389055795,189.04857927646503,680313.432611432,54214.6971895572,12.0,48.0,32.0,209.75,7136.7167966666675,7223.433593333335,7289.666991666669,7376.383788333335,7070.483398333335,6983.766601666667,6917.533203333334,0.7008830227382195,-22021312.0,+1
2019-03-14,7103.0,7148.0,7047.25,7091.049805,7086.299805,584482.0,7023.489990100001,7056.682705854545,186.75,56.717290001818554,-1.976029650918272,-36.112093934563745,133.76121711097895,918392.4580373525,93495.50450082065,8.0,44.0,28.000000000000004,115.75,7095.433268333333,7143.616536666666,7196.183268333334,7244.366536666666,7042.866536666666,6994.683268333333,6942.116536666666,0.43473751861041837,-22605794.0,-1
2019-03-15,7109.0,7157.0,7060.0,7086.299805,7084.0,861945.0,7035.2699706,7068.102672199999,117.79980499999965,56.20365891000376,-2.0426215477358802,-26.214331828673494,134.87047695794615,-57268.48379409844,86642.59594196068,4.0,40.0,20.0,105.8999019999992,7101.099934999999,7142.199869999999,7198.099934999998,7239.199869999999,7045.199869999999,7004.099934999999,6948.199869999999,0.27113201030927475,-23467739.0,-1
2019-03-18,7077.450195,7077.450195,6776.600098000001,7084.0,6909.100098000001,1525653.0,7060.699951099999,7076.962677545454,254.29980499999965,55.92074513473514,-2.07486331136969,-5.639316019384751,7.282568954757333,-263633.74515790166,70720.94407378511,0.0,36.0,20.0,146.6000980000008,6979.350097666666,7182.100097333332,7280.200194666666,7482.950194333332,6881.2500003333325,6678.500000666667,6580.399903333333,1.0217709918172293,-24993392.0,-1
2019-03-19,6900.0,6901.950195,6809.25,6909.100098000001,6825.200195,816763.0,7058.0949707,7049.399067890909,-26.049803999998403,38.787824979155424,-4.526845675031533,8.677153353611175,-93.5207334069029,199078.69688850443,76555.3873835451,0.0,32.0,16.0,264.29980499999965,6873.433431,6937.616862000001,6966.133626000001,7030.317057000001,6844.916667,6780.733236,6752.216472,1.0771293199545096,-25810155.0,-1
2019-03-20,6860.0,6860.0,6650.0,6825.200195,6673.549805,1017560.0,7028.8399902,7007.054563218182,-292.54980499999965,33.16385218211563,-5.703067503154348,48.90696660555295,-169.44509820793203,-691958.261113865,41622.94881548097,76.0,28.000000000000004,-36.0,152.95019500000035,6778.400065000001,6906.800130000001,6988.400065000002,7116.800130000001,6696.800130000001,6568.400065000001,6486.800130000001,0.8342866428571445,-26827715.0,-1
2019-03-22,6567.0,6716.299805,6532.350098,6673.549805,6552.700195,1715983.0,6990.5049805,6942.456347727272,-383.35009699999955,25.463700487702823,-7.82910689751858,62.080325722699854,-243.1886589725856,-2536768.911764706,-75576.68121089126,72.0,96.0,-36.0,109.95019500000035,6640.733236,6749.116374,6824.682942999999,6933.066081,6565.166667,6456.783529,6381.216960000001,0.7675995211017104,-28543698.0,-1
2019-03-25,6515.0,6621.0,6491.200195,6552.700195,6522.600098,1093184.0,6942.8700195,6862.8554776363635,-476.3496099999993,20.98380246678606,-9.523339478480299,49.08329270468312,-241.9183790522141,-36115.34661920221,-73782.9841839963,68.0,96.0,-36.0,97.0,6554.9667966666675,6618.733398333335,6684.766601666667,6748.533203333334,6488.933593333335,6425.166991666668,6359.133788333335,0.47380656696672363,-29636882.0,-1
2019-03-26,6558.0,6600.0,6480.0,6522.600098,6585.700195,909087.0,6898.360009800001,6786.442764636364,-445.10009700000046,19.97389867736686,-9.945323173980094,40.59762443110958,-206.7767534835993,-1584022.401494104,-142430.23042536486,64.0,96.0,-36.0,309.69970699999885,6534.200032666667,6588.400065333333,6654.2000326666675,6708.400065333333,6468.400065333333,6414.200032666667,6348.400065333333,0.3550008166666657,-30545969.0,-1
2019-03-27,6628.0,6640.0,6500.0,6585.700195,6518.0,887601.0,6848.7400391,6729.595525581819,-496.19970699999885,28.31862638394462,-9.06070103743165,26.516612447021544,-144.60871325109474,-1100064.8085316012,-185959.07488473927,60.0,96.0,-32.0,274.75,6575.233398333334,6650.4667966666675,6715.233398333334,6790.4667966666675,6510.4667966666675,6435.233398333334,6370.4667966666675,0.6121442500000025,-29658368.0,+1
2019-03-28,6535.0,6625.0,6501.200195,6518.0,6596.25,949713.0,6784.820019600001,6669.460973018182,-639.2001950000003,25.080957561776742,-10.009813542688912,11.885562302901235,-133.7650895905242,250448.62844195077,-166122.36109716241,56.00000000000001,92.0,48.0,259.1000980000008,6548.066731666667,6594.933268333333,6671.8665366666655,6718.733073333333,6471.133463333334,6424.266926666667,6347.333658333334,0.13570138499006276,-30608081.0,-1
2019-04-01,6730.799805,6870.0,6700.0,6596.25,6840.700195,1142386.0,6735.3400391000005,6635.175514909091,-494.79980499999965,34.99299097476229,-8.91279966353568,-24.541518342143718,-55.389361026886064,97972.06160951778,-154118.06915594966,52.0,88.0,-24.0,292.85009700000046,6722.083333333333,6744.166666666666,6892.083333333332,6914.166666666666,6574.166666666666,6552.083333333333,6404.166666666666,-0.6102941176470589,-29465695.0,+1
2019-04-02,6859.450195,6900.700195,6785.5,6840.700195,6889.700195,866805.0,6710.7800781000005,6654.3319068909095,-245.5996099999993,55.984057131203635,-5.4857676293284685,-71.49379249105732,-11.51189470917599,-268434.46225219016,-159314.26884214242,48.0,84.0,-28.0,182.3496099999993,6842.3001300000005,6899.100260000001,6957.500325000001,7014.300455000001,6783.900065000001,6727.099935,6668.69987,0.4791675482840995,-28598890.0,+1
2019-04-03,6896.0,7098.0,6896.0,6889.700195,7072.899901999999,1491021.0,6691.3500976,6686.862837236365,-194.29980499999965,59.04289961948068,-4.7988196411047195,-109.05906854482782,26.034626036533407,552003.836752468,-126981.62767875103,44.0,80.0,-32.0,120.0,6961.233398333334,7026.4667966666675,7163.233398333334,7228.4667966666675,6824.4667966666675,6759.233398333334,6622.4667966666675,-0.031187153465344807,-27107869.0,+1
2019-04-04,7120.0,7170.0,7061.649901999999,7072.899901999999,7113.100098000001,1388375.0,6707.730078,6756.2355289454545,163.7998039999984,68.48955784972748,-1.830675742793565,-147.67758384308672,72.48839053846358,23512.49670921391,-120140.98566111625,40.0,76.0,-36.0,140.0,7101.516601333333,7141.383300666666,7209.866699333334,7249.733398666667,7033.033202666666,6993.166503333332,6924.683104666665,0.10383008606046593,-25719494.0,+1
2019-04-05,7095.0,7143.950195,7050.0,7113.100098000001,7107.700195,729603.0,6736.5200683,6829.939168945453,287.89990300000045,70.22818181425532,-0.8046938481119955,-181.050560753195,71.19773526154046,-675558.8257792392,-145387.25112103097,36.0,72.0,-35.99999999999999,123.79980499999965,7102.350097666666,7154.700195333333,7196.300292666667,7248.650390333333,7060.7500003333325,7008.399902666666,6966.799805333332,0.6716334968756644,-24989891.0,+1
2019-04-08,7107.0,7150.0,7044.700195,7107.700195,7129.450195,498374.0,6779.9351073,6897.426464709091,434.1503900000007,69.63269783644229,-0.8810607410550085,-191.6384283744701,67.66280995822449,4622.469023952281,-138568.6274780772,32.0,68.0,-36.0,352.0,7100.8001300000005,7156.900065000001,7206.099934999999,7262.19987,7051.600260000001,6995.500325000001,6946.300455000001,0.5982917062382044,-25488265.0,-1
2019-04-09,7134.0,7235.0,7080.0,7129.450195,7216.549805,741669.0,6837.610107300001,6960.974662472728,576.75,70.78402882194518,-1.4791172225336273,-191.74123315312954,78.32854920892437,-679510.08,-163156.8753199828,28.000000000000004,64.0,-36.0,304.45019500000035,7148.150065000001,7216.300130000001,7303.150065000002,7371.300130000001,7061.300130000001,6993.150065000001,6906.300130000001,0.3190335161290345,-24746596.0,+1
2019-04-10,7218.950195,7218.950195,7144.600098000001,7216.549805,7186.350098000001,590107.0,6907.005078,7029.8727893272735,693.9497069999998,75.13927431040094,-0.25855093890135017,-163.50580333028302,83.02494635858899,-381302.69833873474,-173072.5945481079,96.0,60.0,-36.0,257.29980499999965,7193.366699333333,7242.133300666665,7267.716796333332,7316.483397666664,7167.783203666665,7119.016602333333,7093.4331066666655,0.9677150387577744,-24156489.0,+1
2019-04-11,7186.950195,7220.0,7150.0,7186.350098000001,7187.850098000001,609539.0,6967.0700683,7080.662792963636,600.6499030000004,70.91029068477033,-0.6817531109865359,-124.5943430584839,75.56167303465195,652792.8584699229,-135533.25577456102,92.0,56.00000000000001,-36.0,280.29980499999965,7185.4500326666675,7220.900065333335,7255.4500326666675,7290.900065333335,7150.900065333335,7115.4500326666675,7080.900065333335,0.5192871142857257,-24766028.0,-1
2019-04-12,7188.899901999999,7357.0,7161.049805,7187.850098000001,7342.850098000001,929935.0,7034.0550781,7120.804616545455,669.8500980000008,71.00381967284525,-2.3305304767153374,-70.31163230625862,85.60796652016053,616011.6127622965,-101372.12538652202,88.0,52.0,-36.0,93.95019500000035,7235.299967666666,7309.550130333332,7431.250162666666,7505.5003253333325,7113.599935333332,7039.349772666666,6917.6497403333315,0.13677094324913072,-23836093.0,+1
2019-04-15,7351.049805,7389.950195,7295.0,7342.850098000001,7352.5,585205.0,7108.7150879,7176.949165618183,746.6000980000008,79.03915474814372,-0.6460076634771135,-4.04975806748007,110.70563950971842,475654.2063819616,-75143.65576068182,96.0,48.0,-36.0,105.29980499999965,7342.600097666666,7390.200195333333,7437.550292666667,7485.150390333333,7295.2500003333325,7247.649902666666,7200.299805333332,0.5039494442323222,-23250888.0,+1
2019-04-16,7369.899901999999,7475.0,7350.0,7352.5,7458.549805,707823.0,7159.8950684,7221.273695090908,511.79980499999965,79.44827464269778,-1.6607917570498916,74.52982521608556,119.156509998226,257621.9288736376,-60017.947368212735,96.0,44.0,-36.0,155.0,7392.5,7435.0,7517.5,7560.0,7310.0,7267.5,7185.0,0.02,-22543065.0,+1
2019-04-18,7533.100098000001,7539.350098000001,7434.049805,7458.549805,7447.450195,713163.0,7216.7800294,7275.574556290911,568.8496099999993,83.52568220919508,-1.085974341741266,150.47283074793813,132.7738580405791,2537710.3639913825,58060.612239041686,96.0,40.0,36.0,89.5,7477.316569333333,7520.5833336666665,7582.616862333335,7625.883626666668,7415.283040666665,7372.016276333332,7309.982747666664,0.232667918597337,-21829902.0,+1
2019-04-22,7422.0,7424.899901999999,7300.0,7447.450195,7321.25,479609.0,7254.235058700001,7317.514586400001,374.55029300000115,81.57125837169603,-1.23515562829098,194.79915276999236,98.77033375923453,4177966.366207522,245329.0556012455,96.0,36.0,35.99999999999999,70.0,7390.783365666666,7481.566731333332,7515.683267666665,7606.466633333332,7356.666829333333,7265.883463666667,7231.766927333334,1.1805469230872678,-22309511.0,-1
2019-04-23,7327.0,7388.899901999999,7006.0,7321.25,7048.899901999999,952628.0,7275.050048900001,7329.699121181819,208.1499019999992,62.41239362491672,-2.9313149936133662,240.828714398177,54.68194858132731,707405.6344926188,266332.5364599443,92.0,32.0,36.0,195.95019500000035,7238.716633999999,7471.433267999999,7621.616535999998,7854.333169999998,7088.533366,6855.816732,6705.6334640000005,0.823322226914544,-23262139.0,-1
2019-04-24,7065.0,7101.950195,6910.0,7048.899901999999,7016.700195,1063510.0,7269.170019600001,7288.580912654545,-58.80029300000115,39.38051318493626,-6.591762343707949,262.7393781312867,-3.1350330499944876,-670643.7285714286,223742.70623124554,88.0,28.000000000000004,48.0,202.10009699999955,7020.283365666667,7130.566731333334,7212.2335606666675,7322.516926333335,6938.616536333334,6828.333170666667,6746.666341333334,0.7236246985839162,-24325649.0,-1
2019-04-25,7014.75,7144.950195,6865.0,7016.700195,6905.25,3075510.0,7257.895019600001,7242.677308181819,-112.75,37.49303704518448,-7.024533739890695,275.4156940469484,-11.373039261593366,252335.30050087898,225042.36960713795,84.0,24.0,52.0,132.1499019999992,7008.8834633333345,7152.766926666669,7288.833658333335,7432.717121666669,6872.816731666669,6728.933268333334,6592.866536666668,0.5418827981170014,-27401159.0,-1
2019-04-26,6805.0,6886.850098000001,6750.0,6905.25,6842.850098000001,1999920.0,7226.765039100001,7178.560031890909,-311.29980499999965,31.46932333209206,-8.522449745616806,286.5078923451192,-54.539826212785684,-256135.3424234097,203170.65542393125,80.0,20.0,56.0,186.8500980000008,6847.3666993333345,6944.733398666669,6984.216797333334,7081.58349666667,6807.883300666668,6710.516601333334,6671.033202666667,1.1344529691166103,-29401079.0,-1
2019-04-30,6700.0,6750.0,6630.0,6842.850098000001,6666.399902,1640025.0,7192.4150391,7108.757315327273,-343.5,28.510188386036248,-9.361118641274988,293.26133635272527,-82.20758142214541,681963.051948052,224933.94617502764,76.0,16.0,60.0,158.54980499999965,6740.9500326666675,6851.900065333335,6860.9500326666675,6971.900065333335,6731.900065333335,6620.9500326666675,6611.900065333335,1.7737508166666733,-31041104.0,-1
2019-05-02,6550.0,6709.950195,6525.0,6666.399902,6683.25,1337101.0,7140.270019500001,7013.118199490909,-521.4501960000007,21.816699339473317,-11.732649465441868,271.96847316970707,-105.80682799467174,162960.1061538478,222116.9534467922,72.0,12.0,60.0,441.45019500000035,6633.783365666667,6742.566731333334,6818.7335606666675,6927.516926333335,6557.616536333334,6448.833170666667,6372.666341333334,0.7645296183656354,-32378205.0,-1
2019-05-03,6675.0,6780.0,6675.0,6683.25,6710.0,795679.0,7074.310009700001,6930.02365049091,-659.6000980000008,23.788226351123257,-11.506180310387872,247.86800991156724,-82.1855738271909,67708.49461518157,215098.38713626444,68.0,8.0,60.0,411.25,6712.75,6750.5,6817.75,6855.5,6645.5,6607.75,6540.5,0.07857142857142857,-31582526.0,+1
2019-05-06,6659.0,6732.0,6639.299805,6710.0,6709.649902,480317.0,7010.060009700001,6863.785466909091,-642.5,27.153102270893655,-11.146654217560727,212.4272939100083,-82.38685887451301,362426.9224168366,221795.13873992683,64.0,4.0,60.0,279.95019500000035,6693.766601666666,6748.233398333333,6786.466796666667,6840.933593333333,6655.5332033333325,6601.066406666666,6562.833008333332,0.7626757958815522,-31102209.0,+1
2019-05-07,6744.899901999999,6785.25,6680.0,6709.649902,6702.0,586684.0,6935.1700194000005,6809.165447327274,-748.8999029999995,27.13501009826436,-11.151359614422281,144.36831268888,-71.54788461150673,132743.71296296298,217747.34665915574,60.0,0.0,60.0,266.70019500000035,6724.966634,6769.933268000001,6830.216634,6875.183268000001,6664.683268000001,6619.716634,6559.433268000001,0.28170928266033357,-31688893.0,-1
2019-05-08,6679.0,6693.0,6616.0,6702.0,6650.149902,552749.0,6860.6249999,6766.770898345456,-745.4501950000003,26.686698204928362,-11.25417603971464,67.39526619228309,-77.4164742916497,170158.7648437263,215584.22930390897,56.00000000000001,0.0,60.0,275.25,6670.333333333333,6724.666666666666,6747.333333333332,6801.666666666666,6647.666666666666,6593.333333333333,6570.666666666666,1.1168831168831168,-32241642.0,-1
2019-05-09,6637.0,6678.0,6600.0,6650.149902,6624.950195,570000.0,6793.5149901,6728.502698727274,-671.1000979999999,23.633095699595458,-11.951053166692004,-28.27720538145695,-77.49857205906554,121685.74515576796,211316.11638808437,52.0,0.0,60.0,317.8500980000008,6642.716634,6685.433268000001,6720.716634,6763.433268000001,6607.433268000001,6564.716634,6529.433268000001,0.6429474615384629,-32811642.0,-1
2019-05-10,6623.0,6664.899902,6575.0,6624.950195,6631.600098,608669.0,6751.1200194,6697.854554163637,-423.94970699999885,22.208071244630148,-12.289742968490087,-135.43941550460386,-77.58134241125687,-809637.4770833305,164909.1348666564,48.0,76.0,60.0,113.60009799999989,6621.616699000001,6668.233398000002,6711.516601000001,6758.133300000002,6578.333496000002,6531.716797000001,6488.433594000002,0.5556201273723334,-33420311.0,-1
2019-05-13,6626.0,6659.299805,6500.0,6631.600098,6543.75,555672.0,6712.610009700001,6676.123659363636,-385.10009700000046,23.6105706807095,-12.200366757526748,-228.4143307986351,-78.32495406570398,-2644688.328638594,37200.15925278126,44.0,72.0,60.0,92.70019500000035,6596.966634333333,6693.933268666666,6756.2664393333325,6853.233073666665,6534.633463666666,6437.666829333333,6375.333658666666,0.8261158762874831,-32864639.0,+1
2019-05-14,6511.0,6612.0,6450.0,6543.75,6576.200195,843313.0,6676.4600097,6645.421839418182,-361.5,18.520758365709042,-12.027872531529429,-277.0691584496426,-87.15956983063006,650087.5217259033,65058.67572883228,40.0,96.0,60.0,105.25,6535.25,6620.5,6697.25,6782.5,6458.5,6373.25,6296.5,0.5787037037037037,-33707952.0,-1
2019-05-15,6590.0,6640.0,6463.299805,6576.200195,6493.75,612357.0,6649.7950194000005,6627.192782200001,-266.64990300000045,25.377069991389803,-11.148297204698695,-321.736836965827,-74.98132476098054,-150238.58170901428,55272.436754384704,36.0,96.0,56.00000000000001,93.64990200000011,6559.833333333333,6656.366861666666,6736.5335283333325,6833.067056666667,6479.666666666666,6383.133138333333,6302.966471666666,0.6389375518233043,-33095595.0,+1
2019-05-16,6506.0,6527.299805,6441.399902,6493.75,6479.649902,555991.0,6632.5300292,6598.820960490908,-172.6499020000001,20.35542480573345,-9.242191286877247,-345.3033192824669,-80.33894908266956,-495114.73921755,30254.837846569466,32.0,92.0,52.0,102.0,6487.483235666667,6533.566569333333,6573.383138666665,6619.466472333333,6447.6666663333335,6401.583332666667,6361.766763333334,0.6094313983101957,-33651586.0,-1
2019-05-17,6497.0,6790.0,6485.0,6479.649902,6706.850098,782196.0,6612.1700194000005,6571.024573727273,-203.6000979999999,19.59048360401404,-9.442307631866537,-360.7814562124513,-47.729497255882265,-637326.9088960344,-89.78700536709624,28.000000000000004,96.0,-28.0,89.89990200000011,6584.883300666667,6684.766601333335,6889.883300666668,6989.766601333335,6379.766601333335,6279.883300666667,6074.766601333335,-0.01754130491803242,-34433782.0,-1
2019-05-20,6875.0,7150.0,6860.0,6706.850098,7084.600098000001,1286198.0,6611.8550292,6588.239133472727,-3.149902000000111,52.66371062633939,-6.2849227343639225,-347.890149483459,18.942356169222737,321281.1201217085,14517.98150040908,24.0,92.0,-28.0,159.29980499999965,6905.616699333333,6951.233398666665,7195.616699333332,7241.233398666665,6661.233398666665,6615.616699333333,6371.233398666665,-0.5281031103448279,-33147584.0,+1
2019-05-21,7105.0,7137.75,6818.0,7084.600098000001,6875.350098000001,973836.0,6649.3500488,6674.192782345455,374.9501960000007,73.54132553969961,-0.9275266203375295,-325.7744238110272,44.64827469980001,-228696.95496973972,3462.7571154023067,20.0,88.0,-56.0,181.6000979999999,7013.4500326666675,7208.900065333335,7333.2000326666675,7528.650065333335,6889.150065333335,6693.7000326666675,6569.400065333335,0.8337766942924184,-32173748.0,+1
2019-05-22,6877.200195,6930.549805,6841.0,6875.350098000001,6899.799805,645280.0,6666.685058600001,6715.2837003818195,173.3500980000008,57.368989051184265,-3.8951907814494287,-305.65717018961186,24.844165017137186,1272484.2882567395,61145.553985463135,16.0,84.0,-60.0,176.70019500000035,6882.299967666666,6923.599935333332,6971.849772666665,7013.1497403333315,6834.050130333332,6792.750162666666,6744.5003253333325,0.3835865192559708,-32819028.0,-1
2019-05-23,6996.0,7049.100098000001,6830.0,6899.799805,6929.25,1364516.0,6691.6500489,6757.668199727272,249.64990299999954,58.59652496720331,-3.5484356119699383,-285.78037282817877,39.266816220091904,326866.7296525062,73223.78924305602,12.0,80.0,-60.0,134.80029300000024,6926.299967666667,7022.599935333334,7145.4000656666685,7241.700033333334,6803.499837333333,6707.199869666666,6584.399739333332,0.31857496019923914,-31454512.0,+1
2019-05-24,6964.950195,7120.0,6886.75,6929.25,7093.149901999999,1002742.0,6722.080029400001,6800.868190836363,304.29980499999965,60.189710431056334,-3.1307615941001274,-262.895411759072,52.994783263762976,,73223.78924305602,8.0,76.0,-68.0,305.0,6978.666666666667,7070.583333333334,7211.916666666668,7303.833333333334,6837.333333333334,6745.416666666667,6604.083333333334,0.18220793140407288,-30451770.0,+1
2019-05-27,7095.0,7193.899901999999,6900.049805,7093.149901999999,7068.450195,1022289.0,6768.235009800001,6868.3354404,461.5498039999993,68.07763904760822,-1.4200341286224394,-217.22353565644335,73.33286561409531,,73223.78924305602,4.0,72.0,-68.0,670.3500979999999,7062.366536333332,7224.6832676666645,7356.2166333333325,7518.533364666664,6930.833170666665,6768.5164393333325,6636.983073666665,0.657138108754818,-29429481.0,+1
2019-05-28,7067.0,7130.0,7031.5,7068.450195,7054.649901999999,915732.0,6820.705029300001,6922.920019527272,524.7001950000003,65.8102694528529,-1.768167398170558,-164.82852781247584,74.3091724204105,,73223.78924305602,0.0,68.0,-68.0,430.8999020000001,7076.650065000001,7121.800130000001,7175.150065000002,7220.300130000001,7023.300130000001,6978.150065000001,6924.800130000001,0.3751288832487345,-30345213.0,-1
2019-05-29,7001.0,7009.0,6870.0,7054.649901999999,6891.450195,768022.0,6868.550000000001,6965.455450927272,478.44970699999885,64.42692713365575,-1.962677443282131,-103.38074449394026,49.54032063615681,,73223.78924305602,0.0,64.0,-68.0,243.6000980000008,6977.8833006666655,7085.766601333331,7116.883300666665,7224.766601333331,6946.766601333331,6838.8833006666655,6807.766601333331,1.3284165611510734,-31113235.0,-1
2019-05-30,6890.0,6921.0,6825.0,6891.450195,6867.700195,850376.0,6908.320019500001,6969.619122745455,397.70019500000035,50.06663251493533,-4.262917182450178,-30.163773455891715,24.793902840183637,,73223.78924305602,0.0,60.0,-68.0,219.1000980000008,6879.150065000001,6933.300130000001,6975.150065000002,7029.300130000001,6837.300130000001,6783.150065000001,6741.300130000001,0.6921895312500036,-31963611.0,-1
,,,,,,,,,,,,,,527051.267159527,98948.2301428198,84.0,56.00000000000001,-68.0,233.25,,,,,,,,,-31963611.0,-1
,,,,,,,,,,,,,,-945541.873996577,40400.49837639779,80.0,52.0,-68.0,293.85009699999955,,,,,,,,,-31963611.0,-1
,,,,,,,,,,,,,,-245610.88973229736,24536.594890903732,76.0,48.0,-68.0,98.5,,,,,,,,,-31963611.0,-1
,,,,,,,,,,,,,,140487.5524124904,30904.180312097622,72.0,44.0,-64.0,198.45019500000035,,,,,,,,,-31963611.0,-1
,,,,,,,,,,,,,,50023.02259212607,31944.27339100265,68.0,40.0,-60.0,229.6499019999992,,,,,,,,,-31963611.0,-1
