date,open,high,low,close,Adj Close,volume,SMA,WMA,MOM,RSI,WilliamK,MACD,CCI,acc_dist,AD21,Arronup,AroonDown,AroonOscillator,ATR,Pivot_Point,Resistance_1,Resistance_2,Resistance_3,Support_1,Support_2,Support_3,SO%k,On_Balance_Volume,y
2013-07-18,344.25,352.18798799999996,342.35598799999997,343.85598799999997,215.925308,13078696.0,324.3325012,332.0276733818182,43.29397599999993,74.84529195507432,-7.321734716650977,7.9998849929810945,160.04213649106495,-17592335.859881252,-11865291.340873232,84.0,20.0,64.0,3.338012000000049,346.1333213333333,349.91065466666663,355.9653213333333,359.7426546666666,340.07865466666664,336.3013213333333,330.24665466666664,0.15256305939788456,133552152.0,+1
2013-07-19,350.375,358.125,350.375,350.093994,219.52534500000002,16402840.0,328.4919006,336.71158116363637,41.59399400000001,78.2129854763981,-4.96064246961503,10.564225207190304,157.5895125181149,-2037491.6593503149,-11309476.463449461,80.0,16.0,64.0,11.087981999999954,352.86466466666667,355.35432933333334,360.6146646666666,363.10432933333334,347.60432933333334,345.11466466666667,339.85432933333334,-0.03625883870967623,149954992.0,+1
2013-07-22,352.774994,361.86199999999997,352.75,355.931,221.78453100000002,6751136.0,333.38250120000004,341.7005083272727,48.90600599999999,80.9644890282771,-2.751329171022154,13.25491610059862,141.67151666913202,-12187928.305356521,-11358612.18788398,76.0,12.0,64.0,14.269012000000032,356.8476666666666,360.9453333333332,365.95966666666664,370.0573333333332,351.83333333333326,347.73566666666665,342.7213333333333,0.349100087796312,156706128.0,+1
2013-07-23,361.25,364.64401200000003,361.25,359.593994,223.72734100000002,6168480.0,338.4899994,346.4662342909091,51.07498199999998,82.55937074456752,-1.9010471803896798,15.37353926570654,129.20178896304967,-321166.0198672313,-10747641.575594712,72.0,8.0,64.0,11.768005999999957,361.82933533333335,362.4086706666667,365.2233473333333,365.8026826666667,359.01465866666666,358.4353233333333,355.62064666666663,-0.4879199012849616,162874608.0,+1
2013-07-24,360.0,365.875,360.0,362.743988,224.23986800000003,4875280.0,343.5368988,350.8760504,50.46899400000001,83.89801387689484,-1.1732129274004677,18.30262064296079,107.4757188962847,-4717773.731416568,-10417134.143229065,96.0,4.0,64.0,8.713012000000049,362.872996,365.745992,368.74799600000006,371.620992,359.870992,356.997996,353.995992,0.46706178723404285,167749888.0,+1
2013-07-25,363.625,368.169006,362.625,363.575012,224.756744,7177688.0,348.62999880000007,354.5193437090909,50.93099999999998,84.26563762517273,-1.7067321636578057,21.600705092857368,93.63620757248114,-3421378.0964917047,-10037239.45760293,96.0,0.0,92.0,6.281005999999991,364.7896726666667,366.95434533333344,370.33367866666674,372.49835133333346,361.4103393333334,359.2456666666667,355.8663333333334,0.17135840040577355,174927576.0,+1
2013-07-26,366.25,369.125,362.825012,364.41299399999997,224.602554,6899640.0,353.4668976,357.3889792,48.368987999999945,84.67278933936387,-1.7443798241554949,24.71981576716348,80.72025987694312,-3515011.7655115924,-9686165.730714437,96.0,8.0,96.0,5.544006000000024,365.45433533333335,368.0836586666667,371.75432333333333,374.38364666666666,361.7836706666667,359.15434733333336,355.4836826666667,0.2520611150370378,181827216.0,+1
2013-07-29,363.75,368.0,363.75,364.16299399999997,225.211304,4362952.0,354.8306976,359.33372399999996,13.637999999999977,83.92521769282419,-1.8369295696436947,27.62666336554497,68.37762696613294,-9293119.549427828,-9665184.794484314,96.0,4.0,88.0,6.299987999999985,365.3043313333333,366.85866266666665,369.55433133333327,371.10866266666665,362.60866266666665,361.0543313333333,358.35866266666665,0.09717505882352218,177464264.0,-1
2013-07-30,366.375,371.625,366.375,365.149994,227.87077299999999,6336208.0,357.06199640000006,361.20995970909087,22.31298799999996,84.54673641796812,-2.3750595139844135,30.870081249701684,63.20309485764684,-1565855.2301119475,-9236239.609980516,92.0,0.0,92.0,4.25,367.71666466666665,369.0583293333333,372.9666646666667,374.3083293333333,363.8083293333333,362.46666466666665,358.5583293333333,-0.23333447619047765,183800472.0,+1
2013-07-31,371.125,373.950012,366.024994,369.46200600000003,228.946381,11807328.0,359.8981964,363.4645069090909,28.362000000000023,87.06735526772368,-1.632298892207353,29.40468926295972,57.69711133763837,-2853446.062780747,-8900721.576752992,96.0,0.0,92.0,7.462006000000031,369.81233733333335,373.5996806666667,377.7373553333333,381.5246986666667,365.6746626666667,361.8873193333333,357.74964466666665,0.43369138089024256,195607800.0,+1
2013-08-01,373.5,374.39401200000003,369.593994,371.205994,229.33187900000001,8690632.0,362.633197,365.52047010909087,27.350006000000008,87.98215299411942,-1.157620667511121,29.0368526627679,52.6856282194683,-15933355.089171847,-9267788.721048497,96.0,16.0,96.0,8.800018000000023,371.73133333333334,373.86867266666667,376.53135133333336,378.6686906666667,369.06865466666665,366.9313153333333,364.2686366666666,0.3358320739630474,204298432.0,+1
2013-08-02,373.125,377.5,372.63800000000003,371.830994,231.964844,11962296.0,364.80689700000005,367.19279683636364,21.736999999999966,88.3236823677067,-2.0355497307001884,29.2525254463568,51.4932462114225,-1162186.2908323694,-8847550.667427147,96.0,12.0,80.0,4.932006000000001,373.98966466666667,375.3413293333333,378.8516646666666,380.2033293333333,370.47932933333334,369.1276646666667,365.6173293333334,-0.16598231180585432,216260728.0,+1
2013-08-05,374.850006,378.125,374.56201200000004,376.100006,231.98402400000003,8502784.0,366.8237975999999,369.2460893818182,20.169006000000024,90.46031834921348,-0.7254792655620215,30.010319254133435,50.65110999616213,9060147.669740912,-7925014.982659384,96.0,8.0,84.0,6.294006000000024,376.26233933333333,377.9626666666666,379.8253273333333,381.5256546666666,374.39967866666666,372.69935133333337,370.8366906666667,0.4316584843956774,224763512.0,+1
2013-08-06,376.0,376.5,368.881012,376.131012,230.31134,10031832.0,368.47749939999994,370.9383101818181,16.53701799999999,90.47492529110791,-0.7143709807433951,30.197401004769915,39.45781274018399,2605883.90068285,-7385772.285952168,96.0,4.0,88.0,6.294006000000024,373.83734133333337,378.79367066666674,381.4563293333334,386.41265866666674,371.17468266666674,366.21835333333337,363.55569466666674,0.9515699460348275,234795344.0,+1
2013-08-07,371.875,375.350006,368.906006,373.419006,228.461029,6503608.0,369.5450012,371.8367659272727,10.675018000000023,78.36502647764127,-1.6859808329601347,29.240131007748573,31.116082458775086,1320587.2775613223,-6942505.835647741,92.0,0.0,92.0,7.618988000000002,372.5583393333334,376.21067266666677,379.0023393333334,382.6546726666668,369.76667266666675,366.11433933333336,363.32267266666673,0.7003414028553727,228291736.0,-1
2013-08-08,367.5,372.25,367.5,370.419006,228.55354300000002,5765368.0,370.2294006,371.99567589090907,6.843994000000009,66.9305746231505,-2.7607681146439678,27.362236104526914,20.404690590001366,-9593091.773387713,-7076722.3771233205,88.0,0.0,92.0,7.225006000000008,370.0563353333334,372.61267066666676,374.80633533333344,377.36267066666676,367.86267066666676,365.3063353333334,363.11267066666676,0.6145275789473735,222526368.0,-1
2013-08-12,372.0,377.5,371.375,370.569,231.702759,7594376.0,370.84500120000007,372.05742123636367,6.156006000000048,67.20661956379871,-2.707030900134342,25.02890998314325,25.469274676018355,-10959200.448696587,-7272304.185922758,84.0,0.0,88.0,5.919006000000024,373.14799999999997,374.92099999999994,379.2729999999999,381.04599999999994,368.79599999999994,367.02299999999997,362.67099999999994,-0.13159183673469113,230120744.0,+1
2013-08-13,376.01300000000003,386.75,376.0,375.674988,237.73162799999997,10334312.0,371.9962006,372.9356006545455,11.511994000000016,75.3038459039899,-3.8488312771503095,23.16064934651172,39.72038981602385,5235626.413112136,-6645296.299139761,80.0,0.0,84.0,7.080993999999976,379.474996,382.94999199999995,390.2249959999999,393.69999199999995,372.19999199999995,368.724996,361.44999199999995,-0.03023367441860606,240455056.0,+1
2013-08-14,383.75,386.86199999999997,380.319,385.450012,236.65596000000002,9211208.0,374.0262024,375.3817481818182,20.300018000000023,84.01984307967113,-0.49050864650421083,21.313177550497016,49.80212170639648,22016656.253333993,-5215190.958260868,96.0,0.0,80.0,16.180999999999983,384.21033733333337,388.1016746666667,390.75333733333326,394.6446746666667,381.5586746666668,377.6673373333334,375.0156746666668,0.7841986856182237,249666264.0,+1
2013-08-16,377.5,379.993988,370.955994,383.705994,229.621155,12087616.0,375.4506012,377.1417102909091,14.243987999999945,78.3288196449235,-1.096360756195674,19.55769871090257,29.45653005789408,-1460432.3435789659,-5028673.356542033,96.0,0.0,96.0,11.187011999999982,378.21865866666667,385.48132333333336,387.25665266666664,394.5193173333334,376.44332933333334,369.18066466666664,367.4053353333333,1.4107112706647031,237578648.0,-1
2013-08-19,373.76300000000003,378.368988,368.868988,372.299988,231.67189,5259328.0,375.56000059999997,376.56887152727273,1.0939940000000092,51.834290500544135,-5.05867811659753,17.619136751266296,11.26220994897777,1750311.2792568086,-4693342.598694912,92.0,0.0,96.0,14.49401800000004,373.17932133333335,377.4896546666667,382.67932133333335,386.9896546666667,367.9896546666667,363.67932133333335,358.4896546666667,0.36115789473684035,232319320.0,-1
2013-08-20,377.5,377.625,372.81201200000004,375.625,231.79895,10362056.0,375.93940119999996,376.5806896,3.7940060000000244,56.75449470312505,-3.9036065892684575,15.150999524268798,16.317554589457426,9979929.047861042,-3970411.4541032137,88.0,8.0,92.0,14.837005999999974,375.35400400000003,377.895996,380.166992,382.708984,373.08300800000006,370.54101600000007,368.2700200000001,0.5844577214819534,242681376.0,+1
2013-08-21,374.350006,374.350006,365.26300000000003,375.830994,228.10643,7526584.0,375.91249999999997,376.5609791999999,-0.269012000000032,57.06799330949015,-3.832046605665212,12.59111353553044,0.9346336522568589,-12554517.654349804,-4391731.18606786,84.0,4.0,80.0,5.325012000000015,371.81466666666665,378.3663333333333,380.9016726666666,387.45333933333325,369.2793273333333,362.7276606666667,360.1923213333333,1.1629786532549855,250207960.0,+1
2013-08-22,373.625,379.556,370.5,369.843994,232.843765,10965816.0,375.2837982,375.4576144727273,-6.287017999999989,45.90755200921356,-5.911862628620644,11.888674919566824,5.21622412616169,5571323.836193564,-3904497.8624402448,80.0,0.0,80.0,10.361999999999966,373.299998,376.09999600000003,382.355998,385.155996,367.04399600000005,364.24399800000003,357.98799600000007,-0.07243882508833834,239242144.0,-1
2013-08-23,375.625,377.493988,372.78799399999997,377.524994,231.34005699999997,5498864.0,375.6943969999999,375.8651046181818,4.105987999999968,58.05153723144817,-3.24357018293487,10.270816692241453,16.346019912885776,-7673426.008840482,-4088179.950580973,76.0,0.0,80.0,9.055999999999983,375.9356586666666,379.0833233333332,380.64165266666663,383.78931733333326,374.3773293333332,371.22966466666657,369.67133533333316,1.0065886186850197,244741008.0,+1
2013-08-26,377.493988,381.23098799999997,376.06201200000004,375.08700600000003,233.652939,5571544.0,376.16119699999996,375.7546698909091,4.668000000000006,53.6410781475785,-4.090499614398544,8.409776914027702,24.09560833218212,-8950890.981103422,-4324393.427923397,72.0,0.0,76.0,7.649993999999992,377.46000200000003,378.857992,382.628978,384.02696799999995,373.6890160000001,372.2910260000001,368.52004000000017,-0.18862652873606317,239169464.0,-1
2013-08-27,379.0,385.0,378.98699999999997,378.83700600000003,235.607468,8525552.0,376.9879976,376.24118061818183,8.268006000000014,59.14936440538941,-2.7877920670320977,7.1255246522623,46.614498682575814,-12842311.767722672,-4736876.32690805,68.0,0.0,72.0,5.16897599999993,380.94133533333337,382.8956706666668,386.95433533333346,388.9086706666668,376.88267066666674,374.92833533333334,370.8696706666667,-0.02494495260268331,247695016.0,+1
2013-08-28,381.5,391.25,381.5,382.006012,240.24861099999998,14329696.0,377.6211,377.15354687272725,6.3310240000000135,63.3908020740769,-3.163041231822071,6.717953540950248,77.24635359031339,13566362.985355094,-3853161.469493894,64.0,0.0,68.0,9.91299399999997,384.9186706666667,388.33734133333337,394.6686706666667,398.08734133333337,378.58734133333337,375.1686706666667,368.83734133333337,0.051898666666666496,262024712.0,+1
2013-08-29,383.75,390.868988,382.625,389.531006,239.350647,20086288.0,378.02919940000004,379.3189843272727,4.080993999999976,71.49872429015157,-0.5881929854576593,6.892523101637664,98.45069690955398,7245604.785544673,-3318802.948545626,96.0,4.0,64.0,12.41299399999997,387.67499799999996,392.7249959999999,395.9189859999999,400.9689839999999,384.4810079999999,379.43100999999996,376.2370199999999,0.8377020927250245,282111000.0,+1
2013-08-30,386.5,390.36199999999997,379.68798799999996,388.075012,239.446793,12678560.0,378.46610119999997,381.1454957090909,4.36901800000004,68.13004719630999,-1.0863945252352385,6.617558224807169,79.39366855011538,1585965.2670577164,-3083292.9695678432,92.0,0.0,92.0,8.862976000000003,386.0416666666667,392.3953453333334,396.71567866666663,403.0693573333334,381.7213333333334,375.3676546666667,371.0473213333334,0.7857424181273217,269432440.0,-1
2013-09-02,384.63800000000003,390.950012,383.075012,388.23098799999997,237.90863,5125040.0,380.05920119999996,382.92092967272725,15.930999999999983,68.31457707611986,-1.0330237810094207,5.179021932009846,84.46905044655838,4879867.303663438,-2701906.706590285,88.0,0.0,92.0,10.674012000000005,387.4186706666667,391.76232933333335,395.2936706666667,399.63732933333335,383.88732933333335,379.5436706666667,376.01232933333335,0.6547271111111052,274557480.0,+1
2013-09-03,384.0,386.81201200000004,377.100006,385.73699999999997,233.884216,6267312.0,381.0704012,383.95325672727273,10.111999999999966,61.7212519381107,-1.8863986313088226,3.8939843510588616,43.85664877436529,-13645942.483753417,-3224783.0756957647,84.0,0.0,88.0,7.875,383.21633933333334,389.33267266666667,392.92834533333337,399.0446786666667,379.62066666666664,373.5043333333333,369.9086606666666,0.8893110239017492,268290168.0,-1
2013-09-04,382.46200600000003,392.48699999999997,381.950012,379.21200600000003,239.97479199999998,8979400.0,381.4085024000001,383.615366690909,3.381012000000055,47.79567065805698,-4.523196598145723,4.054285418879601,57.45527665605783,12435910.501218129,-2478291.489044018,80.0,0.0,84.0,11.13098199999996,384.5496726666667,387.1493333333334,395.0866606666666,397.68632133333335,376.61234533333345,374.01268466666676,366.0753573333335,-0.25984712139749966,259310768.0,-1
2013-09-05,387.08700600000003,387.08700600000003,374.38800000000003,389.08700600000003,231.656448,9457072.0,383.33280360000003,385.01145825454546,19.24301200000002,62.550386262748106,-1.15848197705518,4.032508555214065,48.6672371258375,-13913140.4461652,-3022148.520027076,96.0,56.00000000000001,80.0,10.536987999999951,383.5206706666667,392.6533413333334,396.2196766666667,405.3523473333334,379.9543353333334,370.8216646666667,367.2553293333334,1.1574926415500553,268767840.0,+1
2013-09-06,375.73699999999997,383.98699999999997,375.73699999999997,375.600006,233.52590899999998,13465928.0,383.1403048,383.6054950545455,-1.9249879999999848,43.27547689782475,-5.753915505627153,3.747448780417983,-11.943539136291273,-22707150.218909543,-3956425.727233173,92.0,52.0,39.99999999999999,12.699005999999997,378.44133533333326,381.14567066666655,386.6913353333333,389.39567066666655,372.89567066666655,370.19133533333326,364.64567066666655,-0.016605333333328334,255301912.0,-1
2013-09-10,379.0,398.5,379.0,378.631012,243.536575,21879136.0,383.49470540000004,382.7856236363637,3.5440059999999676,47.47274221616335,-6.634052754590986,4.680542968611576,63.56853832085241,5202401.020447294,-3522605.836837238,88.0,48.0,40.0,13.350006000000064,385.377004,391.754008,404.87700399999994,411.254008,372.254008,365.877004,352.754008,-0.018922461538461624,277181048.0,+1
2013-09-11,393.125,396.618988,388.468994,394.86199999999997,240.468781,9145680.0,385.09720480000004,384.85240447272724,16.024993999999936,63.95317611013007,-1.2146911519198778,5.158204708367748,147.58271302670335,6957440.0,-3027151.8591161026,96.0,44.0,40.0,22.899993999999992,393.3166606666667,398.16432733333335,401.46665466666667,406.31432133333334,390.01433333333335,385.1666666666667,381.86433933333336,0.784418491596431,286326728.0,+1
2013-09-12,388.125,389.88800000000003,381.0,389.88800000000003,236.36297599999997,6957440.0,385.8854036000001,385.7234581454546,7.881988000000035,57.56666444387412,-2.8754590984974846,5.983715632936935,56.33779511324843,9255384.0,-2447539.1793454657,92.0,40.0,52.0,17.987976000000003,386.92533333333336,392.8506666666667,395.8133333333334,401.73866666666675,383.9626666666667,378.0373333333333,375.07466666666664,1.0,279369288.0,-1
2013-09-13,382.531006,383.23098799999997,376.66299399999997,383.23098799999997,233.448807,9255384.0,385.2554018000001,385.2408371272727,-6.300018000000023,49.875220388656,-5.098167612687823,6.4834742657087645,-3.939000527097192,1467405.2499729528,-2263113.0717771463,88.0,36.0,52.0,13.861999999999966,381.0416566666666,385.4203193333332,387.6096506666666,391.9883133333332,378.8523253333332,374.4736626666666,372.2843313333332,1.0,270113904.0,-1
2013-09-16,378.125,382.243988,372.51300000000003,378.506012,230.77758799999998,6332184.0,384.29850180000005,384.01367534545454,-9.569000000000017,44.9560370027615,-6.67578898163606,6.470863171762517,-37.97389214578935,-7038126.741606314,-2487684.150026203,84.0,32.0,52.0,13.225006000000064,377.75433333333336,382.9956666666667,387.48532133333333,392.72665466666666,373.2646786666667,368.0233453333334,363.53369066666676,0.6158688100324432,263781720.0,-1
2013-09-17,377.125,378.743988,373.875,374.174988,233.028793,8027280.0,382.8929018,382.1730364727273,-14.055999999999983,40.70942977266519,-8.12187378964942,5.104650681707426,-61.88630197032885,3360350.3327569542,-2213081.16206155,80.0,28.000000000000004,52.0,10.717987999999934,375.597992,377.32098399999995,380.4669799999999,382.18997199999995,372.45199599999995,370.729004,367.58300799999995,0.06161198179169567,255754440.0,-1
2013-09-18,378.125,378.656006,375.625,377.825012,232.60874900000002,7439816.0,382.101703,381.2516019636364,-7.911987999999951,45.69744084326615,-6.903167946577625,3.7354452472974344,-44.86266546393495,2513074.153231489,-1991490.4565161893,76.0,24.0,52.0,4.868988000000002,377.36867266666667,379.11234533333334,380.39967866666666,382.1433513333333,376.08133933333335,374.3376666666667,373.05033333333336,0.7258355806620053,263194256.0,+1
2013-09-19,374.875,379.375,374.03799399999997,377.14401200000003,232.75126600000002,15327808.0,381.89490359999996,380.35020360000004,-2.0679939999999988,44.884539476619686,-7.130546911519188,2.2341917380011296,-56.423695937231685,3707150.37260635,-1724685.6860845166,72.0,20.0,52.0,4.481018000000006,376.8523353333333,379.66667666666666,382.1893413333333,385.0036826666667,374.32967066666663,371.5153293333333,368.9926646666666,0.5819776106678622,247866448.0,-1
2013-09-20,375.0,379.0,372.93798799999996,377.375,230.912659,7991712.0,380.723703,379.52840294545456,-11.71200600000003,45.265602256690705,-7.053422370617696,1.3043008036285642,-68.11531419994742,-11328773.322680427,-2173726.9381783325,68.0,16.0,52.0,5.337006000000031,376.43766266666665,379.93733733333335,382.49967466666675,385.9993493333334,373.8753253333333,370.3756506666666,367.81331333333327,0.7319371852117763,255858160.0,+1
2013-09-23,375.625,380.493988,375.131012,374.39401200000003,232.782104,8886376.0,380.60310360000005,378.37755003636363,-1.2059939999999756,41.040348055336,-8.048743906510841,1.7735070914006315,-68.7794040631009,3757457.863911778,-1896773.301639008,64.0,12.0,52.0,6.062012000000038,376.673004,378.214996,382.03597999999994,383.577972,372.85202,371.310028,367.489044,-0.13742369908050417,246971784.0,-1
2013-09-24,378.75,378.875,374.61199999999997,377.424988,232.450867,11752256.0,380.48250120000006,377.7997108363636,-1.2060240000000135,46.859749446152804,-7.036731886477468,0.8162439245298856,-68.63437027206743,488457.47523836,-1785534.102360783,60.0,8.0,52.0,5.362976000000003,376.9706626666666,379.32932533333326,381.23366266666665,383.5923253333333,375.0663253333332,372.7076626666666,370.8033253333332,0.6598611306591593,258724040.0,+1
2013-09-25,378.975006,379.375,374.080994,376.88800000000003,232.030212,8080776.0,378.6851012000001,377.14616516363634,-17.973999999999933,45.932966807282035,-7.216026711185297,0.9513650695591309,-68.26758290124712,-5528374.17998003,-1959881.567583807,56.00000000000001,4.0,52.0,4.480987999999968,376.7813313333333,379.4816686666666,382.0753373333334,384.77567466666665,374.1876626666666,371.4873253333333,368.8936566666666,0.5302234262673758,250643264.0,-1
2013-09-26,379.25,379.60598799999997,375.125,376.205994,232.23497000000003,10682440.0,377.31690060000005,376.6954184,-13.682006000000058,44.63917149139825,-7.443741569282144,0.8796139037550574,-60.97275056206245,-1652703.63344218,-1945588.8377191757,52.0,0.0,52.00000000000001,5.294006000000024,376.978994,378.832988,381.45998199999997,383.31397599999997,374.35200000000003,372.49800600000003,369.87101200000006,0.24124010151332326,239960824.0,-1
2013-09-27,378.0,381.375,373.875,376.53799399999997,231.79525800000002,5701568.0,376.64760120000005,376.5537990181818,-6.692993999999999,45.50140359591149,-7.332890150250428,-1.4923731174117165,-49.926163076544384,-5945230.162314995,-2131489.0006827167,48.0,0.0,52.0,4.480987999999968,377.2626646666667,380.6503293333334,384.76266466666675,388.1503293333334,373.1503293333334,369.7626646666667,365.6503293333334,0.35506586666666257,245662392.0,+1
2013-09-30,377.524994,381.875,374.694,375.825012,232.288651,8679184.0,376.37950120000005,376.4042373454546,-2.680999999999983,43.81061486117049,-7.570947579298826,-3.7624113758889166,-39.7834306627706,-2301931.828301581,-2139402.93928096,44.0,60.0,48.0,7.5,377.4646706666667,380.23534133333334,384.6456706666667,387.4163413333333,373.05434133333335,370.2836706666667,365.87334133333337,0.15750062665366954,236983208.0,-1
2013-10-01,378.75,379.78799399999997,375.375,376.625,232.442871,5310216.0,376.6245024000001,376.44887349090914,2.450012000000015,46.38969956914648,-6.717981313746018,-4.757654936273639,-36.87840481030949,-20126234.962962963,-2973745.6744777053,40.0,56.00000000000001,-16.0,7.180999999999983,377.2626646666667,379.1503293333334,381.67565866666666,383.56332333333336,374.7373353333334,372.8496706666667,370.32434133333345,0.2832544073252782,242293424.0,+1
2013-10-03,379.375,380.875,377.5,376.875,234.150681,14686712.0,376.5295012000001,376.4944185090909,-0.9500120000000152,47.2625402442057,-4.473543081873447,-5.310693950667826,-20.85946368425339,6553563.170725758,-2532220.3861728157,36.0,52.0,-16.000000000000007,4.412993999999969,378.4166666666667,379.33333333333337,381.79166666666674,382.70833333333337,375.95833333333337,375.0416666666667,372.58333333333337,-0.18518518518518517,256980136.0,+1
2013-10-04,378.281006,379.875,375.625,379.64401200000003,232.55079700000002,7352816.0,376.7795012,377.06069319999995,2.5,56.345865290954556,-1.26199329117483,-4.971281797360177,-17.77893511891906,-3921435.4472179087,-2596543.800207525,32.0,48.0,-16.0,4.25,378.3813373333333,381.1376746666666,382.63133733333325,385.3876746666666,376.8876746666666,374.1313373333333,372.6376746666666,0.9456498823529487,264332952.0,+1
2013-10-07,376.875,379.968994,375.799988,377.049988,232.970795,9795344.0,376.747,377.10987261818184,-0.3250120000000152,47.50212903031035,-1.8337547203296747,-4.9822738065749945,-25.51153588333334,-18535246.172666755,-3333912.4733349904,28.000000000000004,44.0,-16.0,4.25,377.60632333333336,379.41265866666674,381.7753293333334,383.58166466666677,375.2436526666667,373.43731733333334,371.0746466666667,0.29983166251139787,254537608.0,-1
2013-10-08,380.03799399999997,381.5,377.78799399999997,377.73098799999997,233.919403,17982912.0,377.0806976,377.2887795272727,3.336975999999936,49.884800801782795,-1.4649622624834404,-4.4105222085261175,-2.884309605091566,-10459674.704157049,-3663303.814787713,24.0,40.0,-15.999999999999996,4.169006000000024,379.00632733333333,380.2246606666667,382.7183333333333,383.9366666666667,376.51265466666666,375.2943213333333,372.80064866666663,-0.01535719500453414,272520520.0,+1
2013-10-18,410.75,415.48699999999997,407.625,408.56201200000004,268.33459500000004,10944776.0,394.6143036,402.23044214545456,31.68701200000004,68.31318414799796,-3.827190651432387,4.098012997895523,150.39931832637788,-1141422.1591356308,-5328371.293138602,92.0,12.0,80.0,12.236999999999966,410.558004,413.49100799999997,418.42000399999995,421.35300799999993,405.629008,402.696004,397.76700800000003,0.11918239633681536,370638864.0,-1
2014-01-02,432.90600599999993,438.5,432.90600599999993,433.5,281.773376,4404744.0,437.67309880000005,437.6464888363636,1.4559940000000324,49.24724161365667,-3.8447718289615525,12.009235713806504,27.55121921886593,-5669461.540137264,-2296839.9206894147,88.0,4.0,84.0,5.037993999999969,434.96866866666664,437.03133133333336,440.5626626666667,442.6253253333334,431.4373373333333,429.3746746666666,425.8433433333332,0.10618423973998883,456453320.0,-1
2014-01-03,434.375,446.875,431.78100599999993,435.069,288.622314,10046344.0,437.9618988000001,437.1730163272727,2.8880000000000337,52.15192526434965,-3.3937477542220575,11.768892743046422,39.69338005232404,8054559.771788084,-1825816.9237782876,84.0,0.0,84.0,5.593994000000066,437.9083353333333,444.03566466666666,453.00232933333336,459.1296586666667,428.9416706666666,422.81434133333323,413.84767666666653,0.21783459036753747,466499664.0,+1
2014-01-06,446.88800000000003,447.56201200000004,433.575012,445.64401200000003,284.796631,11098328.0,438.6231994000001,438.5697641818182,6.613006000000098,66.88914166006529,-0.550260766798651,11.57090937325296,56.336264661378976,6155366.247481765,-1462664.3455838035,80.0,0.0,84.0,15.093994000000066,442.26034533333336,450.9456786666667,456.24734533333344,464.93267866666673,436.9586786666667,428.27334533333334,422.97167866666666,0.8628726674769427,477597992.0,+1
2014-01-07,439.881012,440.73699999999997,430.837006,439.73699999999997,279.878998,7713688.0,438.2049988000001,438.77227338181825,-4.182006000000001,55.81017472970198,-2.2449411383361166,11.524865278625327,20.274416378418298,3047441.8763568257,-1257459.123698231,96.0,16.0,80.0,13.987000000000023,437.10366866666664,443.3703313333333,447.0036626666666,453.2703253333333,433.4703373333333,427.20367466666664,423.5703433333333,0.8989898377716188,469884304.0,-1
2014-01-08,432.625,434.375,427.625,432.14401200000003,277.527405,8990392.0,438.0638000000001,437.6702757818182,-1.4119879999999512,44.80365829264705,-4.423316216111354,10.559472250938427,-16.356811315163377,-8564983.635178806,-1589929.2452728197,92.0,12.0,80.0,14.807006000000058,431.3813373333333,435.1376746666666,438.13133733333325,441.8876746666666,428.3876746666666,424.6313373333333,421.6376746666666,0.669483259259264,460893912.0,-1
2014-01-09,430.0,435.25,427.23098799999997,428.51300000000003,279.364777,12590808.0,437.33510120000005,435.93376669090907,-7.286987999999951,40.406696175926,-5.465028128194303,8.615984720470635,-27.236227752562407,-28923934.343426205,-2833490.53386727,88.0,8.0,80.0,12.111999999999966,430.3313293333334,433.4316706666668,438.35034133333335,441.4506826666668,425.41265866666674,422.31231733333334,417.3936466666667,0.15987156522524976,448303104.0,-1
2014-01-10,436.25,446.875,431.0,431.35000599999995,287.496704,30258176.0,436.4620024000001,434.84556756363634,-8.730988000000082,45.25063665183413,-4.651110976488191,8.162170056539992,7.112456980512762,-28441862.797166303,-3998496.9499895363,84.0,4.0,80.0,8.019012000000032,436.4083353333333,441.8166706666666,452.2833353333333,457.6916706666666,425.9416706666666,420.5333353333333,410.0666706666666,0.02204762204724099,478561280.0,+1
2014-01-13,447.75,459.375,447.75,443.90600599999993,296.705627,17119912.0,436.33630360000006,436.1990227636363,-1.2569880000000921,61.31027959529996,-4.292471453347226,7.836407149905426,107.0818819213895,-741603.1077870453,-3850336.200862079,80.0,0.0,80.0,18.361999999999966,450.34366866666664,452.9373373333333,461.96866866666664,464.5623373333333,441.3123373333333,438.71866866666664,429.6873373333333,-0.3306661505376401,495681192.0,+1
2014-01-14,455.625,461.875,455.056,458.125,298.466644,7425832.0,438.36940300000003,440.1606039272728,20.330994000000032,72.03055836893598,-1.0334137099552188,7.169734290440829,161.8125455974256,-12584487.193147523,-4247650.541252412,96.0,0.0,80.0,28.02499400000005,458.35200000000003,461.6480000000001,465.1710000000001,468.4670000000001,454.82900000000006,451.533,448.01000000000005,0.45006599208095166,503107024.0,+1
2014-01-15,461.912994,465.54400599999997,460.125,460.84399400000007,300.514465,17130144.0,440.88320300000004,444.24689319999993,25.138000000000034,73.6419847794206,-1.282250404607599,5.652699823468538,167.96396012682766,-2814001.437266091,-4182436.498493183,96.0,0.0,96.0,17.968994000000066,462.171,464.217,467.5900059999999,469.63600599999995,458.797994,456.751994,453.37898800000005,0.1326800523933855,520237168.0,+1
2014-01-16,462.375,467.181,461.70599400000003,464.006012,301.56689500000005,17608232.0,443.9338042,448.4510402909091,30.506012,75.53347041756106,-0.8623443360738291,5.321139285893992,159.61141322519637,-19863643.069159415,-4895721.577034623,96.0,0.0,96.0,7.419005999999968,464.29766866666665,466.8893433333333,469.7726746666666,472.3643493333332,461.4143373333333,458.8226626666667,455.93933133333337,0.42009415149499135,537845400.0,+1
2014-01-17,466.125,470.58099400000003,465.0,465.631012,301.94775400000003,25667896.0,446.99000540000003,452.39598716363633,30.56201199999998,76.53209355927761,-1.3321407929707065,5.643572760338088,160.0443624977412,-861101.190719636,-4712206.220293755,96.0,4.0,96.0,6.337005999999917,467.0706686666667,469.14133733333335,472.65166266666665,474.7223313333334,463.5603433333333,461.48967466666664,457.9793493333333,0.11306444694260462,563513296.0,+1
2014-01-20,464.0,469.993988,463.056,466.21899400000007,303.530579,9761944.0,449.0475036,455.892166909091,20.574982000000034,76.92530290845954,-1.1739028826646516,6.439108439740039,137.7990724982554,2403214.904420442,-4388570.055010432,96.0,0.0,92.0,6.574982000000034,466.422994,469.78998800000005,473.360982,476.72797600000007,462.85200000000003,459.485006,455.914012,0.4558949943413097,573275240.0,+1
2014-01-21,468.75,471.25,464.79400599999997,468.662994,304.263092,12102464.0,451.940103,459.45861970909084,28.92599400000006,78.64163955611397,-0.6949646742780319,7.1518091229185075,128.85784291264244,-239739.1561699624,-4199871.106295809,92.0,0.0,96.0,6.9379880000000185,468.23566666666665,471.6773273333333,474.69166066666673,478.13332133333336,465.2213333333333,461.7796726666666,458.76533933333326,0.5992861827318983,585377704.0,+1
2014-01-22,467.64999400000005,472.25,467.506012,469.79400599999997,304.873871,6769760.0,455.70510240000004,462.7047838909091,37.649993999999936,79.45753216832287,-0.6580024112525203,6.62200571411671,116.06007646493687,-5814822.969594561,-4273321.007290372,96.0,64.0,92.0,6.455994000000032,469.85000599999995,472.1939999999999,474.5939939999999,476.9379879999999,467.4500119999999,465.10601799999995,462.7060239999999,0.48229337848240095,592147464.0,+1
2014-01-23,473.01300000000003,474.875,470.10598799999997,470.73699999999997,307.027313,7907344.0,459.9275024000001,465.4378561818182,42.22399999999993,80.18570316606167,-1.1008979048886023,7.629334909584088,107.22742683624483,5426335.873450638,-3832181.0045618475,96.0,60.0,32.0,4.743988000000002,471.90599599999996,473.70600399999995,476.675008,478.475016,468.9369919999999,467.1369839999999,464.1679799999999,0.13231503716073562,600054808.0,+1
2014-01-24,470.625,474.618988,469.337006,474.06201200000004,304.246948,6876584.0,464.1987030000001,468.0077670181818,42.71200600000009,82.68307762793648,-0.21629211839041215,10.008534789084592,95.9286958340229,6333444.848758437,-3369860.501266211,96.0,56.00000000000001,36.0,5.080994000000032,472.67266866666665,476.00833133333333,477.9546506666667,481.29031333333336,470.7263493333333,467.3906866666666,465.4443673333333,0.8945517042655654,606931392.0,+1
2014-01-27,465.0,470.48699999999997,463.89999400000005,469.76901200000003,302.14590499999997,8099048.0,466.7850036,469.0205504727273,25.863006000000098,69.61216983925644,-1.358427136681069,13.107000260818495,66.15806170858033,29956599.949902304,-1854249.7124949493,92.0,52.0,39.99999999999999,5.281982000000028,468.05200199999996,472.20400999999987,474.63900799999993,478.7910159999998,465.61700399999995,461.46499600000004,459.02999800000003,0.8909993402161858,598832344.0,-1
2014-01-28,463.375,463.587006,458.35598799999997,466.52499400000005,297.52359,14108544.0,467.625003,468.97327600000006,8.39999400000005,61.179496292317346,-2.221484802128354,16.514463270815895,37.15848113767878,-4241062.941297482,-1962793.976429159,88.0,48.0,40.0,10.16201799999999,462.8226626666667,467.28933733333344,468.0536806666667,472.52035533333344,462.05831933333343,457.5916446666667,456.8273013333334,1.56164746517792,584723800.0,-1
2014-01-29,458.25,467.962006,456.70599400000003,459.38800000000003,300.980194,8102080.0,467.47940360000007,467.47563909090917,-1.4559940000000324,46.79082218346062,-4.120252743598262,18.618629716991904,25.50672289151087,7463395.052549931,-1534131.9746968132,84.0,44.0,40.0,11.413024000000064,461.35200000000003,465.99800600000003,472.60801200000003,477.254018,454.7419940000001,450.0959880000001,443.48598200000015,0.23827320013518244,576621720.0,-1
2014-01-30,462.962006,464.587006,457.5,464.72500599999995,299.882965,7183632.0,467.551303,466.9748395272727,0.7189939999999524,55.767001607117386,-2.700364216827416,18.393179108845345,23.56604908417184,-1797499.8277136893,-1546108.544338047,80.0,40.0,40.0,11.256011999999942,462.2706706666666,467.0413413333332,469.3576766666665,474.1283473333332,459.95433533333323,455.18366466666663,452.86732933333326,1.0194722566906218,583805352.0,+1
2014-01-31,462.5,467.46899400000007,460.819,463.03100599999993,299.62851,5369928.0,467.2913024,466.1529673454545,-2.6000060000000644,52.52203562464025,-3.151045959428019,17.921632780244238,23.857628802461093,5571998.433252242,-1222421.4039037258,76.0,36.0,40.0,7.087005999999974,463.77299999999997,466.7269999999999,470.42299399999996,473.37699399999997,460.07700599999987,457.1230059999999,453.4270119999998,0.3326327813227953,578435424.0,-1
2014-02-03,460.625,461.5,453.10000599999995,462.63800000000003,293.803528,4384112.0,466.933203,465.30691236363634,-3.5809940000000324,51.716480075744926,-3.2556035916195456,17.272248026479247,3.382387395766046,11967155.783242606,-622653.1685521204,72.0,32.0,40.0,6.649994000000049,459.07933533333335,465.05866466666674,467.4793293333334,473.4586586666668,456.6586706666667,450.6793413333333,448.25867666666664,1.1354762872449702,574051312.0,-1
2014-02-04,447.625,448.993988,443.319,453.64401200000003,288.294586,4535112.0,465.4313048,462.8906958181818,-15.018981999999994,36.80888383387001,-5.6484171599600845,16.464066006258975,-41.949649288510145,-892937.2316942853,-634943.541399511,68.0,28.000000000000004,40.0,9.930999999999983,448.6523333333334,453.98566666666676,454.3273213333334,459.66065466666674,448.3106786666668,442.9773453333334,442.6356906666668,1.8193892216159828,569516200.0,-1
2014-02-05,447.5,448.625,442.84399400000007,445.13800000000003,289.925415,4326992.0,462.96570420000006,459.20100403636366,-24.656005999999934,28.00096573497099,-7.911406717658787,14.83085786771693,-61.06134248366237,5270210.866066141,-366428.714813003,64.0,24.0,40.0,19.319000000000017,445.5356646666667,448.2273353333334,451.3166706666666,454.0083413333333,442.44632933333344,439.7546586666668,436.6653233333335,0.396817785693354,565189208.0,-1
2014-02-06,446.5,447.875,442.625,447.65600599999993,288.504425,5749904.0,460.65760480000006,456.41742254545454,-23.080994000000032,33.44105151538584,-7.241501563019638,12.662022351353528,-64.89847604310684,-3320319.9208428543,-500743.6320915576,60.0,20.0,40.0,10.800017999999966,446.05200199999996,449.4790039999999,451.3020019999999,454.7290039999999,444.2290039999999,440.80200199999996,438.9790039999999,0.9582868571428446,570939112.0,+1
2014-02-07,448.375,450.23098799999997,443.60598799999997,445.462006,288.735657,7551456.0,457.7976042,453.65458639999997,-28.600006000000064,31.080088960563955,-7.82520625207849,9.97731627127547,-68.69346475393849,-2207791.1604204252,-578362.7023202399,56.00000000000001,16.0,40.0,5.25,446.43299399999995,449.25999999999993,453.05799399999995,455.88499999999993,442.63499999999993,439.80799399999995,436.00999999999993,0.2801536603773594,563387656.0,-1
2014-02-10,447.48699999999997,448.25,444.68798799999996,445.819,289.322449,6049424.0,455.4026030000001,451.4766583636363,-23.950012000000015,31.981675265167254,-7.730229464582636,7.065648378812398,-71.37915082388997,-5762345.717856073,-814073.6631492835,52.0,12.0,40.00000000000001,6.625,446.2523293333333,447.81667066666665,449.8143413333334,451.3786826666667,444.2546586666666,442.69031733333327,440.6926466666666,0.3175205473760456,569437080.0,+1
2014-02-11,448.0,452.75,446.68798799999996,446.72500599999995,291.139771,5833592.0,453.42260419999997,449.89891345454544,-19.7999880000001,34.49113780844719,-7.489190289324922,4.144018331067173,-59.210348528075585,-3459556.41528765,-934359.5926437515,48.0,8.0,40.0,3.5620120000000384,448.72099799999995,450.75400799999994,454.78301000000005,456.81602,444.6919959999999,442.6589859999999,438.62998399999987,0.00610655340174003,575270672.0,+1
2014-02-12,450.06201200000004,453.431,449.14999400000005,449.53100599999993,291.451935,4208712.0,452.4369048,449.1913501454546,-9.8569940000001,42.121987441941734,-6.742665513801148,1.278875026815001,-48.85029036810087,209029.408338126,-882372.2190697363,44.0,4.0,40.0,6.930999999999983,450.704,452.25800599999997,454.98500599999994,456.5390119999999,447.97700000000003,446.4229940000001,443.6959940000001,0.0890005760328041,579479384.0,+1
2014-02-13,450.60000599999995,452.243988,447.506012,450.01300000000003,290.293884,3588320.0,450.9657042,448.7506401818181,-14.712005999999917,43.42808492443411,-6.550783849084851,-1.816704602689697,-53.59251710339402,-9386845.029768469,-1269046.699941297,40.0,0.0,40.0,6.705994000000032,449.921,452.335988,454.658976,457.073964,447.598012,445.183024,442.860036,0.5291263611297384,583067704.0,+1
2014-02-14,451.944,458.0,450.40600599999993,448.22500599999995,295.03018199999997,5962168.0,449.4851042,448.2523314181818,-14.805999999999983,39.60282877065761,-5.992671075973053,-4.386860077419101,-38.49894160489047,-16981122.776394114,-1983421.6147951589,36.0,0.0,40.0,4.737976000000003,452.21033733333326,454.0146686666666,459.80433133333327,461.60866266666665,446.4206746666665,444.6163433333332,438.82668066666645,-0.287200648301798,577105536.0,-1
2014-02-17,460.625,460.625,456.10598799999997,455.537994,296.151215,13569920.0,448.77510359999997,449.35285683636357,-7.100006000000008,57.337203302564475,-3.3672876334047115,-7.51262804703606,-1.2284671977112933,-2645563.5956901796,-2013526.6060039275,32.0,72.0,36.0,7.986999999999966,457.422994,458.74000000000007,461.94200600000005,463.2590120000001,454.22098800000003,452.903982,449.701976,-0.12568986318246952,590675456.0,+1
2014-02-18,455.875,461.825012,455.875,457.26901200000003,298.08197,4978240.0,449.13760360000003,450.8972038181818,3.625,60.50458625754257,-2.898128757463429,-9.767343022155956,9.343835202838074,-9831902.649127072,-2368993.314322546,28.000000000000004,68.0,-40.0,12.39999400000005,458.323008,460.77101600000003,464.2730200000001,466.72102800000005,454.821004,452.372996,448.870992,0.23428725858032362,595653696.0,+1
2014-02-19,461.95599400000003,470.25,461.88800000000003,460.25,303.862183,7064304.0,450.64880360000006,452.91763952727274,15.111999999999966,65.58200896980426,-2.6936026936026933,-11.154666307497848,58.504007801860205,12672135.380429545,-1685147.7585939656,24.0,64.0,-40.0,6.287017999999989,464.1293333333333,466.3706666666666,472.4913333333333,474.73266666666655,458.0086666666666,455.76733333333334,449.64666666666665,-0.19588615163836884,602718000.0,+1
2014-02-20,468.11199999999997,468.11199999999997,463.25,469.174988,300.449707,8816848.0,452.80070179999996,456.2860366909091,21.51898200000005,76.16666570222642,-0.289565521885526,-10.974914306861876,81.4805150543625,-11790234.326941054,-2144571.126541722,20.0,60.0,-40.0,12.980987999999968,466.8456626666666,470.4413253333332,471.7076626666666,475.3033253333332,465.57932533333326,461.98366266666665,460.7173253333333,1.2186318387494912,611534848.0,+1
2014-02-21,467.0,469.424988,465.90600599999993,463.90600599999993,303.643311,5517984.0,454.6451017999999,458.3051829090909,18.44399999999996,62.97432740479858,-1.7088199326599507,-9.485699145042588,77.96906398274369,3254232.112172619,-1899119.343644785,16.0,56.00000000000001,-40.0,7.861999999999966,466.41233333333327,466.9186606666666,469.93131533333326,470.43764266666665,463.39967866666655,462.8933513333332,459.8806966666665,-0.5683461864823324,606016864.0,-1
2014-02-24,468.25,469.212006,466.25,468.837006,303.578522,4357608.0,456.9469024,460.8855291272727,23.018005999999957,68.80816069654188,-0.38060444444445146,-7.992639726763173,84.45325489648022,-10327838.285467975,-2282319.881525285,12.0,52.0,-40.00000000000001,3.518982000000051,468.09967066666667,469.94934133333334,471.0616766666667,472.9113473333333,466.98733533333336,465.1376646666667,464.0253293333334,0.8733966102702009,610374472.0,+1
2014-02-25,469.375,474.01300000000003,469.375,468.73699999999997,306.25012200000003,8099512.0,459.14810179999995,463.0291832363636,22.011994000000016,68.55538715868914,-1.406884561335225,-6.015380801344122,98.92976229116667,-3879456.4405234694,-2354930.9159315564,8.0,48.0,-40.0,5.30600000000004,470.7083333333333,472.04166666666663,475.3463333333334,476.67966666666666,467.4036666666666,466.0703333333333,462.76566666666656,-0.13755929279862636,602274960.0,-1
2014-02-26,472.5,477.22500599999995,471.51300000000003,472.86199999999997,308.24231000000003,7352168.0,461.4812012,465.52261927272724,23.330994000000032,73.234952164851,-1.1535477376659715,-3.6495589524417937,116.64073156557079,2167423.142548379,-2149331.7498863693,4.0,44.0,-40.0,5.17599400000006,473.8666686666667,476.2203373333334,479.57867466666664,481.93234333333334,470.5083313333335,468.1546626666668,464.7963253333336,0.23616921971019503,609627128.0,+1
2014-02-28,470.13800000000003,479.64401200000003,470.13800000000003,475.93798799999996,309.646332,9839496.0,464.0737,468.15112596363633,25.924987999999928,76.27309950836593,-0.9736194142468396,-1.0506056387561102,119.59013607131801,967843.7826206228,-2007617.2024174703,96.0,40.0,-40.0,8.488005999999984,475.24,480.342,484.74601199999995,489.848012,470.835988,465.733988,461.329976,0.610138931025958,619466624.0,+1
2014-03-03,478.125,481.243988,473.993988,478.10598799999997,307.49295,7204176.0,467.0617982,470.7024510545454,29.880982000000017,78.27829731641197,-0.8209416232859191,1.4953798532297924,129.44060931626458,1126012.736020388,-1865155.7279089743,96.0,36.0,56.0,9.506011999999998,477.7813213333333,481.56865466666665,485.0313213333333,488.81865466666665,474.31865466666665,470.5313213333333,467.06865466666665,0.5671724137930988,626670800.0,+1
2014-03-04,471.25,478.056,470.23699999999997,474.78100599999993,307.598511,6937912.0,468.9860994,472.1059433818182,19.243011999999908,68.09457286434996,-1.690800170282879,4.323721906439459,97.72376305526855,-7907551.510449704,-2139853.795507004,96.0,32.0,60.0,7.25,474.35800199999994,478.4790039999999,482.177002,486.29800399999993,470.6600039999999,466.5390019999999,462.8410039999999,0.5811492518224783,619732888.0,-1
2014-03-05,478.48699999999997,480.549988,476.23699999999997,474.944,309.391235,4943504.0,470.7535982,473.1891980363636,17.674987999999985,68.32763727328894,-1.6481588194396886,7.3797819727009255,104.58314198579832,-4566973.423289717,-2250194.1757424753,92.0,28.000000000000004,64.0,7.868988000000002,477.2436626666667,478.2503253333334,481.55665066666677,482.56331333333344,473.9373373333334,472.9306746666667,469.6243493333334,-0.2997921626491759,624676392.0,+1
2014-03-06,479.75,481.243988,477.16900599999997,477.712006,310.216949,6226312.0,472.49979879999995,474.45436309090906,17.462005999999974,72.2934896201468,-0.9240124399288204,9.528148085972475,98.2387988179672,14568144.947275542,-1485613.3542858073,88.0,24.0,64.0,5.768982000000051,478.7083333333333,480.24766066666666,482.78331533333335,484.3226426666667,476.1726786666666,474.6333513333333,472.0976966666666,0.13325212234066355,630902704.0,+1
2014-03-07,478.375,479.25,463.537994,478.98699999999997,302.802002,15072744.0,473.481,475.63385421818174,9.812011999999982,74.02229415769168,-0.5904574227077275,11.211870000811132,58.090530088748515,9300963.320767563,-995246.5450615323,84.0,20.0,64.0,6.299987999999985,473.92499799999996,484.3120019999999,489.63700399999993,500.02400799999987,468.5999959999999,458.212992,452.88798999999995,0.9832612080214306,645975448.0,+1
2014-03-10,466.212006,466.212006,455.662994,467.537994,297.23999,7432472.0,473.84419879999996,474.5533076727273,3.631988000000092,44.957235237471494,-3.5856663362354766,12.692225516027747,-8.79504824741356,172503.36710560904,-942159.9901056472,80.0,16.0,64.0,15.712005999999974,463.1376646666667,470.61233533333336,473.6866766666667,481.1613473333333,460.0633233333334,452.58865266666675,449.51431133333347,1.1256978378638738,638542976.0,-1
2014-03-11,456.625,463.61199999999997,453.881012,458.950012,297.543732,4124272.0,472.85549940000004,471.8452737090909,-9.886993999999959,33.55407578672832,-5.832394151350259,12.696843191118319,-36.35454543824408,-356624.8081675168,-915541.3977158219,76.0,12.0,64.0,23.32400599999994,458.8143413333333,463.7476706666666,468.5453293333333,473.47865866666655,454.0166826666666,449.0833533333333,444.28569466666664,0.5209131899042557,634418704.0,-1
2014-03-12,459.174988,462.91900599999997,456.5,459.41900599999997,297.215973,3940104.0,471.92370000000005,469.40227490909086,-9.317993999999999,34.59935354837198,-5.709699219651307,13.430473422033685,-33.86689914756944,229774102.57303205,9571613.921129424,72.0,8.0,64.0,13.656982000000028,459.61267066666665,462.7253413333333,466.0316766666666,469.14434733333326,456.3063353333333,453.1936646666667,449.88732933333335,0.4547442392170972,638358808.0,+1
2014-03-13,427.5,429.98699999999997,417.5,458.912994,271.819641,40790880.0,470.5287994,467.036692,-13.94900599999994,33.93476981327274,-5.842078541729733,12.934019638824168,-161.3513500392029,-3851403.9970159605,8961406.62703593,68.0,4.0,64.0,6.419005999999968,435.46666466666665,453.4333293333333,447.95366466666655,465.92032933333326,440.9463293333333,422.9796646666667,428.45932933333336,3.3164886682149546,597567928.0,-1
2014-03-14,417.5,425.48699999999997,416.881012,419.700012,274.778778,11167544.0,464.9050018000001,457.7950942909091,-56.23797599999995,12.487460563235118,-16.100704767657454,10.872204044056843,-210.1055540125191,5977713.05391002,8825769.314889094,64.0,96.0,64.0,41.91900599999997,420.6893413333333,424.4976706666666,429.2953293333333,433.10365866666655,415.8916826666666,412.0833533333333,407.28569466666664,0.3275626226762142,586400384.0,-1
2014-03-18,425.0,426.48699999999997,417.5,424.26901200000003,271.249023,11804312.0,459.52130420000003,450.4067325090909,-53.836975999999936,19.34107299202479,-14.905394928016491,8.299572439759743,-164.53784072175753,13844723.281628612,9053927.473507924,60.0,96.0,-32.0,42.03198200000003,422.752004,428.004008,431.739004,436.99100799999997,419.01700800000003,413.76500400000003,410.03000800000007,0.7532004005786199,598204696.0,+1
2014-03-19,418.75,419.73098799999997,404.843994,418.819,264.869659,15777848.0,453.92510359999994,443.0063135636364,-55.96200599999992,17.459170691191417,-16.331188968235647,4.758526064097282,-169.286312151821,-7669440.1321474565,8293698.424945263,56.00000000000001,92.0,-36.0,8.986999999999966,414.4646606666667,424.0853273333334,429.35165466666666,438.97232133333335,409.19833333333344,399.57766666666674,394.3113393333335,0.9387392780570776,582426848.0,-1
2014-03-20,408.75,418.68798799999996,408.75,408.968994,267.403259,8023032.0,447.327603,434.83247545454543,-65.97500600000001,14.514112177689654,-18.908078679840475,0.33517636324188516,-150.48862293224792,-440146.0912436155,7896667.617588859,52.0,96.0,-35.99999999999999,19.425018000000023,412.13566066666664,415.5213213333333,422.0736486666666,425.45930933333324,405.5833333333333,402.1976726666667,395.64534533333335,0.02203604995296936,574403816.0,-1
2014-03-21,416.25,417.25,408.81201200000004,412.881012,267.613739,12380320.0,440.84450359999994,428.5694589090909,-64.83099399999998,20.648060584776786,-17.88464387829692,-3.89043362952566,-126.3042974500496,5802621.487334942,7801475.03443777,48.0,92.0,-44.0,10.069000000000017,412.98100800000003,417.150004,421.41899599999994,425.587992,408.71201600000006,404.54302000000007,400.2740280000001,0.48222396144673096,586784136.0,+1
2014-03-25,406.0,409.96200600000003,405.75,409.475006,263.464905,7548064.0,433.8933042,422.8659138909091,-69.51199399999996,19.25974351755312,-18.775699357762036,-8.467441009297033,-121.58605476026551,-6111590.5833698725,7169007.986905971,44.0,88.0,-44.0,8.437987999999962,408.3956706666666,411.0413413333332,412.60767666666663,415.25334733333324,406.8293353333332,404.1836646666666,402.61732933333315,0.8843781324148114,579236072.0,-1
2014-03-26,407.5,408.618988,403.825012,406.799988,263.019318,8458568.0,427.8195036000001,417.9398564,-60.73800600000004,18.153624278198293,-19.475518866761096,-13.94479416648403,-110.6461509461918,-1200634.9854712558,6788538.102762689,40.0,84.0,-64.0,0.0,406.41466266666663,409.00431333333324,411.2086386666666,413.79828933333323,404.21033733333326,401.62068666666664,399.41636133333327,0.6205654763394681,570777504.0,-1
2014-03-27,406.0,407.86199999999997,401.993988,406.11199999999997,261.574371,13599368.0,422.53570240000005,413.99303756363634,-52.83801200000005,17.84941152898155,-19.655505477825862,-20.292278727378857,-97.81644498334337,-5936289.6095641395,6210091.031428073,36.0,96.0,-64.0,0.0,405.32266266666664,408.6513373333333,411.19067466666655,414.51934933333325,402.7833253333333,399.4546506666667,396.91531333333336,0.7017729343430091,557178136.0,-1
2014-03-28,405.01300000000003,409.875,403.41299399999997,403.881012,264.128754,7146824.0,416.98190300000005,410.6012756727273,-55.53799399999997,16.796259835416507,-20.23916096229092,-25.230786213106967,-83.81710934255675,-4656853.924796977,5716101.643445388,32.0,96.0,-44.0,0.0,405.723002,408.03301000000005,412.185008,414.4950160000001,401.571004,399.260996,395.108998,0.07242611659599618,550031312.0,-1
2014-03-31,410.66299399999997,413.118988,403.756012,407.825012,265.764069,9176928.0,411.8731048,408.9363864,-51.08798200000001,25.734310720501483,-18.78369178172255,-29.258174945573955,-67.33902015328589,-3726142.0323604285,5286877.7756310655,28.000000000000004,92.0,-44.0,5.649993999999992,408.23333733333334,412.7106626666667,417.5963133333333,422.0736386666667,403.3476866666667,398.87036133333334,393.9847106666667,0.43458404678170864,559208240.0,+1
2014-04-01,410.381012,415.625,409.375,410.350006,268.286011,8628352.0,410.9381042,408.6594593454545,-9.350006000000008,31.19434603487649,-15.21246557499538,-33.54705987925928,-50.42232002361932,1117204.7160519732,5097334.125966843,24.0,88.0,-60.0,5.868011999999965,411.78333533333335,414.1916706666667,418.0333353333333,420.4416706666667,407.9416706666667,405.53333533333335,401.6916706666667,0.15600096000000122,567836592.0,+1
2014-04-02,418.600006,418.75,413.81201200000004,414.243988,268.941498,5644400.0,409.93560180000003,409.2605291272727,-10.02502400000003,39.15443075323818,-13.539875813193195,-37.581843016813025,-34.48603553132972,7486154.449090641,5205924.007766368,20.0,84.0,-64.0,6.462006000000031,415.60200000000003,417.391988,420.53998800000005,422.329976,412.45400000000006,410.66401200000007,407.5160120000001,0.08748016398581095,573480992.0,+1
2014-04-03,417.43798799999996,418.5,414.881012,415.256012,270.24517799999995,4700216.0,409.579303,410.22787643636366,-3.5629880000000185,41.19455166404862,-13.097143379205638,-36.79061894229852,-26.996963890963897,6253745.026319938,5253555.225305474,16.0,80.0,-64.0,9.362976000000003,416.21234133333337,417.54367066666674,419.8313293333334,421.16265866666674,413.92468266666674,412.59335333333337,410.30569466666674,0.10362012805789901,578181208.0,+1
2014-04-04,418.875,419.5,413.26300000000003,417.26901200000003,268.455688,3925584.0,410.4093048,411.6260053454546,8.300018000000023,45.3964783612151,-3.842443358802592,-36.30363073880943,-20.017589384845806,19362639.882466834,5894915.678460813,12.0,76.0,-64.0,7.799987999999985,416.67733733333336,420.0916746666667,422.91433733333326,426.32867466666664,413.8546746666667,410.4403373333334,407.61767466666674,0.6422978996312362,582106792.0,+1
2014-04-07,412.25,414.306,407.0,414.506012,266.622223,7097544.0,410.5718048,412.3708611999999,1.625,40.78140978978425,-3.65846216796391,-35.173014181123335,-23.54274544773556,-3752195.8193125543,5456385.532641393,8.0,72.0,-64.0,8.399993999999992,411.93733733333335,416.8746746666667,419.24333733333333,424.1806746666667,409.5686746666667,404.63133733333336,402.2626746666667,1.0273764029564763,575009248.0,-1
2014-04-09,410.131012,413.725006,403.81201200000004,411.674988,263.477203,10664680.0,410.79180299999996,412.57143996363635,2.1999819999999772,36.40581294226423,-4.52293129192914,-32.44936585679835,-23.062711053824916,-24436578.30516076,4097540.274449323,4.0,68.0,-64.0,4.256011999999998,409.7373353333333,415.6626586666666,419.65032933333333,425.57565266666654,405.7496646666666,399.82434133333334,395.83667066666663,0.793198906405065,564344568.0,-1
2014-04-10,406.81201200000004,407.218994,398.26901200000003,406.819,259.15799,21263240.0,410.79370420000004,411.8491121454546,0.019012000000032003,30.029070019512716,-4.025799964174323,-30.094021270617077,-30.591027311153038,18186556.37903981,4737983.46788908,0.0,64.0,-64.0,6.236999999999966,404.1023353333333,409.9356586666666,413.0523173333333,418.8856406666666,400.9856766666666,395.15235333333334,392.03569466666664,0.955307843077227,543081328.0,-1
2014-04-11,401.25,406.950012,395.625,400.149994,261.906677,18678336.0,410.1975036,409.9138921090909,-5.962005999999974,23.504985564594833,-6.037443369734792,-27.219417451519007,-33.82019683606564,-8732190.59922893,4125672.3740154663,8.0,96.0,-64.0,10.269012000000032,400.90833533333335,406.1916706666667,412.2333473333333,417.5166826666667,394.8666586666667,389.58332333333334,383.5416466666667,0.39955754572268765,524402992.0,-1
2014-04-15,416.524994,423.5,405.93798799999996,404.39401200000003,263.9021,20782384.0,410.2488036000001,408.8587118181818,0.5130000000000337,34.02927878430546,-5.887823728813549,-23.967711371034795,-3.310820335093794,-722581.7025638432,3905286.7256571073,4.0,96.0,-64.0,10.69399999999996,411.2773333333333,416.6166786666666,428.83934533333326,434.1786906666666,399.05466666666655,393.71532133333324,381.4926546666665,-0.08791566706593335,545185376.0,+1
2014-04-16,405.243988,405.243988,393.43798799999996,407.475006,255.60433999999998,13198304.0,410.2138030000001,408.3543849818182,-0.3500060000000076,40.846421320117884,-4.938364869029273,-20.388418061427274,-26.104881352623973,2704126.177185272,3850686.044507563,0.0,92.0,-64.0,13.405975999999953,402.0523273333333,410.6666666666667,413.8583273333333,422.4726666666667,398.86066666666665,390.2463273333333,387.0546666666666,1.1889732339488395,558383680.0,+1
2014-04-17,397.5,401.256012,394.794006,394.66299399999997,258.417114,8391912.0,408.64510180000013,405.5269651636364,-15.687012000000038,27.307012067871455,-8.8865966101695,-16.479068477211683,-42.55228128009219,-23539872.49596981,2605606.796396986,0.0,96.0,-88.0,11.325012000000015,396.90433733333333,399.01466866666664,403.3663433333333,405.4766746666666,392.55266266666666,390.44233133333336,386.0906566666667,-0.020274199683512475,549991768.0,-1
2014-04-21,401.25,402.5,396.25,399.006012,257.680725,6119624.0,407.12130420000005,403.7744033818182,-15.237976000000003,35.649912221487625,-7.54822434514638,-12.776474786986398,-34.52160598488204,0.0,2487165.2331523383,0.0,92.0,-92.0,23.350006000000008,399.252004,402.254008,405.50200399999994,408.504008,396.004008,393.002004,389.754008,0.44096191999999973,556111392.0,+1
2014-04-22,396.506012,400.0,392.799988,397.868988,255.065475,6626896.0,405.3826018000001,402.09216407272726,-17.387023999999997,34.45535445288978,-7.898616949152541,-10.049178942178571,-45.83099383770752,-2937873.671144845,2240562.835844039,0.0,88.0,-92.0,11.80600000000004,396.88965866666666,400.97932933333334,404.08967066666673,408.17934133333335,393.7793173333333,389.68964666666665,386.5793053333333,0.7040266044001047,549484496.0,-1
2014-04-23,396.756012,398.98098799999997,395.5,393.830994,256.846558,12016720.0,403.0388,399.99187174545455,-23.438018000000056,30.29556210858935,-9.142991063174122,-8.45134197786092,-52.04442844915165,-1467417.9944228048,2072011.9111852928,0.0,96.0,-96.0,12.680999999999983,396.103994,396.707988,399.58498199999997,400.18897599999997,393.22700000000003,392.62300600000003,389.74601200000006,-0.47946330179823654,537467776.0,-1
2014-04-25,398.5,400.0,395.419006,396.580994,257.08551,5962904.0,399.73689879999995,397.9694880727273,-15.09399400000001,36.33543293704097,-8.295533436055477,-5.722181255182477,-48.430039583678905,-2239495.972729203,1699543.0636110266,4.0,88.0,-88.0,7.200012000000015,397.3333333333333,399.2476606666666,401.91432733333323,403.8286546666666,394.66666666666663,392.75233933333334,390.08567266666665,0.2536541196080932,537467776.0,-1
2014-04-28,396.125,399.125,395.625,396.950012,257.283722,6042480.0,398.75,397.4627813818182,-9.868988000000002,37.305952294031705,-8.18181448382126,-6.665260273670185,-49.30275605892188,-5409882.893844636,1376376.7634187534,0.0,84.0,-96.0,3.480987999999968,397.23333733333334,398.8416746666667,400.73333733333334,402.3416746666667,395.3416746666667,393.73333733333334,391.8416746666667,0.3785748571428615,543510256.0,+1
2014-04-29,397.875,399.375,396.375,397.256012,257.25973500000003,4835464.0,398.46060179999995,397.19114720000005,-2.893981999999994,38.20724478779433,-8.087515562403699,-7.046328602103642,-46.117281828443495,2286185.1355401347,1417732.9811958221,64.0,80.0,-92.0,2.75,397.6686706666667,398.96234133333337,400.6686706666667,401.96234133333337,395.96234133333337,394.6686706666667,392.96234133333337,0.29367066666666614,548345720.0,+1
2014-04-30,397.205994,398.75,396.375,397.218994,257.50647000000004,7741936.0,397.7431,396.9654003272727,-7.175018000000023,38.13072848484447,-8.098923266563942,-7.18033523320787,-46.05851612215918,2213019.67438984,1453883.4541839913,60.0,76.0,-84.0,4.580993999999976,397.44799800000004,398.5209960000001,399.8229980000001,400.8959960000001,396.1459960000001,395.07299800000004,393.7709960000001,0.355365894736846,540603784.0,-1
2014-05-02,398.125,405.875,398.125,397.600006,260.655396,4764392.0,396.7556000000001,396.9393832363636,-9.875,39.568032377023044,-7.981508166409859,-7.034987271889747,-23.28181530329143,14335934.336115267,2039447.88683237,56.00000000000001,72.0,-84.0,3.5,400.53333533333335,402.9416706666667,408.2833353333333,410.6916706666667,395.1916706666667,392.78333533333335,387.4416706666667,-0.06774116129032161,545368176.0,+1
2014-05-05,399.0,404.125,396.819,402.46200600000003,257.19043,4196688.0,397.5355012,397.97691160000005,7.799012000000062,54.97062226316029,-6.483203081664089,-7.131063209604065,-16.185303214486797,-31406.625680924397,1945315.5790120347,52.0,68.0,-16.0,3.0,401.13533533333333,405.45167066666664,408.44133533333337,412.7576706666666,398.14567066666666,393.82933533333335,390.8396706666667,0.7723796879277344,549564864.0,+1
2014-05-06,397.11199999999997,398.06201200000004,394.375,397.11199999999997,256.23974599999997,4566024.0,397.34610000000004,397.8999113818182,-1.894012000000032,41.5310101873629,-8.131895223420656,-8.058874918010304,-48.39122305105046,-4045826.4164633616,1672983.8808241596,48.0,64.0,-16.0,2.375,396.5163373333333,398.6576746666666,400.20334933333334,402.34468666666663,394.97066266666656,392.82932533333326,391.2836506666665,0.7423355280644429,544998840.0,-1
2014-05-07,393.875,396.25,381.25,395.64401200000003,248.32217400000002,15596072.0,397.12360240000004,397.59044083636365,-2.2249759999999696,38.54723910237977,-8.584279815100144,-7.469512174485033,-90.0901331218201,-5937181.933091077,1327058.690230115,44.0,60.0,-15.999999999999993,8.65600599999999,391.048004,400.846008,406.048004,415.846008,385.846008,376.048004,370.846008,0.9596008000000021,529402768.0,-1
2014-05-08,383.75,386.049988,380.806,383.419006,248.15632599999998,9161992.0,396.0824036,395.09869603636366,-10.411987999999951,22.80433391453272,-7.3176355193482605,-7.823029642453662,-132.50823949440306,-8553023.37669561,877953.4394235989,40.0,96.0,-16.0,7.305999999999983,383.424998,386.04399600000005,388.66898599999996,391.28798400000005,380.80000800000005,378.18101,375.55602000000005,0.49828603726782755,520240776.0,-1
2014-05-09,383.125,390.625,381.60598799999997,383.16299399999997,251.891998,6179400.0,394.74060360000004,392.74971247272725,-13.418000000000006,22.581488696049092,-7.4010610183299494,-8.225258458196038,-100.8285540663243,5238443.812961989,1076162.01768352,36.0,96.0,-16.0,8.08700600000003,385.13132733333333,388.6566666666667,394.1503393333333,397.6756786666667,379.63765466666666,376.1123153333333,370.61864266666663,0.1726359827440074,514061376.0,-1
2014-05-12,389.774994,398.31201200000004,388.131012,388.931,257.04537999999997,7044200.0,393.9756042000001,391.69342090909083,-7.649993999999992,38.26463622541315,-5.5214663951120215,-7.713641551337503,-41.85424257107329,761337.9327889036,1061851.5239201596,32.0,92.0,-16.0,15.861999999999966,391.7913413333333,395.45167066666664,401.9723413333334,405.6326706666667,385.2706706666666,381.6103413333333,375.08967066666656,0.0785765641881919,521105576.0,+1
2014-05-13,397.875,409.375,397.875,396.88800000000003,264.34310899999997,7299968.0,393.969403,392.22294741818183,-0.062011999999981526,53.31736758454833,-4.023197744663702,-7.214552228009211,34.992244439289955,7365693.3590027,1348395.677668814,28.000000000000004,88.0,-56.0,14.838012000000049,401.3793333333333,404.8836666666666,412.8793333333333,416.3836666666666,393.3836666666666,389.8793333333333,381.8836666666666,-0.08582608695651882,528405544.0,+1
2014-05-14,406.281006,408.125,402.14401200000003,408.156006,263.44088700000003,5184688.0,395.05940240000007,394.8023297818182,10.899993999999992,66.61727685705209,-0.3927487716472039,-6.163475427954495,75.35786877069766,13682451.30775763,1909045.567668725,24.0,84.0,-60.0,9.019012000000032,406.14167266666664,410.13933333333324,412.1226606666666,416.1203213333332,404.1583453333333,400.16068466666667,398.1773573333333,1.0051840933303982,533590232.0,+1
2014-05-15,406.76300000000003,411.85598799999997,400.656006,406.76300000000003,264.925995,8409192.0,396.01380300000005,396.93025661818183,9.544006000000024,64.01571725165462,-1.6279017168755405,-5.070702681989701,81.22397625115184,-13724700.539339066,1198407.4383581362,20.0,80.0,-60.0,15.14901800000007,406.42499799999996,412.1939899999999,417.62498,423.3939719999999,400.99400799999995,395.225016,389.794026,0.5452681977524656,525181040.0,-1
2014-05-16,412.375,417.5,382.381012,409.056,257.243561,14188792.0,397.15940240000003,399.3015651636363,11.455993999999976,66.50047752860922,-2.651177394034542,-3.771371617167347,50.99118151991915,-1971515.2449118977,1054317.4683036031,16.0,76.0,-60.0,20.444000000000017,402.97900400000003,423.57699600000007,438.09799200000003,458.69598400000007,388.45800800000006,367.86001600000003,353.33902000000006,0.7595602697890949,539369832.0,+1
2014-05-19,399.75,399.75,375.01300000000003,397.194,244.087784,17246512.0,396.63260180000003,399.3078556363636,-5.268006000000014,47.09107960722579,-6.375510204081627,-2.8694872226990924,-54.26819432183465,5277654.867831898,1246290.6253272276,12.0,72.0,-60.0,11.236999999999966,390.6523333333334,406.29166666666674,415.3893333333334,431.0286666666667,381.5546666666668,365.9153333333334,356.8176666666668,0.8966729999595753,522123320.0,-1
2014-05-20,381.125,392.35598799999997,380.274994,376.881012,252.762421,8787344.0,394.6095030000001,395.71665749090914,-20.230987999999968,29.86683205270417,-12.753214442700159,-2.692117507089222,-115.15284620917306,2552187.335059186,1305650.53337645,8.0,96.0,-60.0,11.199981999999977,383.17066466666665,386.0663353333333,395.2516586666667,398.1473293333333,373.98534133333334,371.0896706666667,361.90434733333336,-0.28093565810892723,513335976.0,-1
2014-05-21,389.75,395.53799399999997,387.381012,390.274994,255.58815,6788304.0,394.07260120000007,394.9285649454546,-5.36901800000004,45.13483147499761,-8.547882574568291,-3.224660787331743,-39.34232340179612,-2080795.5183016453,1151718.7745032418,4.0,92.0,-60.0,35.118988,391.06466666666665,394.7483213333333,399.2216486666667,402.9053033333333,386.59133933333334,382.9076846666667,378.43435733333337,0.35478587546227325,520124280.0,+1
2014-05-22,395.0,397.5,385.14401200000003,394.63800000000003,252.09021,9832744.0,395.1945006,395.0313647272727,11.21899400000001,49.284588226990316,-7.178021978021968,-3.3888380362723183,-26.6999669216725,-5820442.683036429,834797.6419730119,0.0,88.0,-60.0,34.04299999999995,392.42733733333336,399.7106626666667,404.78332533333327,412.06665066666665,387.3546746666667,380.0713493333334,374.99868666666674,0.7683714163529478,529957024.0,+1
2014-05-23,390.625,396.375,376.51901200000003,389.23699999999997,248.500229,9081776.0,395.80190120000003,393.94818280000004,6.074005999999997,44.479293029209394,-8.873783359497656,-3.242694234306896,-66.65588209449184,-2918225.0075794305,664203.2870506442,80.0,84.0,-88.0,16.919006000000024,387.37700399999994,398.23499599999985,407.2329919999999,418.0909839999998,378.3790079999999,367.521016,358.5230199999999,0.6405114668683298,520875248.0,-1
2014-05-26,383.875,388.868988,381.26901200000003,383.694,250.548096,5750544.0,395.2782012,391.7467462181819,-5.236999999999966,39.875329898261484,-10.614128728414437,-1.3138413163756013,-81.00804393269968,152815552.06051356,7580267.19259177,76.0,80.0,-88.0,18.65698199999997,384.6106666666667,387.9523213333334,392.2106426666666,395.55229733333334,380.3523453333334,377.01069066666673,372.75236933333343,0.31907837603697625,515124704.0,-1
2014-05-27,387.5,394.375,387.43798799999996,386.85598799999997,253.721634,4984128.0,394.275,390.21543472727274,-10.032012000000066,43.71033437891381,-9.621353846153855,0.0550725653642985,-35.68057210944611,3367955.1649165927,7388795.992996903,72.0,76.0,-88.0,12.355987999999968,389.5563253333333,391.6746626666666,396.4933373333333,398.61167466666666,384.7376506666666,382.61931333333325,377.80063866666654,-0.08389779345919979,520108832.0,+1
2014-05-28,390.43798799999996,398.5,389.75,391.756012,256.899658,5389320.0,392.6350006,389.7574369090909,-16.399993999999992,49.47298997738256,-8.082884772370488,1.1208308997759673,-3.958033249036405,-13295791.908108424,6448575.869419854,68.0,72.0,-4.0,19.855987999999968,393.33533733333337,396.92067466666674,402.0853373333334,405.67067466666674,388.17067466666674,384.58533733333337,379.42067466666674,0.2292585142857141,525498152.0,+1
2014-05-29,378.125,378.125,364.375,396.66299399999997,265.54306,41341328.0,391.625,390.48979934545457,-10.100006000000064,54.8177258393502,-6.5422310832025214,1.1858877012365383,-128.5899877220435,-2786997.025681005,6028772.16495027,64.0,68.0,-4.0,7.967987999999934,379.720998,395.066996,393.470998,408.816996,381.316996,365.970998,367.566996,2.3482177454545434,566839480.0,+1
2014-05-30,367.5,369.931,360.0,365.56201200000004,266.896332,28035616.0,387.2756012000001,385.7510742545454,-43.493987999999945,30.907798265131262,-16.3070605965463,-1.4234582587181421,-252.4635696405061,3993607.6926674545,5936263.650567456,60.0,96.0,-4.0,10.680999999999983,365.1643373333334,370.32867466666676,375.0953373333334,380.25967466666674,360.3976746666668,355.2333373333334,350.4666746666668,0.5600656530057444,538803864.0,-1
2014-06-02,370.06201200000004,374.71200600000003,370.06201200000004,367.424988,271.777039,6229856.0,384.29870000000005,382.14187185454546,-29.769012000000032,32.929738482847995,-15.722138775510208,-3.8916053067152347,-151.16701369073306,-7014406.1172144655,5347590.535673888,56.00000000000001,96.0,-4.0,11.644012000000032,370.733002,371.40399199999996,375.382996,376.05398599999995,366.75399799999997,366.083008,362.104004,-0.5671026672292605,545033720.0,+1
2014-06-03,376.0,379.618988,371.843994,374.14401200000003,273.96051,6824936.0,384.02500000000003,380.29556494545454,-2.7369999999999663,40.21101161911218,-13.612555102040808,-6.7899850380541125,-95.0435711263746,34413187.10535695,6668767.528269645,52.0,92.0,-4.0,27.381012,375.20233133333335,378.5606686666667,382.97732533333334,386.3356626666667,370.7856746666667,367.42733733333336,363.0106806666667,0.29582247909130543,551858656.0,+1
2014-06-04,376.875,378.419006,369.18798799999996,377.149994,270.991028,5508008.0,382.71250000000003,379.04556385454543,-13.125,43.38383475140629,-12.668761695447412,-8.197117805335836,-88.28602890891578,4185272.9856552323,6555880.310636822,48.0,88.0,-36.0,36.66299399999997,374.91899600000005,380.65000400000014,384.1500140000001,389.8810220000002,371.4189860000001,365.687978,362.187968,0.8625274048864358,557366664.0,+1
2014-06-05,375.0,383.549988,370.25,373.06201200000004,276.13537599999995,12153720.0,380.5549012,377.2909296727273,-21.575987999999995,40.04891123814561,-13.952272527472514,-6.946187745598763,-78.76809020816384,-12714794.848314589,5679932.367959572,44.0,84.0,-39.99999999999999,9.149993999999992,375.6206666666667,380.9913333333334,388.9206546666667,394.29132133333337,367.6913453333334,362.3206786666667,354.3913573333334,0.2114296644478207,545212944.0,-1
2014-06-06,375.01901200000003,376.25,368.75,380.14401200000003,272.675568,16882424.0,379.6456024,377.21622254545457,-9.092987999999934,48.0338778528618,-6.519031753948451,-7.355210778251262,-76.0238182029082,-24087113.77334636,4326872.780408446,40.0,80.0,-40.0,12.194000000000017,375.048004,381.346008,382.548004,388.846008,373.846008,367.548004,366.346008,1.5192016000000044,562095368.0,+1
2014-06-09,375.75,376.875,372.01300000000003,375.381012,271.168243,10858344.0,378.8143036,376.44084247272724,-8.312988000000018,43.53422120604073,-7.719194657762938,-8.56042117868867,-69.68928861017994,-3718928.7669916125,3961151.4229764096,36.0,76.0,-40.0,9.231018000000063,374.7563373333333,377.4996746666666,379.6183373333332,382.36167466666654,372.6376746666666,369.89433733333334,367.77567466666665,0.6927215137803349,551237024.0,-1
2014-06-10,375.0,386.149994,374.544006,373.306,279.222534,10479176.0,377.45930480000004,375.43933272727276,-13.549987999999985,41.576427907191,-8.412020033388986,-8.894489029282113,-42.81426392896303,1610350.4960115792,3854295.9693362373,32.0,72.0,-40.0,13.299987999999985,378.0,381.455994,389.60598799999997,393.06198199999994,369.850006,366.39401200000003,358.24401800000004,-0.10666959159358468,540757848.0,-1
2014-06-11,388.125,407.156006,386.294006,384.39401200000003,289.95507799999996,20375704.0,376.7231048000001,376.70018858181817,-7.361999999999966,54.25935106455209,-7.386516425709372,-8.579666124395374,52.0501326222322,-7728388.21698843,3327806.251326945,28.000000000000004,68.0,-40.0,7.5,392.61467466666664,398.93534333333326,413.4766746666666,419.79734333333323,378.0733433333333,371.7526746666667,357.21134333333333,-0.0910743936343589,561133552.0,+1
2014-06-12,410.0,412.131012,390.08700600000003,399.169006,288.293091,21128856.0,376.97370600000005,380.78126152727276,2.506012000000055,65.70585312087972,-4.1394833163314955,-8.43216892143812,98.75065916759549,572581.3661506745,3202567.8316829787,24.0,64.0,-40.0,8.131011999999998,400.46234133333337,410.8376766666667,422.5063473333334,432.8816826666667,388.79367066666674,378.4183353333334,366.7496646666668,0.41199408129357284,582262408.0,+1
2014-06-13,398.56201200000004,400.875,391.381012,396.881012,289.378296,10151744.0,380.1056060000001,384.400771709091,31.31899999999996,62.89361245546996,-4.8701659738512255,-9.81509670053714,72.2968470912426,934936.2790568843,3099492.94360997,20.0,60.0,-40.0,11.605987999999968,396.37900800000006,401.3770040000001,405.8729960000001,410.8709920000001,391.8830160000001,386.88502000000005,382.3890280000001,0.5793139827014737,572110664.0,-1
2014-06-16,398.25,407.46200600000003,397.5,398.375,294.567719,9375328.0,383.20060720000004,387.7224797090909,30.950012000000015,64.05279979837817,-4.393053218248469,-11.983213410181634,94.2769044171152,-12652218.47870021,2383501.243062195,16.0,56.00000000000001,-40.0,33.85000600000001,401.1123353333333,404.7246706666666,411.07434133333334,414.68667666666664,394.7626646666666,391.1503293333333,384.80065866666655,0.08783371541836024,581485992.0,+1
2014-06-17,406.125,408.375,402.319,405.51901200000003,294.812469,10079392.0,386.3381072000001,391.7803714909091,31.375,69.33786468040402,-2.1115762242035507,-9.321031530137532,104.10382735681198,-1608078.4547173313,2202064.6369085736,12.0,52.0,-40.0,27.736999999999966,405.40433733333333,408.48967466666664,411.46033733333337,414.5456746666666,402.43367466666666,399.34833733333335,396.3776746666667,0.5284035667107041,591565384.0,+1
2014-06-18,405.625,409.375,401.593994,405.85598799999997,294.235748,9791280.0,389.2087066000001,395.32907709090904,28.705993999999976,69.58127053801698,-2.003961204583604,-6.140365299395455,91.4491369911349,7434316.714557756,2439895.734927638,8.0,48.0,-40.0,9.493988000000002,405.60832733333336,409.6226606666667,413.38933333333335,417.4036666666667,401.8416546666667,397.8273213333334,394.06064866666674,0.5477433123686016,601356664.0,+1
2014-06-19,405.73098799999997,415.375,405.63800000000003,405.06201200000004,300.718842,11313704.0,392.4087066000001,398.2114962545455,32.0,68.11131497778274,-3.259735440537325,-2.934028533400067,98.7886382468711,9471283.205523388,2759506.1267588413,4.0,44.0,-40.00000000000001,10.580994000000032,408.69167066666665,411.7453413333333,418.42867066666656,421.48234133333324,402.0083413333333,398.9546706666667,392.27134133333334,-0.059154565061106834,590042960.0,-1
2014-06-20,415.0,417.424988,411.60598799999997,413.98699999999997,301.14590499999997,8853000.0,395.7930054000001,402.1348223272728,33.842987999999934,74.96975225976267,-1.079685366903435,0.2445514368635031,120.44413445582069,-7159337.189284083,2308647.093786334,0.0,40.0,-40.0,10.0,414.33932533333336,417.07266266666676,420.1583253333334,422.8916626666668,411.25366266666674,408.52032533333335,405.4346626666667,0.4091788967176476,598895960.0,+1
2014-06-23,412.5,413.618988,402.681,414.575012,293.514435,6328112.0,399.7124054000001,405.5497326181819,39.19400000000002,75.37241080156004,-0.8950227235307204,4.440471163192228,92.64781033848027,2087112.859710018,2298577.3021784197,96.0,36.0,-40.0,7.781005999999991,410.2916666666667,417.9023333333334,421.2296546666667,428.8403213333334,406.96434533333337,399.35367866666667,396.02635733333335,1.0874040088542802,605224072.0,+1
2014-06-24,403.75,404.36199999999997,399.01901200000003,404.069,290.903748,10638024.0,402.7887054000001,406.34184072727277,30.763000000000034,56.601046463001325,-4.194390673887682,6.961361123553218,53.33131019037077,-4616347.730679086,1984260.9281054689,92.0,32.0,-40.0,9.736999999999966,402.48333733333334,405.94766266666664,407.8263253333333,411.2906506666666,400.6046746666667,397.1403493333334,395.2616866666668,0.9451617709042294,594586048.0,-1
2014-06-25,405.625,405.625,400.75,400.475006,291.580017,6433520.0,404.39680480000015,405.92116810909096,16.080993999999976,51.53495851026127,-5.3230690551207545,9.016738023025368,50.64838171656987,-3899616.7273660963,1716810.6443369514,88.0,28.000000000000004,-40.0,12.362975999999946,402.28333533333335,403.8166706666667,407.1583353333333,408.6916706666667,398.9416706666667,397.40833533333335,394.0666706666667,-0.05640902564102408,588152528.0,-1
2014-06-26,402.5,404.375,396.093994,401.406006,288.96939100000003,7376552.0,404.62050480000005,405.3773865090909,2.2369999999999663,52.79774875106719,-5.030692503315724,12.48639744338925,39.06842513067236,4806199.777660561,1857238.0743898104,84.0,24.0,60.0,11.305999999999983,400.625,405.156006,408.906006,413.437012,396.875,392.343994,388.593994,0.6414694060117802,595529080.0,+1
2014-06-27,400.0,404.450012,396.5,397.81201200000004,292.683411,6890744.0,404.71360480000004,404.1394787272727,0.93100000000004,47.30731674881636,-6.15937088454878,14.888932505775983,27.612499246974544,39918.205964444955,1774632.2601348374,80.0,20.0,60.0,15.555999999999983,399.58734133333337,402.67468266666674,407.5373533333334,410.62469466666676,394.7246706666667,391.63732933333335,386.7746586666667,0.16503270686887464,588638336.0,-1
2014-07-02,401.5,405.450012,399.774994,402.631012,291.94830299999995,6119632.0,404.9886048,403.6497858545455,-3.2249759999999696,52.63512635708732,-4.645984629824336,15.97591231646686,21.35213378449595,-14666018.004702812,814356.61398064,68.0,8.0,60.0,7.950012000000015,402.61867266666667,405.46235133333334,408.29369066666675,411.13736933333337,399.7873333333333,396.94365466666665,394.1123153333333,0.5032614874525498,594471792.0,-1
2014-07-03,401.274994,403.549988,398.81201200000004,401.91299399999997,291.529938,7504912.0,404.67370300000005,403.0905838909091,-3.149018000000069,51.38788420410465,-4.871475099184118,15.675209310858634,11.08483071285178,-2052838.9100653233,684029.0657170137,64.0,4.0,60.0,10.062987999999962,401.424998,404.037984,406.1629739999999,408.77595999999994,399.30000800000005,396.68702200000007,394.5620320000001,0.6544950839767795,586966880.0,-1
2015-01-05,502.47500599999995,507.5,494.375,503.299988,386.103027,9937024.0,493.4251006,493.5886740363636,11.824982000000034,63.97225168970275,-1.0281547123623047,-14.785121154423848,41.949489466014505,-5742290.389787156,5465601.865923996,4.0,52.0,-48.0,7.236999999999966,501.724996,509.07499199999995,514.8499959999999,522.199992,495.94999199999995,488.599996,482.82499199999995,0.6799990857142846,474920588.0,+1
2015-01-06,495.0,496.25,483.52499400000005,498.97500599999995,378.036255,9667316.0,493.3563018,494.59774774545457,-0.6879880000000753,55.93171416089405,-2.086901835985324,-10.754438124902322,9.391443415082502,-17207362.561332703,4435012.560787385,0.0,48.0,-48.0,6.274994000000049,492.9166666666667,502.3083393333333,505.6416726666667,515.0333453333333,489.58333333333337,480.19166066666673,476.8583273333334,1.2141457536444353,465253272.0,-1
2015-01-07,491.25,493.68798799999996,487.5,488.549988,379.845367,7249916.0,492.22130119999997,493.72387250909094,-11.350006000000064,41.444107322496976,-4.638925826193394,-7.781714737104039,-4.485784549384026,-13077571.883457689,3638985.9855635273,0.0,44.0,-48.00000000000001,11.763000000000034,489.91265866666663,492.32531733333326,496.10064666666653,498.5133053333332,486.1373293333333,483.72467066666667,479.94934133333334,0.16968164773428637,458003356.0,-1
2015-01-08,496.39999400000005,499.25,487.5,490.88800000000003,381.759705,13564920.0,492.0188018,493.4814541090909,-2.0249939999999924,45.12244110478498,-4.066585067319453,-5.876797688935483,11.934896459006412,13173915.483192839,4072391.8767963643,4.0,40.0,-48.0,13.89999400000005,492.546,497.592,504.29600000000005,509.342,485.842,480.796,474.092,0.28834042553191774,471568276.0,+1
2015-01-09,495.02499400000005,527.25,478.26300000000003,493.36199999999997,401.29794300000003,44863328.0,493.0912018000001,493.7256719636364,10.723999999999933,49.03159224807455,-7.913134851138362,-4.681377449187664,64.95042821678041,-11738619.114611883,3353709.551127319,0.0,36.0,-48.0,19.774993999999936,499.625,520.987,548.612,569.9739999999999,472.0,450.63800000000003,423.01300000000003,0.3082246310245564,516431604.0,+1
2015-01-12,523.0,529.799988,518.75,518.612,409.32608,12758888.0,496.14620060000004,498.36581709090905,30.549987999999928,72.28283233615947,-2.5970260704835533,-1.887806588297451,244.87624405094007,-1594800.6607416447,3128777.266416139,0.0,32.0,-44.0,11.47500599999995,522.3873293333332,526.0246586666665,533.4373173333333,537.0746466666665,514.9746706666665,511.33734133333326,503.9246826666665,-0.012488701345199093,529190492.0,+1
2015-01-13,526.950012,526.950012,518.75,528.987,404.093719,8801236.0,500.0998994000001,504.3368715272727,39.53698799999995,77.21155494388522,-0.18871588269404002,2.477877010105999,215.53809153683812,-488426.69808002055,2964358.902751449,96.0,28.000000000000004,-36.0,11.75,524.8956706666667,531.0413413333333,533.0956826666666,539.2413533333333,522.8413293333333,516.6956586666666,514.6413173333333,1.2484128072007636,537991728.0,+1
2015-01-14,524.625,533.25,523.150024,522.224976,411.78283700000003,9921260.0,503.16369640000005,508.35961272727275,30.637969999999996,68.10413212227438,-2.5388656303972437,5.745676225262628,182.02183967183254,1044670.1503178674,2877100.3222634913,92.0,24.0,-36.0,48.986999999999966,526.2083333333334,529.2666426666667,536.3083093333335,539.3666186666667,519.1666666666667,516.1083573333334,509.0666906666668,-0.09158912852862854,528070468.0,-1
2015-01-15,533.799988,538.200012,528.062012,532.1619870000001,412.86621099999996,8342452.0,507.06609510000004,513.6320292,39.023987000000034,73.420213889246,-1.3747779679022294,7.753713490500786,192.83315151770034,-6350755.381338687,2457652.331919047,96.0,20.0,-32.0,36.43798800000002,532.8080036666667,537.5539953333333,542.9460036666668,547.6919953333334,527.4159953333333,522.6700036666666,517.2779953333333,0.4044165515880916,536412920.0,+1
2015-01-16,537.0,540.0,528.0,533.562012,409.781067,6690960.0,511.06229570000005,518.4494686363637,39.96200600000003,74.1213884125221,-1.4598612244898002,9.646172548576715,170.4844115848107,-6677139.592309809,2042434.5135745483,96.0,16.0,68.0,8.338012000000049,533.8540039999999,539.7080079999998,545.8540039999998,551.7080079999998,527.7080079999998,521.8540039999999,515.7080079999998,0.46350099999999844,543103880.0,+1
2015-01-19,530.0,533.0880129999999,523.650024,529.575012,406.724579,4087744.0,513.6897981,521.8154170545455,26.27502400000003,68.20885313532436,-2.363942857142854,11.433052726400092,120.0989472357713,-5850920.212451165,1683645.6594165782,96.0,12.0,68.0,10.09997599999997,528.7710163333334,533.8920086666667,538.2090053333332,543.3299976666666,524.4540196666668,519.3330273333335,515.0160306666669,0.6277807698228983,539016136.0,-1
2015-01-20,526.75,533.25,525.362,525.625,410.92236299999996,6804504.0,516.3547975,523.9854537636364,26.64999400000005,62.50888969406454,-3.259637188208617,12.602396116795205,100.58939736997498,442786.39245412394,1627242.9650173213,92.0,8.0,76.0,15.975036000000046,528.0790000000001,530.7960000000002,535.9670000000002,538.6840000000002,522.9080000000001,520.191,515.0200000000001,0.033341784989862136,532211632.0,-1
2015-01-21,532.875,543.987,529.5,531.049988,419.76293899999996,8494908.0,520.6047975,526.6573065818181,42.5,66.89316003814416,-2.9072786396007038,12.999306371143575,112.97369777554646,11941829.034660757,2096087.7899069078,88.0,4.0,80.0,12.0,534.8456626666667,540.1913253333335,549.3326626666667,554.6783253333334,525.7043253333335,520.3586626666668,511.2173253333335,0.1069916476841298,540706540.0,+1
2015-01-22,543.700012,550.75,540.325012,542.474976,424.89859,9958396.0,525.7634951,530.6337026727273,51.586975999999936,74.21921323424489,-1.8317706696181584,14.213907737408704,126.79177570639165,-6486815.040741943,1705955.840245733,96.0,0.0,84.0,9.911987999999951,544.5166626666667,548.7083133333333,554.9416506666666,559.1333013333333,538.2833253333333,534.0916746666667,527.8583373333333,0.2062317961421114,550664936.0,+1
2015-01-23,550.0,556.25,541.275024,549.112,428.49755899999997,9486328.0,531.3384951,534.8788853818182,55.75,77.54924803716857,-1.5610716238381703,17.530577636724388,117.31807489515025,7997683.033683792,1991943.4419161612,96.0,60.0,84.0,7.888000000000034,548.879008,556.482992,563.8539839999999,571.4579679999999,541.508016,533.904032,526.53304,0.5233381342313972,560151264.0,+1
2015-01-27,555.25,555.25,532.525024,553.763,413.301849,13739968.0,534.8535951,538.9560680909091,35.15100000000007,79.67230479184973,-0.5439037725533005,21.06994440386444,93.90863342203195,456426.6936299258,1922147.2256263408,96.0,56.00000000000001,84.0,18.361999999999966,547.1793413333334,561.8336586666667,569.9043173333334,584.5586346666666,539.1086826666667,524.4543653333334,516.3837066666667,0.9345653874397946,573891232.0,+1
2015-01-28,537.5,538.700012,532.575012,534.125,414.859467,13134356.0,535.3673951,538.8235962545454,5.138000000000034,54.543472059506,-4.838709677419355,24.640728994093138,46.51294305622503,1927721.9451332272,1922400.621969152,92.0,52.0,96.0,19.700012000000015,535.1333413333333,537.6916706666666,541.2583413333334,543.8166706666666,531.5666706666666,529.0083413333333,525.4416706666666,0.25305926530612,560756876.0,-1
2015-01-29,536.25,537.474976,531.900024,536.138,415.042816,15369424.0,536.7586975,538.9637062363636,13.913024000000064,56.178214832579215,-4.398469108802617,25.58333505151677,38.72950015773859,4406720.944329674,2035324.2736616328,88.0,48.0,36.0,14.97497599999997,535.1709999999999,538.4419759999998,540.7459519999998,544.0169279999998,532.8670239999999,529.596048,527.292072,0.7601816123259985,576126300.0,+1
2015-01-30,540.375,540.638,531.737,536.375,414.346436,10833744.0,537.1799988000001,538.8939430545454,4.213012999999933,56.39126365878865,-4.346637506834336,25.209283817431526,34.56800310937368,-7565098.420003703,1598941.4214556317,84.0,44.0,39.99999999999999,22.72497599999997,536.25,540.763,545.151,549.6640000000001,531.862,527.3489999999999,522.9609999999999,0.5210650488709132,586960044.0,+1
2015-02-02,535.375,538.0,531.513,535.474976,413.369934,8702540.0,537.3712952000001,538.5839389090909,1.9129639999999881,55.21501291869293,-4.54347162383817,25.365688680346466,26.186713248415995,-13574177.693870312,909254.1851783965,80.0,40.0,40.0,21.18798800000002,534.995992,538.478984,541.4829920000001,544.9659839999999,531.991984,528.508992,525.504984,0.6107562817943513,578257504.0,-1
2015-02-03,534.2130129999999,534.987,525.5,534.2130129999999,410.283997,5265956.0,537.8350953,538.0097057818182,4.638000999999917,53.41252794011387,-4.819461344997281,23.51841543364708,14.592964955258173,-6121347.419837758,589681.3832862817,76.0,36.0,40.0,5.574951999999939,531.566671,537.6333420000001,541.0536710000001,547.120342,528.1463420000001,522.0796710000001,518.6593420000002,0.9184160430062152,572991548.0,-1
2015-02-04,534.974976,537.5,531.599976,530.224976,414.53060899999997,5160016.0,538.2950929,536.6260477272726,4.59997599999997,47.730879277346446,-5.691640021869881,21.657988930952115,14.326726100128473,847371.7777777778,601394.5830941166,72.0,32.0,40.0,8.901000000000067,533.1083173333333,534.6166586666666,539.0083413333332,540.5166826666666,528.7166346666666,527.2082933333332,522.8166106666665,-0.2330498994580349,567831532.0,-1
2015-02-05,537.700012,555.0,537.0,535.7130129999999,424.38644400000004,11875936.0,538.7613954,536.1565786545455,4.663024999999948,55.28360604758123,-4.491413231273935,20.526765033764832,36.1995844932808,-6156118.232432317,294234.90820372954,68.0,28.000000000000004,40.0,6.486999999999966,542.5710043333333,548.1420086666667,560.5710043333333,566.1420086666667,530.1420086666667,524.5710043333333,512.1420086666667,-0.07149927777778152,579707468.0,+1
2015-02-06,551.25,561.950012,547.125,548.450012,431.48593099999994,7453728.0,539.358899,537.918145309091,5.9750360000000455,67.7592237880504,-2.916081574699257,20.429546674452467,61.47282274707315,1122012.555924411,331861.1650887149,64.0,24.0,40.0,9.97497599999997,552.5083413333333,557.8916826666666,567.3333533333334,572.7166946666666,543.0666706666666,537.6833293333333,528.2416586666666,0.08937679106094577,587161196.0,+1
2015-02-09,550.0,563.5,550.0,557.625,435.04534900000004,6536868.0,540.210199,541.2392545818182,8.513000000000034,73.82819705281777,-1.264800861141012,20.004909274621696,69.99270876439326,-3242663.7427526964,169382.7594844177,96.0,20.0,40.0,5.90002400000003,557.0416666666666,564.0833333333333,570.5416666666665,577.5833333333333,550.5833333333333,543.5416666666666,537.0833333333333,0.5648148148148148,593698064.0,+1
2015-02-10,560.75,574.5,560.25,562.224976,440.732758,8516920.0,541.0563966,545.2419413090909,8.461975999999936,76.39830250286633,-2.5814982124079977,18.185822290701253,93.49251105750425,1348346.3970481276,222972.0159584562,96.0,16.0,40.0,24.77502400000003,565.6583253333333,571.0666506666666,579.9083253333333,585.3166506666666,556.8166506666666,551.4083253333333,542.5666506666666,0.13859480701754173,602214984.0,+1
2015-02-11,570.125,573.299988,564.062012,569.575012,442.000183,5796972.0,544.6013978,550.4271441090909,35.450012000000015,80.01634759346102,-1.0357493165089346,16.18938846142396,95.82827913082845,3006149.85748157,349480.1001623737,96.0,12.0,40.0,26.236999000000083,568.979004,573.8959960000001,578.21698,583.1339720000001,564.6580200000001,559.741028,555.4200440000001,0.5967757439508429,608011956.0,+1
2015-02-12,570.75,580.487,568.25,571.2130129999999,447.09713700000003,6287536.0,548.1088991,555.2656195999999,35.0750129999999,80.7742052456087,-1.926113685312383,13.232078304253264,102.41900139298859,-1029241.3199373434,286810.9444676596,92.0,8.0,76.0,15.049987999999985,573.316671,578.3833420000001,585.5536710000001,590.620342,566.1463420000001,561.0796710000001,553.9093420000002,0.24213557244422168,614299492.0,+1
2015-02-13,574.900024,581.674988,571.5,577.799988,444.176117,5657516.0,552.2513979,560.6639994,41.424987999999985,83.65108363848451,-0.8028176508702788,12.468023916493166,109.19509880956244,-7622118.3476685975,-72685.8428288007,96.0,4.0,80.0,16.875,576.9916586666667,582.4833173333334,587.1666466666666,592.6583053333334,572.3083293333334,566.8166706666667,562.1333413333334,0.619164170021625,619957008.0,+1
2015-02-16,570.075012,576.724976,566.312012,574.025024,440.82016,6244276.0,556.1064027,564.6228405090908,38.55004800000006,76.11916019839595,-1.5849099684444299,11.590988675845779,87.82285922368007,4305651.584728382,126329.49546925157,96.0,0.0,84.0,11.075012000000015,572.3540039999999,578.3959959999999,582.7669679999998,588.8089599999998,567.9830319999999,561.9410399999999,557.5700679999999,0.7407124426820315,613712732.0,-1
2015-02-18,572.638,576.237,564.5369870000001,569.687988,444.25350999999995,8613764.0,559.6539002000001,567.0922196545455,35.474975000000086,68.00233371101643,-2.483451659608259,10.834287849819816,74.53515424156546,741508.7235274836,154292.18774516098,92.0,0.0,84.0,12.236999999999966,570.1539916666667,575.7709963333333,581.8540046666666,587.4710093333332,564.0709833333334,558.4539786666668,552.3709703333335,0.4402560065531547,605098968.0,-1
2015-02-19,573.5,583.5,573.013,574.125,449.70874000000003,9673624.0,564.0439026,569.7233287090909,43.90002400000003,71.57972198385369,-1.9349845201238391,12.030741036268182,88.66605085548603,-3751666.9810976707,-23251.41139282044,88.0,0.0,92.0,10.461975000000052,576.8793333333333,580.7456666666666,587.3663333333333,591.2326666666665,570.2586666666666,566.3923333333333,559.7716666666666,0.10603604462667779,614772592.0,+1
2015-02-20,582.125,584.0,569.224976,581.174988,441.66128499999996,6971628.0,568.5901001,572.8380715090909,45.46197500000005,76.41414898060447,-0.582476701030931,14.473063996641713,82.22389472025856,-7633419.8145473,-369168.15802147554,96.0,0.0,96.0,11.487976000000003,578.1333213333334,587.0416666666667,592.9083453333333,601.8166906666668,572.2666426666667,563.3582973333333,557.4916186666667,0.8087981447610502,621744220.0,+1
2015-02-23,575.0,577.299988,562.025024,570.775024,438.27600099999995,5090488.0,570.8226013,573.2353304,22.325012000000015,59.25692072367927,-2.7267991752577254,17.115691959460946,48.33759156003743,8188990.110698722,19839.03711769379,96.0,8.0,92.0,11.700012999999899,570.0333453333334,578.0416666666667,585.3083093333335,593.3166306666667,562.7667026666668,554.7583813333334,547.4917386666668,0.5728327739430369,616653732.0,-1
2015-02-24,569.75,573.987,564.400024,566.400024,439.668762,6437676.0,571.7001037,572.4312254363637,8.77502400000003,53.43346455969003,-3.628861030927829,19.843702563544753,38.74245978403464,-4268213.206139076,-175072.42901406428,92.0,4.0,88.0,13.812011999999982,568.2623493333334,572.1246746666668,577.8493253333334,581.7116506666667,562.5376986666669,558.6753733333335,552.9507226666669,0.20861635618989902,610216056.0,-1
2015-02-25,572.224976,583.700012,570.0,568.200012,448.335266,6044972.0,572.2976073,571.7948451272728,5.9750360000000455,55.50910595385746,-3.2577294845360796,21.21193894533849,51.74423556805145,428272.56011014024,-147647.65671007303,88.0,0.0,96.0,14.77502400000003,573.9666746666667,577.9333493333334,587.6666866666667,591.6333613333334,564.2333373333333,560.2666626666667,550.5333253333333,-0.13138587031894444,616261028.0,+1
2015-02-26,576.875,577.25,561.349976,579.400024,436.825134,6445776.0,573.2801085000001,573.0861936181818,9.825012000000015,66.2952514085286,-0.9484486597938081,21.50448757434185,40.13459472266342,2110292.1480562375,-45014.028966804464,84.0,0.0,88.0,19.149963999999954,572.6666666666666,583.9833573333333,588.5666906666665,599.8833813333333,568.0833333333333,556.7666426666666,552.1833093333332,1.135221431112307,622706804.0,+1
2015-02-27,568.724976,570.1619870000001,562.875,564.525024,438.305389,7801076.0,572.6113096,571.4943600727274,-6.687988999999902,48.3370850726533,-4.015458969072159,20.633648789178665,14.574040374367936,1494413.0174675444,24959.92785453286,80.0,32.0,88.0,9.586975999999936,565.8540036666667,568.8330073333334,573.1409906666668,576.1199943333335,561.5460203333333,558.5670166666666,554.2590333333333,0.22643432738387143,614905728.0,-1
2015-03-03,572.5,575.737,569.575012,572.924988,444.51504500000004,4905552.0,572.1238096,571.551392509091,-4.875,56.087668895165685,-2.2835076288659826,19.2871682839924,31.432281863755385,-1252901.5295641723,-33124.683977239074,76.0,28.000000000000004,88.0,17.299987999999985,572.7456666666666,575.9163213333331,578.9076546666665,582.0783093333331,569.7543333333332,566.5836786666666,563.5923453333332,0.5436518214576199,619811280.0,+1
2015-03-04,575.0,578.474976,562.974976,574.4630129999999,440.026276,4375228.0,572.1676085,571.9767022181818,0.43798899999990226,57.43670817959376,-1.9663890721649622,18.43555856797832,23.93682529004063,-4492145.145893555,-235807.4326822403,72.0,24.0,84.0,15.90002400000003,571.9709883333334,580.9670006666668,587.4709883333335,596.4670006666668,565.4670006666668,556.4709883333334,549.9670006666668,0.7411636774193524,624186508.0,+1
2015-03-05,566.763,574.687988,558.3380129999999,568.6619870000001,434.793915,5684916.0,572.0650084000001,571.339316490909,-1.026000999999951,50.66311214755893,-3.1624769072164813,16.89152697059103,2.5196144949412362,2333842.426873836,-119005.16609890174,68.0,20.0,48.0,16.52502400000003,567.2293293333333,576.1206456666667,583.5793043333334,592.4706206666668,559.7706706666667,550.8793543333333,543.4206956666666,0.6314366841539563,618501592.0,-1
2015-03-09,564.75,564.75,544.75,561.900024,423.66140700000005,7984720.0,570.8425108000001,569.4911375090909,-12.22497599999997,43.727286551298796,-4.556696082474221,15.896730476041398,-42.068111297935005,-4938964.735770732,-338094.2378771193,64.0,16.0,-64.0,0.0,557.1333413333333,569.5166826666666,577.1333413333332,589.5166826666666,549.5166826666666,537.1333413333333,529.5166826666666,0.8575012000000015,610516872.0,-1
2015-03-10,549.525024,551.737,540.049988,547.513,425.198883,6329916.0,567.476312,565.2494082727274,-33.66198799999995,32.727860961080324,-7.523092783505147,13.831214667086442,-93.0540665835785,3252105.781366971,-174903.3276061042,60.0,12.0,-60.0,0.0,546.4333293333333,552.8166706666666,558.1203413333333,564.5036826666666,541.1296586666666,534.7463173333333,529.4426466666666,0.6385731442733233,604186956.0,-1
2015-03-11,548.525024,560.0,542.275024,549.5,422.142426,6780912.0,565.3488096000001,561.9809879090909,-21.27502400000003,35.320596894547606,-7.11340206185567,11.175726700230143,-78.2730935460094,-536087.6195724898,-191320.79545208323,56.00000000000001,8.0,48.0,0.0,550.5916746666667,558.9083253333333,568.3166506666666,576.6333013333333,541.1833493333334,532.8666986666667,523.4583733333334,0.4076155589717008,610967868.0,+1
2015-03-12,544.75,556.612,544.25,545.549988,429.125885,5688564.0,563.263806,558.3812021636363,-20.850036000000046,32.45173631623467,-7.927837525773199,7.232329744872686,-87.82870325516741,-3348178.0312380088,-334814.306414285,52.0,4.0,48.0,15.5,548.803996,553.357992,561.165996,565.7199919999999,540.995992,536.441996,528.633992,0.10516000647144381,605279304.0,-1
2015-03-13,556.25,557.5,548.099976,554.575012,429.532074,6179684.0,561.9013060000001,556.8014214363636,-13.625,44.36492326771891,-6.067007835051543,4.63946378581204,-63.94932410184905,-7325270.884846155,-652562.3332237845,48.0,0.0,48.0,16.349975000000086,553.3916626666667,558.6833493333334,562.7916866666667,568.0833733333334,549.2833253333333,543.9916386666666,539.8833013333333,0.688831858301641,611458988.0,+1
2015-03-16,552.638,570.5,552.638,555.099976,438.478699,6818632.0,559.4713012000001,555.5648159818181,-24.30004800000006,45.01577333159677,-5.958767835051552,2.43628944112902,-35.01009796192486,1477029.5999999724,-555762.6997450495,44.0,0.0,48.0,23.911987000000067,559.4126586666666,566.1873173333332,577.2746586666666,584.0493173333332,548.3253173333333,541.5506586666667,530.4633173333333,0.13783316537901358,618277620.0,+1
2015-03-17,566.6619870000001,569.875,554.312012,566.6619870000001,433.42044100000004,5539312.0,559.6849975000001,556.8722134,2.136963000000037,57.616170112808376,-3.5151690897833,-0.10398738193634927,-12.38735302823777,1065354.2796008855,-482075.5642109616,40.0,0.0,48.0,21.850036000000046,563.6163329999999,572.9206539999999,579.179321,588.4836419999999,557.3576659999999,548.0533449999999,541.7946779999999,0.7935478071434657,623816932.0,+1
2015-03-18,563.625,565.7130129999999,555.638,560.125,431.29247999999995,4905564.0,558.4049987000001,556.9522138545454,-12.799987999999985,50.12285419023051,-4.863835654289197,-4.198755260260668,-27.286564969343065,-1522075.2522716047,-529348.2773715428,36.0,76.0,48.00000000000001,17.72497599999997,560.4920043333333,565.3460086666665,570.5670173333332,575.4210216666664,555.2709956666666,550.4169913333334,545.1959826666667,0.445359226831768,618911368.0,-1
2015-03-19,558.650024,562.25,555.687988,557.375,431.475861,6891740.0,556.6961974000001,556.7649413636364,-17.088012999999933,47.14651623066958,-5.43119689462686,-5.725889871549839,-37.29369954703914,17335885.278732385,282707.7944576879,32.0,72.0,48.0,12.361999999999966,558.4376626666667,561.1873373333334,564.9996746666667,567.7493493333334,554.6253253333334,551.8756506666667,548.0633133333334,0.2570876127626689,612019628.0,-1
2015-03-20,560.25,567.224976,558.237,557.612,436.698975,6430896.0,555.5911987000001,556.9314509272727,-11.049987000000101,47.456776895319514,-4.3512126897734085,-7.96747127523372,-19.340663584406606,-15510693.944114668,-435174.10367604374,28.000000000000004,68.0,48.0,11.950012000000015,561.0246586666667,563.8123173333335,570.0126346666667,572.8002933333335,554.8243413333335,552.0366826666667,545.8363653333334,-0.06953734633915352,618450524.0,+1
2015-03-23,563.25,568.75,556.375,564.362,432.056213,5078700.0,555.8373963,558.5261420727273,2.461975999999936,55.953768523380454,-2.9434228492458394,-10.157858384020756,-0.042638976905149936,-3137133.5027025347,-557990.4401466334,24.0,64.0,44.0,17.861999999999966,563.1623333333333,569.9496666666666,575.5373333333332,582.3246666666666,557.5746666666666,550.7873333333333,545.1996666666666,0.6454141414141387,623529224.0,+1
2015-03-24,558.724976,563.349976,551.5,558.362,427.80038499999995,6736532.0,556.9222963,558.9851609272728,10.848999999999933,47.99352248864166,-4.194791596381457,-11.402927213670296,-33.8996333877404,-2545043.4178670356,-648311.030149158,20.0,60.0,40.0,15.562988000000018,557.7373253333334,563.9746506666668,569.5873013333335,575.8246266666667,552.1246746666668,545.8873493333334,540.2746986666668,0.5790729027636836,616792692.0,-1
2015-03-25,555.724976,557.2869870000001,550.187988,552.862,429.28064000000006,6170968.0,557.2584962999999,558.2469252363636,3.3619999999999663,41.71636589331717,-5.341879614589105,-11.854585380334925,-63.34873644588973,12816678.445014514,-36266.0533187877,16.0,56.00000000000001,-40.0,11.023987000000034,553.4456583333334,556.7033286666668,560.5446573333335,563.8023276666669,549.6043296666668,546.3466593333334,542.5053306666667,0.37667451425192894,610621724.0,-1
2015-03-26,552.0,553.724976,533.0,554.775024,415.207703,15740840.0,558.1809999000001,557.7953848181818,9.225036000000046,44.623159182076456,-4.186139760165646,-9.85378345924562,-104.8044746929003,890823.4833234599,5874.3802100735375,12.0,52.0,-40.0,6.5620119999999815,547.1666666666666,561.3333333333333,567.8916426666665,582.0583093333332,540.6083573333333,526.4416906666667,519.8833813333333,1.0506658246552403,626362564.0,+1
2015-03-27,541.0,556.174988,540.75,536.5880129999999,426.00125099999997,10074220.0,556.3823,553.8693872,-17.986999000000083,28.843343044734738,-7.192362036055157,-8.708431370528388,-103.34335223385416,6788017.5198340425,314153.6141444366,8.0,96.0,-40.0,9.84997599999997,544.5043336666666,548.2586673333333,559.9293216666665,563.6836553333333,532.8336793333333,529.0793456666667,517.4086913333333,-0.26982108511203196,616288344.0,-1
2015-03-30,551.400024,560.0,548.724976,550.5369870000001,431.002258,4623088.0,555.9260011,552.8066030181818,-4.562988999999902,45.80385219223809,-4.233937009543994,-6.865850478601828,-33.22441756123247,-18853959.699724946,-557124.2646087704,4.0,92.0,-40.0,12.375,553.087321,557.449666,564.362345,568.72469,546.174642,541.812297,534.8996179999999,0.16071016788967304,620911432.0,+1
2015-03-31,561.25,568.4119870000001,551.0880129999999,557.0,429.13595599999996,8016412.0,554.9598024000001,553.0018755454546,-9.661987000000067,51.929382860230945,-2.863202545068929,-5.729464721757495,11.044652689290151,-673479.6449501038,-562413.1455383019,0.0,88.0,-40.0,12.861999999999966,558.8333333333334,566.5786536666668,576.1573073333335,583.902627666667,549.2546796666667,541.5093593333332,531.9307056666665,0.34126044058944105,628927844.0,+1
2015-04-01,549.724976,549.875,539.424988,554.5880129999999,420.546021,6738488.0,554.4061036999999,552.9342774727272,-5.536987000000067,49.51927003331533,-3.3747586426299185,-4.221467513591392,-76.99906008622303,-4663746.669025581,-748837.3967716293,8.0,84.0,-40.00000000000001,8.174011999999948,547.9626669999999,556.5003459999998,558.4126789999998,566.9503579999998,546.0503339999998,537.5126549999999,535.6003219999998,1.4510055108070619,622189356.0,-1
2015-04-06,544.75,546.174988,540.099976,543.487,421.36859100000004,7741752.0,553.0173037,550.9489858909091,-13.888000000000034,39.72768451420115,-5.7291622481442275,-5.242990255773975,-119.90044464703587,1361447.8283417125,-652915.3410032642,4.0,80.0,-40.0,20.72497599999997,543.2539879999999,546.4079999999999,549.329,552.4830119999999,540.3329879999999,537.1789759999999,534.2579759999999,0.5575337135136503,614447604.0,-1
2015-04-07,543.75,545.700012,534.5,544.549988,417.751129,8542268.0,551.7111024999999,549.4094739454545,-13.062011999999982,41.016303224557376,-5.5037141039236515,-5.727305917494505,-126.57622149820817,4689215.032819423,-410091.2329055496,0.0,76.0,-88.0,15.424987999999985,541.5833333333334,548.6666666666667,552.7833453333333,559.8666786666668,537.4666546666667,530.3833213333334,526.2666426666667,0.8973193957292163,622989872.0,+1
2015-04-08,545.625,551.224976,543.263,539.875,425.692505,10185576.0,549.2624025,547.2574553090909,-24.486999999999966,37.001819659686916,-6.371117600212371,-5.910314346625,-81.35326259851756,4586944.482979388,-182953.24564425537,12.0,72.0,-88.0,23.411987000000067,544.7876586666666,546.3123173333332,552.7496346666666,554.2742933333332,538.3503413333333,536.8256826666667,530.3883653333334,-0.42552250848282647,612804296.0,-1
2015-04-09,552.849976,554.724976,546.099976,550.138,428.487549,10581548.0,548.4400025,547.4166548545454,-8.223999999999933,49.517529927111845,-3.962107503991478,-5.225698190143589,-26.07182584619478,6357042.254629909,114319.27731487289,8.0,68.0,-88.0,17.875,550.320984,554.5419919999999,558.945984,563.1669919999999,545.9169919999999,541.695984,537.2919919999999,0.46817669565218134,623385844.0,+1
2015-04-10,552.549988,559.5,552.549988,553.75,432.152954,7123776.0,548.5288025,548.3821089454545,0.8880000000000337,53.286247321321376,-3.1931878658861095,-6.370072079952024,18.774690653436224,12527966.328479938,678575.9618562442,4.0,64.0,-76.0,17.575012000000015,555.2666626666667,557.9833373333333,562.2166746666667,564.9333493333334,551.0333253333333,548.3166506666666,544.0833133333333,0.17266329899862223,630509620.0,+1
2015-04-13,559.5,561.0,554.025024,558.487,433.091583,4872336.0,548.9000001,550.192690309091,3.711975999999936,58.02777723344719,-2.1847791378392833,-6.1400105285378,40.80316627438996,-2767089.1074230103,521954.8222382305,0.0,60.0,-76.0,14.488036999999963,557.8373413333334,561.6496586666667,564.8123173333333,568.6246346666667,554.6746826666667,550.8623653333334,547.6997066666668,0.6397120219481695,635381956.0,+1
2015-04-15,559.125,561.25,548.763,559.700012,428.23596200000003,6237784.0,551.2112,552.1563288363636,23.111999000000083,59.24989235332443,-1.9265541245343236,-5.024779817039644,26.168926105302965,6982162.016352306,815600.6039773579,0.0,56.00000000000001,-76.0,11.200012000000015,556.571004,564.379008,569.0580039999999,576.866008,551.892008,544.084004,539.4050080000001,0.8758718667414119,641619740.0,+1
2015-04-16,555.5,557.75,540.125,553.424988,424.550446,9007812.0,551.5000001000001,552.5588357454545,2.8880009999999174,50.47701576697894,-3.1927175732732365,-4.665122781021182,-29.277365791047067,4193394.1680841725,969136.6751671955,20.0,52.0,-60.0,7.961975999999936,550.4333293333333,560.7416586666666,568.0583293333334,578.3666586666666,543.1166586666666,532.8083293333333,525.4916586666666,0.7546092482269495,632611928.0,-1
2015-04-17,545.013,548.737,538.362,548.6619870000001,421.57135,6450316.0,550.6661988000001,552.0428333636364,-8.338012999999933,44.682642227806205,-4.207391491261598,-2.264175028611703,-71.2851949474203,29128977.244022377,2249129.4290455934,16.0,48.0,-60.0,14.84997599999997,545.2536623333334,552.1453246666669,555.6286623333334,562.5203246666669,541.7703246666669,534.8786623333334,531.3953246666669,0.9927698313253109,626161612.0,-1
2015-04-20,544.0,545.0,528.7869870000001,544.812012,412.45993,12825384.0,549.6885987000001,550.9784357636364,-9.776000999999951,40.361439799813745,-5.0275612156449005,-2.6753344742387526,-117.58635336493248,14820976.049471084,2820577.0030203224,12.0,44.0,-60.0,9.361999999999966,539.5329996666666,550.2790123333331,555.7460126666664,566.492025333333,534.0659993333331,523.3199866666666,517.8529863333332,0.9884051163099654,613336228.0,-1
2015-04-21,537.0,538.775024,530.025024,533.0369870000001,414.481842,8881648.0,548.6435974000001,547.95087,-10.450012999999899,30.091613903294586,-7.536024000171089,-4.221262367977488,-162.33061167380598,12231054.170400072,3248325.965401895,8.0,96.0,-60.0,7.25,533.9456783333334,537.8663326666667,542.6956783333335,546.6163326666667,529.1163326666667,525.1956783333334,520.3663326666667,0.3442243428571471,604454580.0,-1
2015-04-22,537.763,538.75,524.487,535.650024,413.533966,12350984.0,547.7536010000001,545.588402109091,-8.899963999999954,34.36769299218615,-6.979362246239364,-5.761945643285117,-154.7776519507524,2885066.65061334,3231814.178357652,4.0,92.0,-56.00000000000001,12.486999999999966,532.9623413333334,541.4376826666668,547.2253413333334,555.7006826666668,527.1746826666667,518.6993413333333,512.9116826666667,0.7826561032040972,616805564.0,+1
2015-04-23,537.174988,537.5,528.0,534.424988,410.496826,11891800.0,547.2085998,543.1650179272727,-5.450012000000015,33.26696298274531,-7.2403347041071795,-5.31555087281879,-122.6038618785262,10043066.0005569,3541416.5340624917,0.0,96.0,-32.0,19.575012000000015,533.3083293333333,538.6166586666666,542.8083293333334,548.1166586666666,529.1166586666666,523.8083293333333,519.6166586666666,0.6763145263157879,604913764.0,-1
2015-04-24,533.974976,537.549988,495.0,530.5,385.96759,43565452.0,545.2447998000001,540.1270906909091,-19.638000000000034,29.745021741647108,-6.652244456462952,-5.074696746990639,-190.99470736905718,-17443134.127117462,2587573.3217485845,0.0,92.0,-32.0,15.062988000000018,521.0166626666667,547.0333253333333,563.5666506666666,589.5833133333333,504.48333733333334,478.4666746666667,461.93334933333335,0.8343128087368676,561348312.0,-1
2015-04-27,500.0,500.5,487.02499400000005,498.799988,383.92715499999997,19822640.0,539.7497986000001,531.6825794545455,-54.950012000000015,14.9728829277647,-13.510008004326664,-4.26503577348069,-323.5676465130365,5546599.314683458,2722074.5033051297,12.0,96.0,-32.0,19.875,495.4416606666667,503.8583273333333,508.9166666666666,517.3333333333333,490.38332133333336,481.9666546666667,476.9083153333334,0.8738396109062941,541525672.0,-1
2015-04-28,495.5,495.5,488.0,496.162994,379.332336,10393500.0,533.5173980000002,523.757705890909,-62.32400599999994,14.291629859983033,-14.080477230935633,-5.444505625597117,-253.8045295767678,6196595.9708182765,2880007.297349696,8.0,96.0,-88.0,14.786987999999951,493.220998,498.441996,500.720998,505.941996,490.941996,485.720998,483.441996,1.0883992000000036,531132172.0,-1
2015-04-29,490.22500599999995,493.0,484.48699999999997,490.22500599999995,379.381042,8289056.0,526.5698974000001,515.8863618909091,-69.47500600000006,12.780726571157203,-15.365060897782595,-7.680935768984796,-216.56195324011694,-3917903.3865860603,2571011.357046238,4.0,92.0,-88.0,14.263000000000034,489.2373353333333,493.98767066666665,497.7503353333333,502.5006706666667,485.4746706666666,480.7243353333333,476.9616706666666,0.6740286620462776,522843116.0,-1
2015-04-30,490.0,491.25,483.075012,490.287994,375.724182,13134260.0,520.256198,509.2896521818182,-63.13699399999996,12.89343909748726,-15.351434505137906,-10.894452012729175,-173.17976936220265,-6424271.453258588,2162134.8655114155,0.0,96.0,-96.0,9.5,488.20433533333335,493.3336586666667,496.37932333333333,501.50864666666666,485.1586706666667,480.02934733333336,476.9836826666667,0.8823232523399452,535977376.0,+1
2015-05-04,489.875,500.0,487.47500599999995,485.56201200000004,385.561401,13361592.0,513.9462005,502.98161836363636,-63.09997500000003,11.596099150616126,-16.373821092482416,-14.390507274053562,-127.48382346096628,-3634577.8971482366,1898647.9216573804,20.0,96.0,-92.0,42.549987999999985,491.01233933333333,494.5496726666667,503.5373333333334,507.07466666666676,482.02467866666666,478.4873453333333,469.4996846666666,-0.15273412506224793,522615784.0,-1
2015-05-05,500.0,500.924988,488.01300000000003,498.27499400000005,379.690582,9408516.0,509.29249870000007,500.1323080909091,-46.53701799999993,32.634983774698796,-13.623581611681978,-17.51052478584063,-91.89970549626219,7986257.733855059,2175357.458672472,16.0,92.0,-84.0,43.47500599999995,495.73766066666667,503.4623213333333,508.6496486666666,516.3743093333333,490.55033333333336,482.8256726666667,477.6383453333334,0.7947648340441499,532024300.0,+1
2015-05-06,493.75,493.75,478.825012,490.68798799999996,371.817261,10508408.0,505.05759880000005,496.74966978181817,-42.348999000000106,28.039852616532542,-15.264902541914557,-20.897870139522638,-98.30444106265449,156009.67916823973,2083568.9232097429,12.0,88.0,-88.0,10.799987999999985,487.7543333333333,496.6836546666666,502.6793213333333,511.6086426666666,481.7586666666666,472.8293453333333,466.83367866666663,0.7948399020488297,521515892.0,-1
2015-05-07,480.5,491.77499400000005,477.5,480.51300000000003,376.063019,6779984.0,499.54389640000005,492.28701545454544,-55.137024,23.023412897318224,-16.83640326975476,-24.30256523471803,-93.31091660471526,5265687.347982383,2228210.669836524,8.0,96.0,-88.0,11.67599400000006,483.26266466666675,489.0253293333335,497.53765866666686,503.30032333333355,474.75033533333345,468.9876706666667,460.4753413333334,0.2110683899411813,514735908.0,-1
2015-05-08,489.5,491.88800000000003,486.31201200000004,486.0,378.76129199999997,5777676.0,494.7013976000001,489.8244888363637,-48.424987999999985,30.734023860763088,-13.949708385122856,-27.47792887057983,-68.69601572061732,-4432878.272141916,1925433.899654268,4.0,96.0,-96.0,8.174987999999985,488.06667066666665,489.82132933333327,493.6426586666667,495.39731733333326,484.2453413333333,482.49068266666666,478.6693533333333,-0.05595636145559112,520513584.0,+1
2015-05-11,491.25,500.0,488.049988,489.48699999999997,385.668121,4785512.0,490.6000976,488.8764165454546,-41.013000000000034,35.47352847955666,-12.446860986547092,-30.42341513525662,-49.81006777223423,-6417253.222132596,1546220.8485535777,0.0,92.0,-76.0,12.52499400000005,492.5123293333333,496.9746706666666,504.46234133333337,508.9246826666666,485.0246586666666,480.5623173333333,473.0746466666666,0.12025192945412772,525299096.0,+1
2015-05-12,498.412994,498.64999400000005,485.5,498.412994,376.66275,8284892.0,490.5613982000001,490.2969431636364,-0.38699399999995876,46.321861079455644,-9.17788137054368,-32.94540706391729,-38.959314597904324,-7357035.762053635,1141527.3661408091,28.000000000000004,88.0,-76.0,15.362975999999946,494.1876626666667,502.8753253333334,507.3376566666668,516.0253193333335,489.7253313333334,481.03766866666666,476.5753373333333,0.9819771780884445,533583988.0,+1
2015-05-13,487.93798799999996,491.22500599999995,482.125,486.77499400000005,378.519867,7099084.0,489.6225982000001,489.60850603636356,-9.387999999999977,36.97092548498286,-11.819216827743025,-35.72385964229204,-46.58614908130318,-13076319.597978186,495261.5948730935,24.0,84.0,-76.0,19.449982000000034,486.7083333333333,491.29166666666663,495.80833933333327,500.3916726666666,482.1916606666667,477.60832733333336,473.0916546666667,0.5109880147331852,526484904.0,-1
2015-05-14,490.0,490.200012,477.0,489.174988,374.283325,6233844.0,489.5175964,489.5271223636364,-1.050017999999966,39.85970458217837,-11.030669552771712,-34.999658835478215,-41.310767426956446,-1855775.1771335844,388396.2870275544,20.0,80.0,-88.0,14.27499400000005,485.4583333333333,493.91666666666663,498.6583453333333,507.11667866666664,480.7166546666666,472.2583213333333,467.5166426666666,0.9223467372605397,532718748.0,+1
2015-05-15,483.75,491.64999400000005,483.075012,483.700012,379.497131,5189344.0,488.85879819999997,488.46937974545455,-6.587982000000011,35.568678950928984,-12.27909644817958,-34.00461298873529,-33.12923338606451,4895267.616135996,593254.0747638057,16.0,96.0,-92.0,11.375,486.1416726666667,489.20833333333337,494.7166546666667,497.7833153333334,480.63335133333334,477.56669066666666,472.0583693333333,0.0728864503738897,527529404.0,-1
2015-05-18,492.5,499.72500599999995,490.39999400000005,490.43798799999996,385.552094,6469976.0,489.34639580000004,488.75650516363635,4.875975999999923,44.11223924910648,-2.6091933353494365,-32.301071198259706,-13.934369655184613,2766944.806787828,692058.1989695065,12.0,92.0,-92.0,14.0,493.52099599999997,496.6419979999999,502.8460079999998,505.9670099999998,487.316986,484.19598400000007,477.9919740000001,0.0040744183492646205,533999380.0,+1
2015-05-19,496.825012,508.924988,496.5,498.26300000000003,391.21932999999996,10272076.0,489.34519639999996,490.37770592727276,-0.011994000000015603,52.544299494001784,-2.600960739675609,-29.691140264109947,5.587755457450761,16.241275628454005,660601.7463401314,8.0,88.0,-60.0,13.14999400000005,501.2293293333334,505.9586586666668,513.6543173333334,518.3836466666668,493.5336706666668,488.8043413333334,481.1086826666668,0.1418914851265881,544271456.0,+1
2015-05-20,510.0,513.0,508.39999400000005,505.587006,396.04623399999997,5882188.0,490.8350982,493.3307622181818,14.899018000000012,59.19334853626615,-1.7905782608695713,-25.864688419103345,27.948727840687372,7922389.563925353,990683.0108451974,4.0,84.0,-60.0,16.287994000000026,508.9956666666667,509.59133933333334,513.5956726666666,514.1913453333333,504.9913333333334,504.39566066666674,500.39132733333344,-0.6115183328021975,550153644.0,+1
2015-05-21,512.224976,515.474976,509.31201200000004,511.825012,396.268372,10059312.0,493.9662994,497.1471101818181,31.31201199999998,64.13214927919661,-0.8763945519742234,-23.170791101903717,42.13869456724405,-13570998.759262994,328788.3847983999,0.0,80.0,-60.0,13.200012000000015,512.2040000000001,515.095988,518.366964,521.258952,508.93302400000016,506.04103600000013,502.7700600000002,0.4077583448483562,560212956.0,+1
2015-05-22,511.0,512.888,507.52499400000005,512.112,395.88140899999996,6888824.0,496.5774994,500.4463284727273,26.111999999999966,64.3611202611144,-0.8074857299469544,-19.198416576991974,45.368984805929145,-8305876.543393866,-63696.38474004584,0.0,76.0,-80.0,8.574982000000034,510.84166466666665,514.1583353333333,516.2046706666665,519.5213413333332,508.79532933333326,505.47865866666666,503.4323233333333,0.8553050285604623,567101780.0,+1
2015-05-25,512.625,514.138,501.76300000000003,511.61199999999997,390.14608799999996,4675808.0,498.78999940000006,503.17987403636357,22.125,63.54563708727874,-0.9275409622690041,-13.957896079882403,45.637302134608206,-5751884.661564987,-322250.3973702602,0.0,72.0,-80.0,16.024993999999936,509.171,516.579,521.5459999999999,528.954,504.20399999999995,496.796,491.82899999999995,0.7958787878787824,562425972.0,-1
2015-05-26,505.0,507.86199999999997,500.537994,504.200012,388.308319,3965040.0,499.36870120000003,504.1635126909091,5.787017999999989,52.22689366109766,-2.707236844885479,-9.641684126906512,30.456182505389865,3311300.4414203037,-157088.99557823432,0.0,68.0,-80.0,18.487000000000023,504.20000200000004,507.86201000000005,511.524008,515.186016,500.5380040000001,496.8759960000001,493.2139980000002,0.5000020480594936,558460932.0,-1
2015-05-27,501.75,502.25,488.75,501.825012,380.802521,8454708.0,500.87370300000003,504.61011465454544,15.050017999999966,48.9999950047077,-3.2774991984152138,-5.861950551861526,8.570566190729753,-5267919.690352544,-389399.4817430318,0.0,64.0,-80.0,14.736999999999966,497.60833733333334,506.4666746666667,511.10833733333334,519.9666746666667,492.9666746666667,484.10833733333334,479.4666746666667,0.9685194074074085,550006224.0,-1
2015-05-28,493.799988,508.0,493.799988,492.125,390.107391,10980540.0,501.1687042000001,503.0194413818182,2.950012000000015,37.95005136618335,-5.606573586788555,-4.134149923677171,9.731457554892224,-4557252.891144527,-578847.3640186737,0.0,60.0,-80.0,9.887969999999996,497.974996,502.15000399999997,512.1750079999999,516.350016,487.94999199999995,483.77498399999996,473.74997999999994,-0.11795680172664523,539025684.0,-1
2015-05-29,501.212006,514.112,500.25,504.14999400000005,391.37487799999997,18993044.0,503.21370239999993,503.56149407272727,20.449982000000034,53.08382222251737,-2.719246690106039,-0.21428195328968513,48.02155106101305,675330.4225335567,-521839.28280310263,4.0,56.00000000000001,-76.0,5.363005999999984,506.17066466666665,512.0913293333333,520.0326646666666,525.9533293333333,498.22932933333334,492.3086646666667,484.3673293333334,0.28134425046891204,558018728.0,+1
2015-06-01,508.200012,516.0,505.81201200000004,505.787994,396.14300499999996,5724892.0,504.7487030000001,504.0295470909091,15.350006000000064,54.815903494945694,-2.448922302158267,3.5848636454192615,63.67899914711369,1900440.60133387,-411735.65169001796,0.0,52.0,-72.0,12.375,509.20000200000004,512.587992,519.38799,522.77598,502.4000040000001,499.0120140000001,492.2120160000001,-0.002357482164291163,563743620.0,+1
2015-06-02,512.025024,513.775024,501.25,511.950012,388.569885,4673140.0,506.1174042,505.338876,13.687011999999982,61.056642325802954,-0.9712201438848884,8.328273387962156,61.676075134303076,2899311.112495037,-261233.52602443204,96.0,48.0,-68.0,11.07400599999994,508.9916786666667,516.7333573333334,521.5167026666668,529.2583813333334,504.20833333333337,496.46665466666667,491.68330933333334,0.8542907382852112,568416760.0,+1
2015-06-03,504.549988,509.86199999999997,502.0,502.162994,390.93924,5495796.0,505.7750030000001,504.6198923272728,-3.424011999999948,48.72371593830607,-3.3182268585131833,10.206779791016231,34.79336408200311,-4717359.440712643,-463784.70399153995,92.0,44.0,-64.0,15.450012000000015,504.67499799999996,507.3499959999999,512.5369979999999,515.2119959999999,499.48799599999995,496.812998,491.625996,0.020731874841010783,562920964.0,-1
2015-06-04,507.5,513.75,503.14999400000005,505.22500599999995,392.322723,7489464.0,505.11500240000004,504.5198928727272,-6.600006000000064,52.20859288412952,-2.5839314148681174,11.05125503852031,49.017787559285345,2450554.67977661,-331314.7319853887,88.0,40.0,-60.0,14.200012000000015,507.375,511.60000599999995,517.9750059999999,522.2000119999999,501.0,496.77499400000005,490.39999400000005,0.19575573825146053,570410428.0,+1
2015-06-05,507.5,511.0,502.037994,507.01300000000003,389.150177,6125788.0,504.6051024000001,504.86498334545456,-5.098999999999933,54.30117731496981,-2.155155875299752,10.60641660161167,40.821090954984065,2004559.4687895915,-225138.63193739316,84.0,36.0,-52.00000000000001,21.986999999999966,506.68366466666674,511.32933533333346,515.6456706666668,520.2913413333334,502.3673293333335,497.72165866666677,493.4053233333335,0.5551219224803043,576536216.0,+1
2015-06-08,505.0,506.162994,496.75,502.912994,386.906219,6141048.0,503.7352018000001,504.55732727272726,-8.69900599999994,48.663469276522214,-3.1383707434052694,9.154797646461475,2.092442493069495,1402956.7215776853,-151134.2976782123,80.0,32.0,-52.0,11.85000599999995,501.941996,507.13399200000003,511.35499000000004,516.5469860000001,497.720998,492.529002,488.308004,0.6547325962387747,570395168.0,-1
2015-06-09,500.93798799999996,501.912994,495.75,500.01300000000003,385.367859,7561740.0,503.3165006000001,503.8805633090909,-4.1870119999999815,44.86215335288014,-3.8338129496402797,7.178216064222511,-20.635007323421867,-2060351.5020747238,-237916.89788756327,76.0,28.000000000000004,48.0,12.52502400000003,499.2253313333334,502.70066266666674,505.38832533333334,508.86365666666677,496.5376686666667,493.06233733333335,490.3746746666667,0.6917092568968939,562833428.0,-1
2015-06-10,497.5,509.837006,496.25,498.02499400000005,392.02252200000004,6385840.0,502.93649880000004,502.91847120000006,-3.800017999999966,42.251543487992535,-4.310552997601906,5.877640437024468,-10.578248967098101,-3228312.828605326,-373843.9856616793,72.0,24.0,48.0,9.950012000000015,501.3706666666667,506.4913333333334,514.9576726666667,520.0783393333334,492.9043273333334,487.7836606666667,479.31732133333344,0.13063908266472044,556447588.0,-1
2015-06-11,508.98699999999997,511.18798799999996,498.76300000000003,506.625,386.441986,9229464.0,504.3864988000001,503.58910778181826,14.5,55.24981639205061,-2.2482014388489207,5.255715624349364,17.797131731656105,-3531604.358458665,-517378.5480758733,68.0,20.0,48.0,11.587005999999974,505.52532933333333,512.2876586666666,517.9503173333333,524.7126466666666,499.8626706666667,493.1003413333334,487.4376826666668,0.6327571503489591,565677052.0,+1
2015-06-12,501.25,506.38800000000003,488.875,499.412994,406.05542,9852924.0,503.9127988,502.68483418181825,-4.737000000000023,45.3686846438545,-3.9776992805755333,4.119772335717471,-66.62191363307201,154239.06864250763,-486850.47458576463,64.0,16.0,48.0,8.962005999999974,498.2253313333334,507.57566266666674,515.7383313333335,525.0886626666668,490.0626626666667,480.71233133333334,472.5496626666667,0.6017240906754985,555824128.0,-1
2015-06-15,488.47500599999995,499.39999400000005,484.0,493.76300000000003,419.79821799999996,5236426.0,502.71029940000005,500.8394162181819,-12.024993999999992,39.05488209811832,-5.332613908872894,4.5271020549963055,-145.06366893040672,-6304447.166036673,-751286.6878575898,60.0,12.0,48.0,10.263000000000034,492.38766466666675,500.7753293333335,507.78765866666686,516.1753233333336,485.37533533333345,476.9876706666667,469.9753413333334,0.6339612859589427,550587702.0,-1
2015-06-16,497.174988,501.5,492.5,495.22500599999995,423.570465,5223444.0,501.0377988000001,499.4784537818182,-16.725006000000064,41.48620235412011,-4.982012949640299,3.5454579049579706,-89.55000378398186,5264571.008439766,-477838.61072941887,56.00000000000001,8.0,48.0,7.162994000000026,496.4083353333333,500.3166706666666,505.4083353333333,509.3166706666666,491.3166706666666,487.4083353333333,482.3166706666666,0.30277844444443897,555811146.0,+1
2015-06-17,505.5,510.5,496.10000599999995,499.674988,422.023438,6412068.0,500.78899820000004,499.2306699999999,-2.4880060000000412,48.6769305773591,-3.914870983213433,2.943030822817491,-16.92273596192931,-1604945.8910237567,-529070.7598379537,52.0,4.0,48.0,13.587005999999974,502.09166466666665,508.08332333333334,516.4916586666668,522.4833173333334,493.6833293333333,487.6916706666666,479.28333533333324,0.2482627423316997,562223214.0,+1
2015-06-18,502.799988,503.97500599999995,497.89999400000005,497.85000599999995,424.67248499999994,3474426.0,500.0514982,498.6963077818182,-7.375,46.001842686398035,-4.352516546762602,0.6234385393311186,-34.658129563931936,-426631.8862282606,-524414.447400781,48.0,0.0,48.0,13.162993999999912,499.9083353333333,501.91667666666655,505.98334733333314,507.99168866666645,495.84166466666665,493.8333233333334,489.76665266666674,-0.008228461112521148,558748788.0,-1
2015-06-19,505.14999400000005,505.200012,496.549988,500.97500599999995,421.875061,6670458.0,499.4476988,498.86421829090904,-6.037994000000083,51.29074670290681,-3.6031160671462947,-0.23924410918203876,-19.37352135734364,-11349910.825152053,-1016482.4646084575,44.0,0.0,48.0,17.75,500.9083353333333,505.2666826666666,509.5583593333333,513.9167066666666,496.6166586666666,492.25831133333327,487.96663466666655,0.5115613552054827,565419246.0,+1
2015-06-22,502.450012,514.375,498.5,497.674988,433.95465099999996,5710868.0,498.9238982,498.5419072363636,-5.238006000000041,45.822144309030236,-4.020466325609393,-2.013455685056215,18.145071414752667,9540237.529411765,-536631.5557547624,40.0,80.0,48.0,15.412994000000026,503.51666266666666,508.5333253333333,519.3916626666667,524.4083253333333,492.6583253333333,487.64166266666666,476.7833253333333,-0.05196925984252064,559708378.0,-1
2015-06-23,512.5,513.700012,499.075012,511.924988,424.015503,6952116.0,500.115097,500.9057417454545,11.911987999999951,64.61811489709598,-0.5898313572073464,-3.362759826124602,94.77072136924275,3164016.073077206,-368420.2998871882,36.0,76.0,48.00000000000001,9.0,508.23333733333334,517.3916626666667,522.8583373333333,532.0166626666667,502.76666266666666,493.60833733333334,488.14166266666666,0.8786308376068356,566660494.0,+1
2015-06-24,507.5,507.5,495.60000599999995,500.200012,421.76913499999995,7073694.0,500.3325988,500.92118083636365,2.175017999999966,48.607965251671416,-3.412576105928374,-4.00871993035787,-24.305855556010584,-8075964.730573496,-718763.2285777611,32.0,72.0,48.0,15.27499400000005,501.10000599999995,506.60000599999995,513.0,518.5,494.7000119999999,489.2000119999999,482.80001799999985,0.38655532095226647,559586800.0,-1
2015-06-25,499.60000599999995,501.75,493.825012,497.549988,419.79821799999996,7117466.0,499.4250976,500.41525160000003,-9.075012000000015,45.6578287353877,-4.050559614805902,-3.8925059217514786,-87.79279545051313,2046682.7762610351,-593061.137440843,28.000000000000004,68.0,48.0,6.0750119999999015,497.7083333333333,501.5916546666666,505.63332133333324,509.5166426666666,493.66666666666663,489.78334533333333,485.74167866666664,0.4700292290663376,552469334.0,-1
2015-06-26,499.5,505.799988,499.049988,495.22500599999995,426.071136,5320284.0,499.0062988,499.6515985818181,-4.187988000000075,43.01498123523387,-4.610290460427337,-3.160196305225952,-41.017904791687926,245027.81818181818,-554966.1849102601,24.0,64.0,44.0,8.65002400000003,500.02499399999994,500.9999999999999,506.7749939999999,507.7499999999999,494.2499999999999,493.27499399999994,487.4999999999999,-0.566664000000005,547149050.0,-1
2015-06-29,493.5,499.75,491.25,502.625,419.671112,5690668.0,499.8924988,500.30954425454536,8.861999999999966,53.00503563534001,-2.828769184471863,-3.4197404182352784,-67.29656189222015,5829114.7588886805,-264780.687448275,20.0,60.0,-40.0,15.875,497.875,504.5,506.375,513.0,496.0,489.375,487.5,1.338235294117647,552839718.0,+1
2015-06-30,495.0,496.72500599999995,490.0,495.075012,417.212769,6212530.0,499.87749940000003,499.4336375636364,-0.14999399999993557,43.9372225753968,-4.6464009629852505,-2.928923782660206,-120.67491591182737,-763080.6489119374,-287430.6856978585,16.0,56.00000000000001,-40.0,16.02502400000003,493.9333393333333,497.86667866666664,500.6583453333333,504.5916846666666,491.1416726666667,487.20833333333337,484.41666666666674,0.7546479512434714,546627188.0,-1
2015-07-01,494.5,502.5,493.0,492.174988,422.743958,6880852.0,499.1274994,498.03318094545455,-7.5,40.84064968743682,-5.344571050255797,-2.1651203868065636,-71.87535127146566,7894943.435984085,84495.41076159087,12.0,52.0,-40.0,16.324982000000034,495.89166266666666,498.7833253333333,505.39166266666666,508.2833253333333,489.2833253333333,486.39166266666666,479.7833253333333,-0.08684336842105422,539746336.0,-1
2015-07-03,494.0,496.5,491.0,494.0,419.73465,2695306.0,498.51499939999997,497.00772869090906,-6.975005999999951,44.296508481403094,-4.905206139030996,-2.231800298138751,-86.8860027463431,-3334240.4906706302,99783.4065925476,4.0,44.0,-40.0,8.25,493.8333333333333,496.66666666666663,499.33333333333326,502.16666666666663,491.16666666666663,488.3333333333333,485.66666666666663,0.5454545454545454,541058598.0,-1
2015-07-07,492.5,495.0,489.5,491.64999400000005,415.580963,3497418.0,496.23500060000003,495.1936357090909,-20.274993999999936,41.492255577131715,-5.470961420403238,-2.0239445405303513,-115.5057634556955,-3584429.50644456,-262072.7286388618,56.00000000000001,36.0,-40.00000000000001,12.625,492.049998,494.59999600000003,497.54999799999996,500.09999600000003,489.09999600000003,486.549998,483.59999600000003,0.39090800000000897,541866782.0,-1
2015-07-08,489.5,489.5,477.39999400000005,490.25,405.83252000000005,7024178.0,495.2399994,494.10545378181814,-9.950012000000015,39.68584922205678,-5.808004814926272,-1.3426096195012747,-195.95722539505027,-2634180.9829871897,-369895.8311136883,52.0,32.0,-40.0,9.5,485.7166646666667,494.03333533333335,497.81667066666665,506.1333413333333,481.9333293333334,473.61665866666675,469.83332333333345,1.0619834403387902,534842604.0,-1
2016-01-12,531.0,531.474976,515.424988,527.849976,453.278351,6565212.0,539.687506,535.1986426909091,-24.52502400000003,36.87921475388534,-5.953952631578955,7.332174612245353,-104.41238354074487,-5847386.004214758,-1518911.9852726047,56.00000000000001,8.0,48.0,21.5,524.9166466666667,534.4083053333334,540.9666346666666,550.4582933333334,518.3583173333334,508.8666586666667,502.3083293333334,0.7741431333157381,497422626.0,-1
2016-01-13,528.5,545.5,524.049988,524.974976,467.71926900000005,8751294.0,536.950006,532.5236372363637,-27.375,34.288683319894574,-6.584435087719305,5.310299745952307,-62.36891310742459,401598.9717187083,-1431616.0326820808,52.0,4.0,48.0,10.0,531.5083213333334,538.9666546666667,552.9583333333333,560.4166666666667,517.5166426666667,510.05830933333334,496.0666306666667,0.04312295955825032,488671332.0,-1
2016-01-14,533.0,577.5,527.174988,541.700012,489.132233,30227006.0,536.8050048,533.3872746909091,-1.4500120000000152,55.344077804479994,-7.481711180773247,2.865112462771549,38.77472923750094,-7236390.243902439,-1695469.405919398,48.0,0.0,48.0,13.075012000000015,548.7916666666666,570.4083453333333,599.1166786666665,620.7333573333333,520.0833333333333,498.4666546666666,469.75832133333324,0.28862435243930046,518898338.0,+1
2016-01-15,574.0,582.0,568.775024,566.5,492.111084,13036614.0,538.1850036,538.7863647272727,13.799987999999985,71.15661961462932,-3.2091097308488616,0.8265615339889791,182.0490968936088,-2813858.201966103,-1746305.2602851626,96.0,0.0,48.0,6.924987999999985,572.425008,576.0749920000001,585.6499840000001,589.299968,562.8500160000001,559.2000320000001,549.6250400000001,-0.17202481123595503,531934952.0,+1
2016-01-18,569.950012,581.049988,564.174988,569.950012,488.65740999999997,10066612.0,539.9175048000001,544.5618208,17.325012000000015,72.70785376016161,-2.4948215320910943,-0.4207046221217752,154.02387670814448,225878.6798644319,-1656660.5357328998,96.0,84.0,48.0,9.57495199999994,571.724996,579.2750040000001,588.5999960000001,596.1500040000001,562.4000040000001,554.849996,545.5250040000001,0.34222364444444625,542001564.0,+1
2016-01-19,567.5,579.474976,564.275024,565.950012,492.00323499999996,7500436.0,542.5675047999999,549.2950039272727,26.5,67.82778306723011,-3.3229788819875745,-2.529539813066208,126.69647498562404,-4441017.205695098,-1783222.2025493751,92.0,80.0,48.00000000000001,16.225036000000046,569.900004,575.5249839999999,585.099956,590.7249359999998,560.325032,554.700052,545.12508,0.11019692693766346,534501128.0,-1
2016-01-20,567.0,580.0,558.5,569.825012,484.059692,7507998.0,545.8475036,554.2509143272728,32.799987999999985,70.07304465329456,-2.520701449275359,-4.464196205445205,110.69967760176216,3894327.4948290684,-1525151.7617594232,88.0,76.0,48.0,21.450012000000015,569.4416706666667,580.3833413333334,590.9416706666666,601.8833413333334,558.8833413333334,547.9416706666667,537.3833413333334,0.5267447441860472,542009126.0,+1
2016-01-21,567.5,571.25,561.0,560.625,490.88070700000003,6743000.0,548.4425048,556.9377318545455,25.950012000000015,58.82640326928192,-4.425465838509317,-4.314309149182577,75.3437910385863,-11297951.917180885,-1969369.9506422544,84.0,72.0,48.0,52.52502400000003,564.2916666666666,567.5833333333333,574.5416666666665,577.8333333333333,557.3333333333333,554.0416666666666,547.0833333333333,-0.036585365853658534,535266126.0,-1
2016-01-22,574.049988,576.25,565.5,568.525024,490.53533899999996,6436018.0,552.7550048,560.5890989818182,43.125,64.47559815228327,-2.7898501035196626,-3.289477641456415,95.63439828858202,-2717914.736942306,-2003394.7136558958,80.0,68.0,96.0,40.299987999999985,570.0916746666667,574.6833493333334,580.8416746666667,585.4333493333334,563.9333493333334,559.3416746666667,553.1833493333334,0.28139758139535165,541702144.0,+1
2016-01-25,570.125,573.424988,562.275024,568.125,491.139771,4579262.0,556.4025024,563.3836435636364,36.47497599999997,63.96285351707456,-2.872670807453416,-1.210041345707623,76.53864175435129,-2143041.9603729406,-2009742.3157793982,76.0,64.0,12.0,16.875,567.9416706666667,573.6083173333334,579.0916346666668,584.7582813333333,562.4583533333334,556.7917066666668,551.3083893333335,0.5246632186435753,537122882.0,-1
2016-01-27,573.224976,574.799988,567.5,568.825012,491.506683,6971962.0,560.500006,565.6422816727273,40.975036000000046,64.53236865782232,-2.727740786749479,2.792962348262563,77.62626742279292,5087351.719788814,-1687147.1323444562,72.0,60.0,12.0,15.19995199999994,570.375,573.25,577.674988,580.549988,565.950012,563.075012,558.650024,0.1815087915213036,544094844.0,+1
2016-01-28,568.0,571.299988,563.099976,569.25,487.664429,7788598.0,564.9275084,567.2331896727273,44.27502400000003,64.92071984877558,-2.639751552795031,5.542207696676087,60.523290169194965,-6296711.714084297,-1896672.795150827,68.0,56.00000000000001,12.0,21.5,567.8833213333334,572.6666666666667,576.0833333333335,580.8666786666668,564.4666546666667,559.6833093333333,556.2666426666667,0.750001829265618,551883442.0,+1
2016-01-29,569.0,585.0,565.799988,564.799988,502.903992,10232108.0,567.237506,567.2100041454546,23.09997599999997,57.33580373650431,-4.156381069958851,9.67111457355145,69.46628056648336,269203.4512320489,-1798223.87486069,64.0,52.0,12.0,10.25,571.8666586666667,577.9333293333334,591.0666706666668,597.1333413333334,558.7333173333334,552.6666466666667,539.5333053333334,-0.052083300781270304,541651334.0,-1
2016-02-01,585.0,589.950012,580.799988,582.450012,506.551941,4251126.0,568.8325072000001,569.9759143272728,15.950012000000015,72.20006344962634,-1.5276504362321923,14.448525226011725,107.44121484790924,4964188.061332041,-1490841.5141246375,96.0,48.0,12.0,15.625,584.400004,588.00002,593.5500279999999,597.150044,578.8499959999999,575.2499799999999,569.6999719999999,0.18033001880651076,545902460.0,+1
2016-02-02,588.424988,595.0,582.0,586.674988,507.501709,7632702.0,570.5050048,573.2200017454545,16.72497599999997,74.6403961224434,-1.6784298387096805,17.99758063328136,105.32734530110767,17380729.170817677,-633042.846627208,96.0,44.0,12.0,11.149963999999954,587.8916626666667,593.7833253333333,600.8916626666667,606.7833253333333,580.7833253333333,574.8916626666667,567.7833253333333,0.3596144615384604,553535162.0,+1
2016-02-03,583.900024,587.950012,576.375,587.775024,499.795563,5245966.0,572.6875060000001,576.3600052363637,21.825012000000015,75.29198497436347,-1.4566483870967681,18.260190829613407,80.3733561508311,-4484259.876862561,-808098.1661833705,96.0,40.0,12.0,7.299987999999985,584.0333453333334,591.6916906666668,595.6083573333335,603.2667026666668,580.1166786666668,572.4583333333334,568.5416666666667,0.9848822618931208,558781128.0,+1
2016-02-04,580.025024,597.474976,580.025024,578.849976,509.31494100000003,5549346.0,573.5900024,577.4804543272728,9.024963999999954,60.69303544109704,-3.7363961877195617,18.142244068286004,73.10267748959502,4105477.397053145,-584753.8223998803,92.0,36.0,11.999999999999993,8.200012000000015,585.449992,590.8749599999999,602.8999439999998,608.3249119999998,573.4250079999999,568.00004,555.975056,-0.06733817949757483,553231782.0,-1
2016-02-05,587.75,593.325012,585.924988,589.875,507.134766,3984224.0,576.5150024000001,580.4413629818182,29.25,69.20408105513533,-1.5246454417804054,18.900737873699313,72.99250092223318,-2792885.261402391,-685123.433263636,96.0,32.0,12.0,19.200012000000015,589.7083333333334,593.4916786666668,597.1083573333333,600.8917026666668,586.0916546666667,582.3083093333333,578.6916306666667,0.5337836742151105,557216006.0,+1
2016-02-08,581.875,586.099976,571.900024,587.349976,496.81677199999996,4221044.0,578.3974976000001,582.4113581818182,18.82495199999994,65.45854785388482,-2.0311952429884865,18.57615425409233,42.759089433717776,-6554074.344148801,-951893.9292129749,92.0,28.000000000000004,48.0,25.15002400000003,581.7833253333333,591.6666266666666,595.9832773333333,605.8665786666666,577.4666746666667,567.5833733333334,563.2667226666667,1.0880284665750986,552994962.0,-1
2016-02-09,564.150024,564.150024,546.75,575.400024,478.188324,7579572.0,579.1250000000001,581.8663629818182,7.27502400000003,50.52569466422638,-4.428497530034474,19.909646272668965,-20.62852094304125,4587344.578948255,-700110.3606601796,88.0,24.0,52.0,13.0,562.100016,577.450032,579.5000399999999,594.850056,560.0500079999999,544.699992,542.6499839999999,1.6465508323436784,545415390.0,-1
2016-02-10,554.0,563.75,552.5,553.825012,478.57693499999993,5866054.0,577.6250000000001,577.2663651636364,-15.0,34.249231194307114,-8.756701158856158,19.708150608490996,-44.60359267613203,-3475829.873049836,-826279.4294051697,84.0,20.0,56.0,11.575012000000015,556.6916706666667,560.8833413333334,567.9416706666666,572.1333413333334,549.6333413333334,545.4416706666667,538.3833413333334,0.1177788444444458,539549336.0,-1
2016-02-11,555.5,556.5,535.575012,554.275024,465.66860999999994,5214378.0,576.1275024,573.0209149818182,-14.97497599999997,34.7550738560509,-8.666423407380822,18.732437296257558,-75.3663497129171,-4856227.950942825,-1009458.9076568893,80.0,16.0,56.0,17.44995199999994,548.7833453333334,561.9916786666668,569.7083333333333,582.9166666666667,541.0666906666668,527.8583573333334,520.1417026666668,0.8936689473848218,544763714.0,+1
2016-02-12,547.349976,552.200012,533.5,539.325012,468.258911,7408096.0,573.5800048,566.3295530909091,-25.47497599999997,26.839894273613396,-11.665573358691523,17.078040689734735,-95.82915870996514,-244081.15360133123,-974669.0097452715,76.0,12.0,64.0,14.475036000000046,541.675008,549.8500160000001,560.37502,568.5500280000001,531.1500040000001,522.974996,512.4499920000001,0.3114977680228232,537355618.0,-1
2016-02-15,548.125,550.099976,543.299988,542.325012,471.324066,5093478.0,569.5675048,560.6468271272728,-40.125,30.504496835507908,-11.063737731139378,15.180514453352885,-77.44041098524812,1259833.4645232535,-873100.7154603347,72.0,8.0,64.0,17.97497599999997,545.2416586666667,547.1833293333334,552.0416466666668,553.9833173333334,540.3833413333334,538.4416706666667,533.5833533333334,-0.1433790765513074,542449096.0,+1
2016-02-16,543.5,546.375,536.849976,545.875,465.88439900000003,5125448.0,565.487506,556.3390989818181,-40.799987999999985,34.95318658507351,-10.351567979211854,13.30602478720698,-78.18977631234857,722452.5639953263,-800575.5663941655,68.0,4.0,64.0,40.59997599999997,543.0333253333333,549.2166746666667,552.5583493333334,558.7416986666667,539.6916506666666,533.5083013333333,530.1666266666666,0.9475066939463881,547574544.0,+1
2016-02-17,540.875,551.5,538.5,539.575012,473.95748899999995,4164598.0,560.6675048000001,551.6277364363636,-48.200012000000015,30.90249065778076,-11.615420389728843,9.053758146639893,-72.16609801739813,-2787196.332908641,-890876.5103266449,64.0,0.0,64.0,22.90002400000003,543.1916706666667,547.8833413333334,556.1916706666666,560.8833413333334,534.8833413333334,530.1916706666667,521.8833413333334,0.08269323076923193,543409946.0,-1
2016-02-18,550.0,563.5,550.0,548.924988,484.987854,4189072.0,557.675006,549.4927333818182,-29.924987999999985,42.344499854715416,-9.739704165209687,3.866106185670219,-35.46036224134407,2888340.06779661,-719093.9385937639,60.0,0.0,64.0,20.924987999999985,554.1416626666667,558.2833253333333,567.6416626666667,571.7833253333333,544.7833253333333,540.6416626666667,531.2833253333333,-0.07963051851851964,547599018.0,+1
2016-02-19,559.599976,567.099976,556.924988,561.700012,486.64990199999994,3974018.0,554.8575072000001,550.2245526545455,-28.174987999999985,54.28010098808283,-7.17688263653178,-1.7239049597878875,-12.202944837782383,-7253501.236183967,-1016112.4521206009,56.00000000000001,0.0,64.0,20.77502400000003,561.9083253333333,566.8916626666667,572.0833133333333,577.0666506666666,556.7166746666667,551.7333373333333,546.5416866666667,0.4692903814726895,551573036.0,+1
2016-02-22,565.5,566.974976,557.025024,563.625,486.39086900000007,3857010.0,552.4850096,551.8186422545455,-23.72497599999997,55.868524156933525,-6.790707182861667,-5.331489109780705,-9.952741212628457,5733347.104903486,-709318.8358922239,52.0,76.0,64.0,10.774963999999954,562.5416666666666,568.0583093333332,572.4916186666665,578.0082613333332,558.1083573333333,552.5917146666667,548.1584053333333,0.663317370777267,555430046.0,+1
2016-02-23,565.125,566.25,558.025024,563.325012,485.20370499999996,2501960.0,551.2775084,553.7895517818182,-12.075012000000015,55.52166973791403,-6.850888338274369,-9.224503948913934,-10.090646617588861,-10253824.732394367,-1143160.0130059705,48.0,72.0,64.0,9.52502400000003,562.5333453333334,567.0416666666667,570.7583213333332,575.2666426666667,558.8166906666668,554.3083693333334,550.5917146666668,0.6443773209794174,552928086.0,-1
2016-02-24,559.75,571.875,559.174988,561.950012,485.82965099999996,4950714.0,552.0900084000001,555.7300069818182,8.125,53.756613068990056,-7.126729667569101,-12.945867207602419,-2.5392079238199763,-7046256.037148282,-1411482.5595579012,44.0,68.0,64.0,13.0,564.3333333333334,569.4916786666668,577.0333453333335,582.1916906666668,556.7916666666667,551.6333213333334,544.0916546666667,0.21850562030965223,547977372.0,-1
2016-02-25,562.700012,565.299988,550.549988,562.674988,479.332367,4484528.0,552.9300048000001,557.6545487272728,8.399963999999954,54.634008523372195,-6.20037895229951,-15.558173818560476,-22.685627810758906,-5215662.2917013895,-1584399.8201098826,40.0,64.0,60.0,23.924987999999985,559.5083213333334,568.4666546666667,574.2583213333335,583.2166546666667,553.7166546666667,544.7583213333334,538.9666546666667,0.8220338983050848,552461900.0,+1
2016-02-26,560.075012,566.0,558.0,555.150024,484.016418,4235636.0,554.512506,558.0581885818182,15.825012000000015,44.517982778626134,-6.353921889743624,-15.278557310355609,-21.046140387820135,-909216.3852203119,-1553709.6639785378,36.0,60.0,56.00000000000001,18.174987999999985,559.7166746666667,561.4333493333334,567.7166746666667,569.4333493333334,553.4333493333334,551.7166746666667,545.4333493333334,-0.3562469999999962,548226264.0,-1
2016-02-29,564.75,565.200012,534.150024,560.575012,467.999908,8166076.0,556.3375060000001,559.1604624,18.25,51.92300604200657,-2.389635315886859,-15.501485535880875,-47.91131360258678,600940.4558810949,-1455771.0221667339,32.0,56.00000000000001,-24.0,9.94995199999994,553.3083493333334,572.4666746666667,584.3583373333333,603.5166626666667,541.4166866666667,522.2583613333334,510.3666986666667,0.8510466413062703,556392340.0,+1
2016-03-01,547.400024,565.150024,547.400024,542.025024,485.872833,6386154.0,555.9525083999999,556.5581929454545,-3.8499759999999696,34.012563740373125,-6.312445360824735,-13.570527338021407,-47.10152029439713,30903.241154608822,-1388194.9192884895,28.000000000000004,52.0,-24.0,8.22497599999997,551.525024,555.650024,569.275024,573.400024,537.900024,533.775024,520.150024,-0.3028169014084507,550006186.0,-1
2016-03-02,568.525024,581.75,562.5,562.724976,499.061707,7214898.0,558.2675048,557.7895506909091,23.149963999999954,54.30676625749937,-3.9409682030036315,-11.412302752728351,49.15985855543357,56681864.34269674,1251353.2289836248,24.0,48.0,-24.0,12.700012000000015,568.9916586666667,575.4833173333334,588.2416586666668,594.7333173333334,556.2333173333334,549.7416586666667,536.9833173333334,0.011687064935063359,557221084.0,+1
2016-03-03,584.0,596.424988,577.0,578.0,504.80352800000003,5814304.0,561.175006,561.377277090909,29.075012000000015,63.789018440184584,-3.704073668289456,-9.129672969350736,139.57195520730488,-2092130.9622192397,1099376.6748380368,20.0,44.0,-24.0,14.75,583.8083293333333,590.6166586666666,603.2333173333332,610.0416466666666,571.1916706666666,564.3833413333333,551.7666826666666,0.05148008328241957,563035388.0,+1
2016-03-04,587.799988,592.5,579.549988,584.650024,505.38635300000004,4281680.0,563.4700072,565.6454621818182,22.950012000000015,67.20742950686204,-2.3671838536587457,-5.523668681863455,155.9660058445164,-1788969.4285714284,968088.2155921494,16.0,40.0,-24.0,8.0,585.5666706666667,591.5833533333334,598.5166826666666,604.5333653333334,578.6333413333334,572.6166586666667,565.6833293333334,0.393824808810991,567317068.0,+1
2016-03-08,581.5,595.25,573.700012,585.325012,502.27792400000004,7617746.0,565.6400084,569.6190994181818,21.700012000000015,67.56602506956312,-2.2314874137364344,-3.1663563907425214,148.59045776854632,-276187.0925794108,911530.2470388957,12.0,36.0,-24.000000000000007,31.049987999999985,584.7583413333333,595.8166706666666,606.3083293333332,617.3666586666666,574.2666826666666,563.2083533333333,552.7166946666666,0.5394434558385837,574934814.0,+1
2016-03-09,572.5,591.875,571.474976,581.724976,508.77526900000004,6305782.0,567.4800048000001,572.5436389818183,18.399963999999954,63.30580821116431,-2.9552218635224685,-1.3662876602012375,124.63191611403332,-4230374.86388033,677807.287451654,8.0,32.0,-23.999999999999996,17.75,581.6916506666666,591.9083253333333,602.0916746666667,612.3083493333334,571.5083013333333,561.2916266666666,551.1082773333333,0.5024503892740511,568629032.0,-1
2016-03-10,581.450012,581.450012,569.674988,589.25,493.233521,24381016.0,570.2100036,576.5018199272727,27.299987999999985,68.14942296979629,-1.4424261291835192,0.7545587152829967,110.20322855649773,-7794373.393343473,292708.1655973233,4.0,28.000000000000004,-24.0,39.72497599999997,580.125,590.575012,591.900024,602.350036,578.799988,568.349976,567.024964,1.662418012905958,593010048.0,+1
2016-03-11,573.099976,577.974976,569.099976,571.25,493.44940199999996,4058548.0,571.0675048,576.6909101818181,8.575012000000015,49.951146747225536,-5.061062191753018,2.682222134043741,56.39865863551501,-8591981.756756758,-111141.37632786891,0.0,24.0,-24.0,33.700012000000015,572.774984,576.4499920000001,581.6499840000001,585.3249920000001,567.5749920000001,563.899984,558.6999920000001,0.2422562253521161,588951500.0,-1
2016-03-14,573.0,577.125,569.25,571.5,492.67230199999995,4174262.0,572.7025024000001,576.7695456727273,16.34997599999997,50.16441344981902,-5.010803357550664,4.363605492107126,44.98249518880601,2101458.5155677507,-10568.653968975517,76.0,20.0,-24.0,14.5,572.625,576.0,580.5,583.875,568.125,564.75,560.25,0.2857142857142857,593125762.0,+1
2016-03-15,572.0,577.25,564.474976,570.599976,489.73669400000006,6720258.0,573.7049988,576.3872681454545,10.024963999999954,49.29191117328827,-5.191739985527228,6.73197251513534,26.719999773863517,7678706.850072746,338943.8689420171,72.0,16.0,-24.0,21.549987999999985,570.774984,577.0749920000001,583.5500080000002,589.8500160000001,564.299968,557.99996,551.524944,0.47945115406436695,586405504.0,-1
2016-03-16,570.950012,577.5,565.775024,567.200012,497.529083,5588850.0,576.2224976,575.2045432727273,25.174987999999985,45.818324285237985,-5.875252893407111,10.0744953009563,15.829177777129807,-2856580.103291845,193692.7792950213,68.0,12.0,-24.0,20.40002400000003,570.1583453333334,574.5416666666667,581.8833213333332,586.2666426666667,562.8166906666668,558.4333693333334,551.0917146666668,0.12153440655230241,580816654.0,-1
2016-03-17,578.450012,584.875,577.025024,576.224976,501.544037,6474622.0,577.5724975999999,575.2049938909091,13.5,55.43664867009972,-4.06091621597426,12.355226195193836,54.72150340445809,-4484963.900582756,-18973.433426698783,64.0,8.0,-24.000000000000004,12.049987999999985,579.375,581.724976,587.224976,589.5749519999999,573.875,571.525024,566.025024,-0.10191725426932054,587291276.0,+1
2016-03-18,581.400024,599.5,581.0,580.875,515.207764,8477422.0,577.8599976,575.8054488727272,2.875,59.69076326895885,-3.7212787212787215,16.237015264973707,84.37979448696474,-166257.88953321998,-25668.18143154074,60.0,4.0,-24.0,20.15002400000003,587.125,593.25,605.625,611.75,574.75,568.625,556.25,-0.006756756756756757,595768698.0,+1
2016-03-21,594.0,599.5,590.025024,596.700012,515.8553469999999,5138392.0,579.0649964,579.2309060363636,12.049987999999985,70.68118788394452,-0.5594381618381588,18.0046086575976,110.78966011656651,-4402306.334807522,-224606.27931226965,96.0,0.0,56.0,7.875,595.4083453333334,600.7916666666667,604.8833213333332,610.2666426666667,591.3166906666668,585.9333693333334,581.8417146666668,0.7044860060859264,600907090.0,+1
2016-03-22,595.625,597.0,586.0,597.450012,513.718445,7097950.0,580.2774964,582.5736361454545,12.125,71.11190675154648,-0.409588011988009,16.892318765419077,87.79463481993122,-11126214.405773982,-720133.9214241715,92.0,40.0,56.0,12.77502400000003,593.4833373333333,600.9666746666667,604.4833373333333,611.9666746666667,589.9666746666667,582.4833373333333,578.9666746666667,1.0409101818181832,608005040.0,+1
2016-03-23,595.0,605.349976,591.049988,594.974976,521.424561,6333176.0,581.6024964000001,585.2459051636364,13.25,67.34470282234932,-2.048978076775894,14.966700934767346,91.7071902401198,3925150.572823581,-508984.6262310896,88.0,36.0,56.0,11.72497599999997,597.1249799999999,603.1999719999999,611.424968,617.4999599999999,588.8999839999999,582.824992,574.5999959999999,0.2744749156432851,601671864.0,-1
2016-03-28,616.200012,618.5,597.875,603.900024,520.172546,10787510.0,583.0674988,589.3000010909091,14.65002400000003,73.24260520555838,-2.810389990375355,13.3273898543099,117.12949177433184,-6729427.20488485,-791732.0161698998,96.0,32.0,56.0,17.674987999999985,606.7583413333333,615.6416826666666,627.3833413333332,636.2666826666666,595.0166826666666,586.1333413333333,574.3916826666666,0.2921223757575772,612459374.0,+1
2016-03-29,599.5,609.450012,595.775024,602.450012,516.869934,6995356.0,586.1875,592.8240944,31.200012000000015,70.84401503803406,-3.0895068334937412,11.727767935296924,89.58132945303281,5264675.79619988,-516440.7519712707,96.0,28.000000000000004,56.0,23.27502400000003,602.5583493333334,609.3416746666667,616.2333373333333,623.0166626666667,595.6666866666667,588.8833613333334,581.9916986666667,0.4881165526434094,605464018.0,-1
2016-03-30,598.799988,605.0,597.775024,598.625,520.6257929999999,5756818.0,588.9,595.0854580363638,27.125,64.42248052912542,-3.8257940327237727,9.528350235193102,74.3295756850039,2404049.8690620186,-383691.17828793806,92.0,24.0,96.0,18.625,600.4666746666667,603.1583253333333,607.6916506666666,610.3833013333333,595.9333493333334,593.2416986666667,588.7083733333334,0.1176441278144001,599707200.0,-1
2016-03-31,605.125,614.950012,600.150024,602.974976,525.957581,17996320.0,592.1375,597.6445445818182,32.375,68.20434060029075,-2.988455052935521,10.726311337883658,88.53013157013852,3049139.756701943,-227653.4085156693,88.0,20.0,52.0,11.0,606.025004,611.8999839999999,620.8249919999998,626.6999719999999,597.0999959999999,591.225016,582.3000079999999,0.1908752898988798,617703520.0,+1
2016-04-01,608.0,611.099976,597.549988,609.150024,520.409973,5511428.0,596.3325012,600.7377307636364,41.950012000000015,72.91942116340441,-1.7998028873917171,12.357739097351327,76.78993286141812,6368052.32225033,72151.3974282424,84.0,16.0,52.0,14.299987999999985,605.9333293333333,614.3166706666666,619.4833173333334,627.8666586666666,600.7666826666666,592.3833413333333,587.2166946666666,0.8560919758748169,623214948.0,+1
2016-04-04,606.775024,624.0,606.775024,602.724976,536.9230349999999,4577054.0,598.9825012,601.8999989090909,26.5,61.89920101894812,-4.05238552380953,14.166727360323648,89.51209483697457,-1027515.9099956788,22166.519818063753,80.0,12.0,64.0,23.52502400000003,611.1666666666666,615.5583093333332,628.3916426666665,632.7832853333332,598.3333333333333,593.9416906666667,581.1083573333333,-0.2351264814534469,618637894.0,-1
2016-04-05,621.0,621.150024,607.0,621.849976,526.605042,4790716.0,603.0799988,606.0577216,40.97497599999997,74.91822248179305,-0.4095283809523867,17.116923382176424,100.06492439756956,-2042933.0132877843,-71701.64077765735,96.0,8.0,68.0,13.674987999999985,616.6666666666666,626.3333333333333,630.8166906666665,640.4833573333333,612.1833093333332,602.5166426666666,598.0332853333332,1.0494664885374,623428610.0,+1
2016-04-06,614.0,614.0,598.0,609.900024,518.3593139999999,4931354.0,604.4,607.2977261818182,13.200012000000015,60.10998137054452,-2.6857097142857085,18.897238251904923,55.207719744020025,1356119.8906857704,-6800.662074773782,92.0,4.0,68.0,7.22497599999997,607.300008,616.6000160000001,623.3000080000002,632.6000160000001,600.6000160000001,591.300008,584.6000160000001,0.7437515000000019,618497256.0,-1
2016-04-07,604.200012,604.200012,587.5,600.349976,510.070404,5657890.0,604.6899964,606.5613581818182,2.8999639999999545,50.84306874581957,-4.504766476190482,19.551867703179028,16.100728632731382,-113444613.93162984,-5163064.9016000405,88.0,0.0,68.0,16.325012000000015,597.349996,607.1999920000001,614.0500080000002,623.9000040000001,590.49998,580.649984,573.799968,0.7694590878138265,612839366.0,-1
2016-04-08,587.924988,588.75,581.025024,590.75,503.27093499999995,4195578.0,604.2674988,604.0268133818182,-4.22497599999997,43.13070459248314,-6.333333333333334,18.206370515615617,-21.40507444685932,2013297.1178263717,-4836866.627989747,84.0,0.0,68.0,13.549987999999985,586.8416746666667,592.6583253333333,594.5666506666666,600.3833013333333,584.9333493333334,579.1166986666667,577.2083733333334,1.2589004807264137,608643788.0,-1
2016-04-11,582.900024,593.375,575.549988,582.875,511.106567,5768678.0,602.1649964000001,600.1372681454545,-21.02502400000003,37.71561891177083,-7.833333333333334,15.336262340363646,-32.68388961736825,2993425.7620480685,-4480944.246624389,80.0,0.0,68.0,17.22497599999997,583.9333293333333,592.3166706666666,601.7583413333334,610.1416826666666,574.4916586666666,566.1083173333333,556.6666466666666,0.41094008800667337,602875110.0,-1
2016-04-12,590.25,597.450012,589.299988,591.950012,510.37258899999995,5842138.0,601.1149963999999,598.2799982545455,-10.5,46.62594381811127,-6.104759619047615,14.231493690139132,-4.7129257579161825,4091248.0752580757,-4091299.1410842743,76.0,28.000000000000004,88.0,18.42504800000006,592.900004,596.50002,601.0500279999999,604.650044,588.3499959999999,584.7499799999999,580.1999719999999,0.3251553615056864,608717248.0,+1
2016-04-13,597.474976,597.474976,583.174988,591.099976,506.271271,12511386.0,600.3624940000001,596.4590854545454,-7.52502400000003,45.9160121214246,-6.266671238095244,12.773377134550742,-17.89317598511579,-769541.3051578954,-3940310.1485421658,72.0,24.0,88.0,23.84997599999997,590.5833133333333,597.9916386666666,604.8833013333333,612.2916266666666,583.6916506666666,576.2833253333333,569.3916626666667,0.5541954300940667,596205862.0,-1
2016-04-18,625.0,633.950012,616.75,586.349976,534.7644650000001,25015990.0,598.6999940000001,593.911354909091,-16.625,41.81126475476557,-8.898034383070552,11.720139436385011,64.27983884244503,-3107564.976442325,-3902458.0952649,68.0,20.0,88.0,22.40002400000003,612.349996,607.9499920000001,629.5500080000002,625.1500040000001,590.74998,595.149984,573.549968,-1.7674420227148682,571189872.0,-1
2016-04-20,622.0,623.224976,612.900024,619.349976,536.8798830000001,8072848.0,599.7199892,597.6658970909091,10.19995199999994,66.10277948567776,-2.7292336989423314,12.021540499840398,82.43140670253217,-2145581.131365907,-3822600.051451309,96.0,16.0,84.0,19.32495199999994,618.4916586666667,624.0832933333334,628.8166106666667,634.4082453333333,613.7583413333334,608.1667066666668,603.4333893333335,0.6246955918051703,579262720.0,+1
2016-04-21,625.5,625.5,609.049988,621.799988,529.411194,5441100.0,601.6274904,601.6804423272727,19.075012000000015,67.27314659522398,-2.2712447382840755,11.61424401185593,78.84105894544565,12575685.2548633,-3077223.446618824,92.0,12.0,80.0,17.825012000000015,618.7833253333333,628.5166626666667,635.2333373333333,644.9666746666667,612.0666506666666,602.3333133333333,595.6166386666666,0.7750754224373811,584703820.0,+1
2016-04-22,613.150024,614.25,603.5,613.150024,522.913879,5143938.0,600.7574952000001,603.7754484363636,-8.69995199999994,58.977698738653615,-3.888211521341172,10.60215315286257,35.65125935937661,-2782914.766581727,-3063845.77934441,88.0,8.0,48.0,14.575012000000015,610.300008,617.1000160000001,621.0500080000002,627.8500160000001,606.3500160000001,599.550008,595.6000160000001,0.8976766511627935,579559882.0,-1
2016-04-25,606.025024,612.400024,600.549988,605.625,524.89978,5364134.0,600.3299928000001,604.660449309091,-4.27502400000003,52.48167930545681,-5.294889497076975,9.117728145413821,14.595736383136758,2145025.195733304,-2827078.916840877,84.0,4.0,48.0,14.299987999999985,606.1916706666667,611.8333533333334,618.0417066666666,623.6833893333335,599.9833173333334,594.3416346666667,588.1332813333333,0.4282697537796506,574195748.0,-1
2016-04-26,607.724976,619.775024,604.299988,607.924988,531.9367070000001,5846744.0,601.0874940000001,606.0413575272727,7.575012000000015,54.25846801634309,-4.864945025928895,4.914224545185675,36.17815559278334,3057673.5078816325,-2559590.17026258,80.0,0.0,48.0,42.850036000000046,610.6666666666666,617.0333453333333,626.1417026666666,632.5083813333333,601.5583093333332,595.1916306666666,586.0832733333332,0.23424824342896453,580042492.0,+1
2016-04-27,614.599976,621.174988,614.275024,616.075012,535.390442,4486208.0,603.6199952000001,608.7663607999999,25.325012000000015,60.32418063670934,-3.341433703902786,2.2701857484350967,71.74644727925069,-2093646.9719419624,-2538410.933975279,76.0,0.0,80.0,36.875,617.175008,620.0749920000001,624.0749719999999,626.974956,613.1750280000001,610.2750440000001,606.2750640000002,0.2608691871435846,584528700.0,+1
2016-04-28,615.5,619.799988,603.5,620.075012,522.007324,12165168.0,607.3399964,611.7581820363637,37.200012000000015,63.09557647662158,-2.59370028764482,0.7418911723399333,56.808041539053775,-845057.7755667907,-2461440.335865802,72.0,60.0,80.0,16.450012000000015,614.4583333333334,625.4166666666667,630.7583213333332,641.7166546666667,609.1166786666668,598.1583453333334,592.8166906666668,1.016872650458395,596693868.0,+1
2016-04-29,605.724976,611.775024,602.5,604.575012,521.553955,5036410.0,608.6024964000001,611.2554576,12.625,48.07961220936616,-5.491167275644439,0.7443153783410708,4.223686744292304,3676101.759196813,-2182461.1497265915,68.0,56.00000000000001,80.0,18.299987999999985,606.2833453333334,610.0666906666668,615.5583693333333,619.3417146666668,600.7916666666667,597.0083213333334,591.5166426666667,0.2237203914512791,591657458.0,-1
2016-05-02,605.0,605.575012,598.075012,604.049988,518.510437,3615250.0,609.8974976000001,610.4277288,12.950012000000015,47.63652445613723,-5.5893117729288,2.2421442944133787,-26.050539869394843,-4683447.229597671,-2296142.3351752777,64.0,52.0,80.0,12.600036000000046,602.5666706666667,607.0583293333334,610.0666706666668,614.5583293333334,599.5583293333334,595.0666706666667,592.0583293333334,0.7966634666666627,588042208.0,-1
2016-05-03,601.375,606.099976,585.900024,600.525024,508.47311399999995,6824810.0,611.3150024,608.7236426909091,14.17504800000006,44.46225553550625,-6.248245116405378,3.563459446928732,-64.15442196759165,-2565808.800677955,-2308399.9017890356,60.0,48.0,80.0,15.475036000000046,597.5083413333333,609.1166586666666,617.7082933333331,629.3166106666665,588.9167066666666,577.3083893333334,568.7167546666667,0.7240116214137561,581217398.0,-1
2016-05-04,590.5,596.5,585.325012,588.900024,513.24353,5812842.0,608.2700072,604.6481920727274,-30.44995199999994,35.46863918279844,-8.421345357405093,4.897469643401905,-115.31682686507631,3074892.838681492,-2063704.777222193,56.00000000000001,44.0,76.0,13.25,590.2416786666666,595.1583453333333,601.4166666666667,606.3333333333333,583.9833573333333,579.0666906666667,572.8083693333333,0.3199119318964835,575404556.0,-1
2016-05-05,597.575012,599.5,590.549988,594.424988,514.7976679999999,6302668.0,605.5325071999999,602.1309158545455,-27.375,41.91201651990924,-7.38854530579953,7.027730596262245,-68.8896356214133,-1282881.1014669975,-2028212.791960593,52.0,40.0,12.0,16.299987999999985,594.824992,599.0999959999999,603.7750039999999,608.0500079999999,590.1499839999999,585.8749799999999,581.1999719999999,0.4329603133492998,581707224.0,+1
2016-05-06,594.900024,594.900024,588.525024,596.224976,510.070404,2596720.0,603.8400024,600.4386374545454,-16.92504800000006,44.013444706030555,-7.052067511683697,5.258791330256599,-67.9579735895375,5652064.0,-1679109.3014169286,48.0,36.0,11.999999999999993,17.575012000000015,593.2166746666667,597.9083253333333,599.5916746666667,604.2833253333333,591.5333253333333,586.8416746666667,585.1583253333333,1.2078356078431278,584303944.0,+1
2016-05-09,591.0,600.775024,590.299988,590.75,517.647095,5123678.0,602.3525024,598.0586370181818,-14.875,39.054798013413,-8.075523138786286,2.727114501851588,-55.761270191012116,-3439914.206709441,-1759145.8880211336,44.0,32.0,12.0,7.5,593.9416706666667,597.5833533333334,604.4167066666666,608.0583893333335,587.1083173333334,583.4666346666667,576.6332813333333,0.04296042514794347,579180266.0,-1
2016-05-10,601.25,608.325012,598.299988,599.525024,523.583069,3395704.0,601.512506,597.5445500363637,-8.399963999999954,49.563253113334405,-4.933518708452036,1.166882423922857,-0.8513114944098715,-841230.5625335024,-1717422.4641353323,40.0,28.000000000000004,12.0,20.19995199999994,602.050008,605.8000280000001,612.075032,615.8250520000001,595.7750040000001,592.024984,585.74998,0.122197812194768,582575970.0,+1
2016-05-11,599.25,607.349976,596.25,606.400024,518.855774,3709888.0,600.5450072,598.4331896727273,-9.674987999999985,56.36481250793436,-3.6277257359923967,0.9995341916943516,2.974065434204081,4388788.61941757,-1439867.414882927,36.0,24.0,12.000000000000007,15.200012000000015,603.3333333333334,610.4166666666667,614.4333093333335,621.5166426666667,599.3166906666668,592.2333573333334,588.2167146666668,0.914418553697779,586285858.0,+1
2016-05-12,601.950012,606.5,598.400024,600.924988,522.3742679999999,3406932.0,598.6300048,598.502277090909,-19.15002400000003,50.150426299973745,-3.8780103347271013,0.7396989141001313,-20.016118061001347,665572.2316479248,-1344165.6127678882,32.0,20.0,12.0,10.59997599999997,601.9416706666667,605.4833173333334,610.0416466666666,613.5832933333334,597.3833413333334,593.8416946666667,589.2833653333334,0.3117248742465365,582878926.0,-1
2016-05-13,603.0,605.0,596.075012,605.0,521.187012,5652064.0,598.6725036,599.6604580363637,0.4249879999999848,54.4621644396345,-3.09761830262157,-1.0360932949882908,-25.42150943263082,-1638788.923076923,-1357557.5814182989,28.000000000000004,16.0,12.0,6.375,602.025004,607.9749959999999,610.9499920000001,616.8999839999999,599.0500079999999,593.100016,590.12502,1.0,588530990.0,+1
2016-05-16,605.099976,611.825012,602.5,603.625,524.532837,4533878.0,598.6300048,600.5609119272727,-0.4249879999999848,52.68787951753505,-3.3609399920166196,-2.379344332151163,9.558099097232839,2970034.4333032803,-1160848.8534764086,24.0,12.0,12.0,10.475036000000046,605.9833373333333,609.4666746666667,615.3083493333334,618.7916866666667,600.1416626666667,596.6583253333333,590.8166506666666,0.1206432763839873,583997112.0,-1
2016-05-17,610.0,612.875,604.075012,607.5,524.2091059999999,3796294.0,599.3275024,602.1736383272728,6.97497599999997,57.219855762136895,-2.6188515946305695,-2.347433694062147,38.342953441209566,1637858.1860666848,-1033634.8971335407,20.0,8.0,11.999999999999996,17.575012000000015,608.150004,612.2249959999999,616.9499920000001,621.0249839999999,603.4250079999999,599.350016,594.62502,0.38920371255051606,587793406.0,+1
2016-05-18,599.5,607.0,598.950012,607.125,522.3095089999999,4256596.0,601.15,603.5913651636364,18.22497599999997,56.614307339145604,-2.4337535122984653,-2.8707236171417208,2.1069355200790323,-6435750.949736409,-1279185.6267973077,16.0,4.0,12.0,11.09997599999997,604.3583373333333,609.7666626666667,612.4083253333333,617.8166506666666,601.7166746666667,596.3083493333334,593.6666866666667,1.0155279734578486,583536810.0,-1
2016-05-19,605.474976,608.075012,600.5,604.924988,520.539368,3954400.0,602.2,604.2777266181818,10.5,52.829690853894085,-1.5470711748966217,-3.5909675464814654,15.429764687858347,-6735595.332076475,-1527204.249764543,12.0,0.0,12.0,8.09997599999997,604.5,608.5,612.075012,616.075012,600.924988,596.924988,593.349976,0.58415590628767,579582410.0,-1
2016-05-20,602.5,609.75,600.0,602.875,518.7478639999999,3994548.0,602.8650024000001,604.400453890909,6.65002400000003,49.2872360447361,-1.9459985405010947,-3.222651101710767,15.518988973233519,-5050926.629489325,-1687373.4488429425,8.0,4.0,12.000000000000004,8.924987999999985,604.2083333333334,608.4166666666667,613.9583333333335,618.1666666666667,598.6666666666667,594.4583333333334,588.9166666666667,0.2948717948717949,575587862.0,-1
2016-05-23,601.700012,602.575012,592.5,600.799988,512.876526,4585946.0,603.8700012,604.0249967272727,10.049987999999985,45.70765354055132,-2.3497955728533233,-3.0244329335716884,-65.46407444172503,-3206080.3278688523,-1756405.5797077566,4.0,0.0,12.0,9.325012000000015,598.625,604.75,608.700012,614.825012,594.674988,588.549988,584.599976,0.8238191676595494,571001916.0,-1
2016-05-24,595.525024,595.875,588.799988,594.0,512.7686160000001,3485060.0,603.3174988000001,602.2304510545455,-5.52502400000003,35.85980649486227,-3.673072245195816,-3.2581056806977813,-150.70036856090556,14626319.191429736,-1011736.2719287792,0.0,44.0,12.0,9.25,592.8916626666667,596.9833373333333,599.9666746666667,604.0583493333334,589.9083253333333,585.8166506666666,582.8333133333333,0.7349827816546465,567516856.0,-1
2016-05-25,597.049988,606.549988,597.049988,593.875,521.791504,3857396.0,602.0649964,600.513633090909,-12.52502400000003,35.69667795741401,-3.6973972269520794,-2.9998180863697144,-34.24645259816964,-3700308.997971898,-1133944.1231125575,4.0,40.0,12.0,8.549987999999985,599.1583253333333,601.2666626666667,608.6583253333333,610.7666626666667,591.7666626666667,589.6583253333333,582.2666626666667,-0.3342092631578931,563659460.0,-1
2016-05-26,605.049988,619.900024,605.049988,604.325012,532.80011,6136436.0,602.4049988000002,600.9245450181818,3.4000240000000304,55.30798751989845,-2.990019443731109,-1.5714511545082814,192.83145788019573,-3022484.8749571135,-1219786.8845600374,0.0,36.0,12.0,7.575012000000015,609.7583413333333,614.4666946666666,624.6083773333332,629.3167306666667,599.6166586666666,594.9083053333333,584.7666226666665,-0.04881981430886548,569795896.0,+1
2016-05-27,615.799988,629.75,615.799988,617.075012,538.5635990000001,6180764.0,603.6125000000001,603.5918201454544,12.075012000000015,68.7326972929181,-2.388127743758829,-0.556820034393354,419.7565132666578,-3375255.844155844,-1317762.7463598468,12.0,32.0,4.0,9.75,620.875,625.950012,634.825012,639.900024,612.0,606.924988,598.049988,0.0913994912692569,575976660.0,+1
2016-05-30,620.75,636.0,620.75,623.75,547.240967,5285700.0,605.625,607.2531837818182,20.125,73.5348649640746,-2.281191806331471,0.9220920028767523,413.3741704353936,-1142796.900476602,-1309809.753365154,96.0,28.000000000000004,4.0,10.375,626.8333333333334,632.9166666666667,642.0833333333335,648.1666666666667,617.6666666666667,611.5833333333334,602.4166666666667,0.19672131147540983,581262360.0,+1
2016-05-31,632.5,633.375,619.5,633.799988,539.0599980000001,13782038.0,608.2549988,612.3759088727272,26.299987999999985,79.10891495334496,-0.4096856610800773,1.7350553131949482,292.73034620800604,1930193.580082425,-1162536.8745720822,96.0,24.0,-44.0,12.0,628.8916626666667,638.2833253333333,642.7666626666667,652.1583253333333,624.4083253333333,615.0166626666667,610.5333253333333,1.0306297657657646,595044398.0,+1
2016-06-01,623.025024,634.25,623.0,624.325012,543.1828,4840534.0,609.975,615.2977294545454,17.200012000000015,64.36239829772258,-2.1741132216014867,2.7533046765151994,191.34338267488715,4737496.421829216,-894353.5429174775,92.0,20.0,-36.0,12.549987999999985,627.1916706666667,631.3833413333334,638.4416706666666,642.6333413333334,620.1333413333334,615.9416706666667,608.8833413333334,0.1177788444444458,590203864.0,-1
2016-06-02,627.5,637.450012,627.0,629.099976,544.62915,5053552.0,612.3924988,618.7749978181819,24.174987999999985,67.84752315611014,-1.550754167315358,3.9631807602609115,177.9872307583432,19276664.540318474,22510.915411430007,88.0,16.0,-36.0,26.02502400000003,631.1833293333333,635.3666586666666,641.6333413333332,645.8166706666666,624.9166466666666,620.7333173333333,614.4666346666666,0.20095441038727674,595257416.0,+1
2016-06-03,630.025024,639.650024,630.025024,630.775024,546.938843,3998380.0,615.1825011999999,622.1172751272727,27.90002400000003,69.07177273088097,-1.641542514756274,5.628287670334771,153.7880131597156,3496743.2006586567,180430.56474084954,96.0,12.0,-20.0,25.424987999999985,633.4833573333334,636.9416906666668,643.1083573333335,646.5666906666668,627.3166906666668,623.8583573333334,617.6916906666668,0.07792207792207792,599255796.0,+1
2016-06-06,632.450012,638.5,630.549988,633.450012,546.8740230000001,4225768.0,618.4475035999999,625.4386407272727,32.65002400000003,71.09947308421675,-1.1467699481689129,6.836373362158838,125.22914692491177,2881099.831196798,303188.2586706655,96.0,8.0,68.0,18.924987999999985,634.1666666666666,637.7833453333333,642.1166786666665,645.7333573333333,629.8333333333333,626.2166546666666,621.8833213333332,0.36478234246690755,603481564.0,+1
2016-06-07,633.5,636.25,627.549988,633.375,542.837524,5692420.0,622.3850036,628.1527309818181,39.375,70.94896783606279,-1.1606443579849042,8.452206677960021,95.6854427338168,2358406.546251809,396607.27174253576,92.0,4.0,72.0,13.875,632.3916626666667,637.2333373333333,641.0916746666667,645.9333493333334,628.5333253333333,623.6916506666666,619.8333133333333,0.6695406856910088,597789144.0,-1
2016-06-08,631.974976,631.974976,617.674988,628.700012,534.505493,8741370.0,625.8675048000001,629.3009143272727,34.825012000000015,61.57567649390296,-2.025341998320158,10.213110223401827,52.773004862128474,-10708959.753545517,-108191.22940692162,88.0,0.0,72.0,11.25,626.1166586666667,634.5583293333334,640.4166466666668,648.8583173333334,620.2583413333334,611.8166706666667,605.9583533333334,0.7709813462780558,589047774.0,-1
2016-06-09,613.125,613.125,590.025024,619.049988,523.856018,12740804.0,627.3400024000001,628.0613658181819,14.72497599999997,46.83771199971582,-3.8102349182546313,12.178179077759978,-32.828957443880014,5548532.693330243,148932.58526294972,84.0,4.0,72.0,13.125,607.400004,624.7749839999999,630.49998,647.8749599999999,601.6750079999999,584.300028,578.575032,1.256493253499484,576306970.0,-1
2016-06-10,587.700012,595.0,585.049988,592.75,521.690735,6383956.0,624.9075012,621.7722744727272,-24.325012000000015,26.723666690851744,-8.674747418488977,14.092775696001809,-99.3731293536396,2002138.6181666492,233169.22312220887,80.0,0.0,84.0,10.55004800000006,590.9333293333333,596.8166706666666,600.8833413333334,606.7666826666666,586.8666586666666,580.9833173333333,576.9166466666666,0.7738696194537257,569923014.0,-1
2016-06-13,588.400024,592.450012,583.0,590.299988,521.823303,5286722.0,621.5625,615.4799993454545,-33.450012000000015,25.544534974617676,-9.12790785338059,14.769702748659824,-97.15353563005124,-6307174.128077351,-64119.11102322587,76.0,96.0,88.0,7.950012000000015,588.5833333333334,594.1666666666667,598.0333453333333,603.6166786666668,584.7166546666667,579.1333213333334,575.2666426666667,0.7724845217127738,564636292.0,-1
2016-06-14,591.200012,591.200012,583.625,590.450012,519.216125,2940728.0,617.2275024,609.8231833454545,-43.34997599999997,25.77592864942733,-9.100159033748607,13.361483006951516,-88.07706324138093,1752990.5631382766,18476.783256842486,72.0,96.0,88.0,8.700012000000015,588.425008,593.2250160000001,596.00002,600.8000280000001,585.6500040000001,580.849996,578.0749920000001,0.9009902558570206,567577020.0,+1
2016-06-15,591.849976,596.325012,589.525024,587.5,525.8223879999999,6711572.0,613.5450012000001,604.418182909091,-36.825012000000015,24.078121152717742,-9.645800737077193,11.379439534843414,-69.733354339091,1541103.3617331972,87687.08227849503,68.0,92.0,88.0,15.700012000000015,591.1166786666666,592.7083333333333,597.9166666666665,599.5083213333332,585.9083453333333,584.3166906666667,579.1083573333333,-0.29779817258501556,560865448.0,-1
2016-06-16,594.75,594.75,585.049988,594.974976,524.0769650000001,5302564.0,610.1325011999999,601.0418146909091,-34.125,36.33805095211252,-8.263210213045335,8.402532672178381,-63.283654548871304,-1638287.2291140356,9233.704487925392,64.0,88.0,80.0,38.674987999999985,591.5916546666666,598.1333213333332,601.2916666666667,607.8333333333333,588.4333093333332,581.8916426666666,578.7332973333332,1.0231933733690195,566168012.0,+1
2016-06-17,594.5,596.375,587.549988,593.0,521.204651,8515082.0,606.3549988,597.9268144727273,-37.77502400000003,34.63309835364164,-8.628506784270488,6.096305165471108,-59.001027669808316,12853732.482033217,593074.5580127118,60.0,84.0,80.0,34.0,592.3083293333333,597.0666706666666,601.1333413333334,605.8916826666666,588.2416586666666,583.4833173333333,579.4166466666666,0.6175642594027074,557652930.0,-1
2016-06-20,590.5,605.900024,589.849976,589.75,534.129761,6229566.0,601.9849976,594.9077237818182,-43.700012000000015,31.800086293056793,-9.229635029110815,3.0684255496836386,-50.23280512395614,11047273.47125691,1068265.4177056302,56.00000000000001,80.0,-20.0,9.75,595.1666666666666,600.4833573333333,611.2167146666666,616.5334053333333,584.4333093333332,579.1166186666666,568.3832613333332,-0.00622901563907904,551423364.0,-1
2016-06-21,605.599976,607.400024,597.825012,604.375,532.9588620000001,4761724.0,599.0849976,595.3422696727273,-29.0,52.131491418678046,-6.52455792732935,-0.2054354380491077,-26.34848789542116,2111958.2346479087,1115706.0002939154,52.0,76.0,-24.0,7.575012000000015,603.200012,608.575012,612.775024,618.150024,599.0,593.625,589.424988,0.6840709964645448,556185088.0,+1
2016-06-22,602.0,605.974976,594.075012,603.049988,530.042358,3031258.0,596.5199952,596.0631770181817,-25.65002400000003,50.55595751618775,-6.769635508237773,-3.9504634953167397,-35.78277234362004,-6041047.816535846,790399.008619835,48.0,72.0,-24.0,6.799987999999985,601.0333253333333,607.9916386666666,612.9332893333333,619.8916026666666,596.0916746666667,589.1333613333334,584.1917106666667,0.7542019454848774,553153830.0,-1
2016-06-23,598.650024,607.424988,596.674988,599.75,535.389221,3828626.0,594.5899964,596.6504506181817,-19.299987999999985,46.51605458330362,-7.380009660371351,-8.151034116776486,-35.15474878403945,705906.1097587122,786558.4223079657,44.0,68.0,-24.0,9.700012000000015,601.2833253333333,605.8916626666667,612.0333253333333,616.6416626666667,595.1416626666667,590.5333253333333,584.3916626666667,0.28604762790697813,549325204.0,-1
2016-06-24,594.0,599.5,580.0,605.799988,527.855103,7808348.0,595.8949952,598.6886309090909,13.049987999999985,54.24967471013908,-6.061169972196481,-12.067744883020055,-56.86509171182758,-3427342.496397917,595017.4714576981,40.0,64.0,-24.0,8.825012000000015,595.099996,610.1999920000001,614.5999959999999,629.6999920000001,590.6999920000001,575.599996,571.1999920000001,1.3230763076923069,557133552.0,+1
2016-06-27,586.025024,591.599976,580.0,597.275024,515.327576,5583778.0,596.5924988000002,598.9395452363636,6.9750360000000455,43.92344577732123,-7.254532526756625,-15.312860226867087,-73.83992590707882,-7603996.942686539,222334.99808750523,36.0,96.0,-23.999999999999993,16.05004800000006,589.625,599.25,601.224976,610.849976,587.650024,578.025024,576.0500480000001,1.4892292880606024,551549774.0,-1
2016-06-28,581.400024,586.25,577.549988,583.099976,512.21228,7655974.0,595.8574952,596.4863592727273,-7.3500360000000455,32.17375866350022,-9.170224157015582,-15.586755023357455,-94.96870947250186,2044137.983873477,305144.2247141404,32.0,92.0,-24.0,17.65002400000003,582.299988,587.049988,591.0,595.75,578.349976,573.599976,569.649964,0.637928775270652,543893800.0,-1
2016-06-29,584.5,589.950012,580.099976,579.575012,520.03363,5459150.0,595.0649964,593.5259077818182,-7.924987999999985,29.880290240919578,-6.525648042791148,-16.05747024051459,-78.09164243846625,9267240.045743955,712512.2165791324,28.000000000000004,96.0,-24.0,11.899963999999954,583.2083333333334,586.3166906666668,593.0583693333333,596.1667266666668,576.4666546666667,573.3582973333333,566.6166186666667,-0.05329564277734133,538434650.0,-1
2016-06-30,590.25,592.25,583.974976,588.424988,517.360291,9346224.0,594.4099976000001,592.3186335272727,-6.549987999999985,41.881858438958204,-3.7370311153943523,-16.356394199606598,-47.303841522136935,-2467399.111111111,567970.7925932121,24.0,92.0,-24.0,10.75,588.2166546666666,592.4583333333333,596.4916786666668,600.7333573333333,584.1833093333332,579.9416306666666,575.9082853333332,0.5377642409254643,547780874.0,+1
2016-07-01,590.0,590.0,585.049988,585.400024,518.067261,3991912.0,593.6500000000001,590.680456509091,-7.59997599999997,39.23347600155566,-4.331998725444225,-15.650246061773942,-45.79544395617701,-7952768.472685753,180664.46235325883,20.0,88.0,-24.0,19.75,586.8166706666667,588.5833533333334,591.7666826666666,593.5333653333334,583.6333413333334,581.8666586666667,578.6833293333334,0.07071417200605665,543788962.0,-1
2016-07-04,588.099976,597.299988,588.099976,586.200012,523.170959,5381322.0,593.2950012,589.3259132363636,-3.549987999999985,40.383826072764464,-4.174652407131487,-15.13172030017779,-23.913021567746387,878231.4786814944,212372.05400454227,16.0,84.0,-60.0,25.799987999999985,590.5333253333333,592.9666746666667,599.7333373333333,602.1666866666667,583.7666626666667,581.3333133333333,574.5666506666666,-0.20651755671622507,549170284.0,+1
2016-07-07,584.349976,585.5,577.5,587.724976,511.37268099999994,5954876.0,590.5224976,588.2986317818181,-15.325012000000015,43.475483899037215,-3.874713569349588,-11.342923782084199,-41.921807397925114,6372456.672755811,284271.6465100028,8.0,76.0,-68.0,9.850036000000046,583.574992,589.6499839999999,591.5749919999998,597.6499839999999,581.6499839999999,575.574992,573.6499839999999,1.2781219999999962,546811824.0,-1
2016-07-08,581.5,583.5,576.75,578.625,511.79241900000005,5551648.0,588.4099976,586.1354504000001,-21.125,34.61089293801166,-5.664550067314942,-11.734776867603614,-58.030869439782826,49312122.38208873,2512810.3163090376,4.0,96.0,-68.0,12.674987999999985,579.625,582.5,586.375,589.25,575.75,572.875,569.0,0.2777777777777778,541260176.0,-1
2016-07-15,594.75,594.950012,526.0,588.125,473.944946,61484126.0,586.9850036,587.7195511272728,-0.2999879999999848,48.08433239170191,-2.272727272727273,-7.213047324954232,-129.67595193200572,9386538.0,2901067.759671972,0.0,80.0,-92.0,10.97497599999997,569.6916706666667,613.3833413333334,638.6416826666668,682.3333533333334,544.4333293333334,500.7416586666667,475.4833173333334,0.9010150716144906,505331048.0,-1
2016-07-18,538.625,542.450012,527.575012,536.275024,478.098633,14332824.0,582.0725036000001,578.4995548363636,-49.125,20.480261410275745,-12.374128957508953,-5.787109850216211,-325.1884661015444,-564676.9519502729,2743533.909143688,36.0,96.0,-96.0,10.72497599999997,535.4333493333334,543.2916866666667,550.3083493333334,558.1666866666667,528.4166866666667,520.5583493333334,513.5416866666667,0.5848747563025221,490998224.0,-1
2016-07-21,539.5,543.599976,537.799988,541.549988,477.19280999999995,8668002.0,568.0825012000001,559.1681796363636,-46.174987999999985,26.707481573101518,-11.317074952938642,-10.047903545856116,-156.00524755234417,8465761.527296973,2835267.9926605374,24.0,84.0,-84.0,16.02502400000003,540.9833173333333,544.1666466666666,546.7833053333331,549.9666346666666,538.3666586666666,535.1833293333333,532.5666706666666,0.6465530618339227,502557762.0,-1
2016-07-22,535.0,539.950012,533.349976,539.950012,473.90075700000006,9386538.0,564.2150024,554.0531816,-38.674987999999985,25.985188342706863,-11.637695347317896,-12.916003301876458,-140.78376086679296,9350459.707317073,3131413.070599471,20.0,80.0,-80.0,70.90002400000003,537.75,542.150024,544.350036,548.7500600000001,535.549988,531.149964,528.9499519999999,1.0,493171224.0,-1
2017-01-11,487.10000599999995,489.22500599999995,481.97500599999995,485.27499400000005,437.51687599999997,12241574.0,495.17249460000005,492.40772269090905,-14.200011999999901,33.45734355342181,-5.202776044624416,1.3316633855241662,-167.156747387618,31.890833668302275,-138833.02505374613,40.0,0.0,48.0,5.975005999999951,485.4916686666666,489.0083313333333,492.7416686666666,496.2583313333333,481.7583313333333,478.2416686666666,474.5083313333333,0.4551707586207032,397276544.0,+1
2017-01-12,488.77499400000005,502.200012,488.77499400000005,484.549988,451.48980700000004,11855740.0,493.70249340000004,490.4763578545454,-14.700012000000015,32.49276980209969,-5.380702540562689,0.9563893273076474,-61.86379107819517,-4708375.214302409,-346539.48820141284,36.0,96.0,48.00000000000001,10.375,491.8416646666667,494.90833533333335,505.26668266666667,508.3333533333333,481.4833173333334,478.41664666666674,468.0582993333334,-0.3147113843720787,385420804.0,-1
2017-01-13,515.0,520.0,481.35000599999995,500.02499400000005,440.54174800000004,31276246.0,494.087494,491.62590341818185,3.8500060000000644,60.52294689090539,-4.744657007125879,-0.1916210616728904,49.66652011610942,21758835.23168237,658250.2717933054,32.0,92.0,48.0,15.399993999999936,500.4583333333333,519.5666606666666,539.1083273333334,558.2166546666667,480.91666666666663,461.80833933333327,442.2666726666666,0.4831821707397956,416697050.0,+1
2017-01-16,482.5,482.72500599999995,476.22500599999995,487.89999400000005,431.44467199999997,12351372.0,492.34749460000006,490.50090341818185,-17.399993999999936,44.00443751641962,-7.624704513064122,-1.1065391691094533,-161.6573794829342,-264942.068560087,616286.9835954239,96.0,96.0,48.0,15.575012000000015,482.2833353333333,488.34166466666665,488.78333533333324,494.84166466666665,481.84166466666665,475.7833353333333,475.34166466666665,1.796152000000015,404345678.0,-1
2017-01-17,478.125,482.0,476.200012,477.825012,431.331818,5560094.0,490.07499700000005,487.86045203636365,-22.72497599999997,34.87780820048863,-10.017811876484558,-1.7765366430581935,-164.4331379112624,10549295.703573905,1067787.3799580825,92.0,96.0,40.0,6.524994000000049,478.675008,481.15000399999997,484.4749959999999,486.94999199999995,475.350016,472.87502,469.550028,0.28017299346136654,398785584.0,-1
2017-01-18,479.049988,480.5,474.89999400000005,477.700012,429.255066,5952962.0,488.1524994000001,485.61045476363637,-19.22497599999997,34.77455840449261,-10.047503087885982,-4.216888164710554,-146.0777929798668,7899321.25,1378311.64677817,88.0,96.0,40.0,7.25,477.70000200000004,480.50001000000003,483.300008,486.100016,474.9000040000001,472.0999960000001,469.29999800000013,0.500002678568557,392832622.0,-1
2017-01-19,475.5,479.799988,474.049988,475.39999400000005,432.550751,8876480.0,485.8049988000001,483.29181741818184,-23.47500599999995,32.71820116683236,-10.593825653206638,-5.859825200049727,-134.69173329039162,5615526.83298887,1570912.3370604748,84.0,96.0,-60.0,16.925017999999966,476.4166566666667,478.78332533333344,482.16665666666677,484.53332533333344,473.03332533333344,470.6666566666667,467.28332533333344,0.23478365217392425,383956142.0,-1
2017-01-20,475.0,476.575012,473.0,479.049988,428.30697599999996,9124742.0,483.9024964000001,482.06363363636365,-19.02502400000003,39.2916623643229,-9.726843705463187,-6.765873668674601,-116.92107867331485,1982743.6025223185,1589631.9400360133,80.0,96.0,-60.0,38.64999400000005,476.2083333333333,479.41666666666663,479.7833453333333,482.99167866666664,475.8416546666666,472.6333213333333,472.2666426666666,1.6922986552212858,393080884.0,+1
2017-01-23,472.5,479.0,470.0,474.35000599999995,430.112854,7948580.0,482.72499700000003,480.32681720000005,-11.77499400000005,34.31105273669803,-10.843228978622339,-8.427320575885346,-116.63681472540974,34240124.42778455,3073745.2349336753,76.0,96.0,0.0,23.7999880000001,474.450002,478.90000399999997,483.45000200000004,487.90000399999997,469.90000399999997,465.450002,460.90000399999997,0.48333399999999455,385132304.0,-1
2017-01-24,475.0,475.0,470.049988,476.35000599999995,426.884857,6826010.0,481.84249880000004,479.1677279272727,-8.824982000000034,38.15992765062942,-10.368169596199536,-9.705806373230928,-102.23921133350366,18431643.391137682,3771831.514761131,72.0,96.0,-4.0,11.699982000000034,473.79999799999996,477.55000799999993,478.75001,482.50001999999995,472.5999959999999,468.84998599999994,467.6499839999999,1.2727278236901136,391958314.0,+1
2017-01-25,473.049988,473.39999400000005,467.39999400000005,472.77499400000005,422.84417699999995,9978090.0,480.59249880000004,477.5190906909091,-12.5,34.045608215162446,-11.217341092636568,-9.551471336953114,-99.61319694422109,-7320634.075253571,3267628.5333968257,68.0,92.0,-8.0,5.600005999999951,471.1916606666667,474.9833273333333,477.1916606666667,480.9833273333333,468.9833273333333,465.1916606666667,462.9833273333333,0.8958333333333334,381980224.0,-1
2017-01-27,466.924988,473.77499400000005,450.575012,468.299988,425.349884,10635138.0,478.96749880000004,475.2840887272727,-16.25,29.458261163616882,-12.280287885985752,-9.18062104455845,-119.55177058903253,4180158.1398889003,3309107.151873738,64.0,96.0,-12.0,5.75,464.2166646666667,477.8583173333334,487.4166466666668,501.0582993333334,454.65833533333335,441.01668266666667,431.4583533333333,0.7640081789718606,371345086.0,-1
2017-01-30,468.75,475.75,464.424988,471.075012,428.600433,11369208.0,476.0725006,473.84909112727274,-28.949982000000034,35.66116074160608,-11.621137292161517,-9.127675625468328,-70.0513068014981,-1070370.5122105326,3110039.985324453,60.0,96.0,-16.0,3.575012000000015,470.4166666666667,476.4083453333334,481.74167866666676,487.7333573333334,465.08333333333337,459.09165466666667,453.75832133333336,0.5871979649999507,382714294.0,+1
2017-01-31,470.75,470.75,452.174988,474.674988,419.232483,24068534.0,474.75,473.59499792727274,-13.225006000000064,43.14459755722847,-10.766036104513068,-9.462154569937411,-82.4252447769009,-3423698.506727239,2813051.872049376,56.00000000000001,92.0,-20.0,9.049987999999985,465.86665866666664,479.5583293333333,484.4416706666666,498.1333413333333,460.9833173333333,447.2916466666666,442.40830533333326,1.2113047356308562,406782828.0,+1
2017-02-01,460.549988,461.60000599999995,452.575012,464.299988,413.882599,11531782.0,473.3974976,471.6949957454545,-13.52502400000003,31.11134427472794,-13.230406650831359,-12.222400594470344,-101.37353539208064,4312783.605129125,2881221.4962802734,52.0,88.0,-24.0,4.950012000000015,459.4916686666666,466.4083253333332,468.51666266666655,475.43331933333315,457.3833313333333,450.4666746666667,448.35833733333334,1.2991671795017319,395251046.0,-1
2017-02-02,458.5,472.5,455.049988,458.375,422.52819800000003,11828268.0,471.4649964,468.9636325454545,-19.325012000000015,26.281303343090585,-14.637767220902612,-13.88737850743928,-76.91626254839343,-11995774.532603417,2204994.404058287,48.0,84.0,-24.0,8.950011999999901,461.974996,468.90000399999997,479.42500799999993,486.350016,451.44999199999995,444.52498399999996,433.99997999999994,0.19054496925274392,383422778.0,-1
2017-02-03,466.89999400000005,470.450012,460.52499400000005,467.950012,422.61846900000006,8423958.0,470.7199982000001,468.32454447272727,-7.449982000000034,42.831069468055546,-12.363417577197145,-13.55443282574862,-46.76896470163371,-9947103.317259176,1652626.3258165836,44.0,80.0,-32.0,23.199982000000034,466.3083393333334,472.0916846666667,476.23335733333334,482.0167026666667,462.16666666666674,456.3833213333334,452.2416486666668,0.7481112880601316,391846736.0,+1
2017-02-06,468.625,471.875,465.27499400000005,468.049988,422.23477199999996,6727934.0,469.61999820000005,467.83908807272724,-11.0,42.98527699343098,-3.824358009131145,-13.247605680956042,-31.249492445350437,-7290080.878174815,1246139.6347260652,40.0,76.0,-36.0,11.325012000000015,468.39999400000005,471.52499400000005,475.00000000000006,478.125,464.9249880000001,461.7999880000001,458.32498200000015,0.42045325413339873,398574670.0,+1
2017-02-07,466.5,474.89999400000005,464.27499400000005,467.625,425.39502000000005,9268002.0,468.9474976000001,467.4763611272727,-6.725005999999951,42.42398891496772,-3.7532637075718016,-12.852862300706704,-26.19927491650569,4122521.875546101,1376884.282036067,36.0,72.0,-35.99999999999999,18.90002400000003,468.9333293333334,473.59166466666676,479.55832933333346,484.21666466666676,462.96666466666676,458.3083293333334,452.34166466666676,0.31529468235293656,389306668.0,-1
2017-02-08,468.0,472.049988,466.22500599999995,471.125,422.79907199999997,6319962.0,468.424997,467.87227065454545,-5.225005999999951,48.77948314292627,-2.45740498034076,-12.335715980329951,-19.74844386497576,1887477.9751775046,1400093.0862697687,32.0,68.0,-36.0,22.09997599999997,469.79999799999996,473.37498999999997,475.62498,479.199972,467.55000799999993,463.9750159999999,461.7250259999999,0.8412032861217461,395626630.0,+1
2017-02-09,468.5,475.0,468.27499400000005,468.25,427.088013,11907266.0,467.9724976,467.84045301818185,-4.524994000000049,44.159411176040265,-3.033085179614025,-11.557811666741031,-13.928286659021705,-21682161.472246356,350899.6972463076,28.000000000000004,64.0,-36.0,17.450012000000015,470.5083313333334,472.7416686666667,477.2333373333334,479.4666746666667,466.0166626666668,463.78332533333344,459.2916566666668,-0.003716576609753127,383719364.0,-1
2017-02-10,473.125,486.0,471.64999400000005,473.0,437.15573099999995,12252452.0,468.4424988,468.75454436363634,4.700012000000015,52.69980911451736,-3.359173126614987,-11.177320398952304,21.18550505418391,4090674.585064836,520889.4648744227,24.0,60.0,-36.0,12.075012000000015,476.8833313333334,482.1166686666667,491.2333373333334,496.4666746666667,467.7666626666668,462.53332533333344,453.4166566666668,0.09407703383538343,395971816.0,+1
2017-02-13,486.424988,493.049988,481.424988,484.14999400000005,444.40176399999996,13724268.0,469.749997,471.61045258181815,13.074982000000034,66.55445265214684,-2.2585951709253536,-9.90092862686464,76.42622059193329,-3013634.9288473674,360229.26515979576,20.0,56.00000000000001,-36.0,6.600005999999951,486.20832333333334,490.9916586666667,497.8333233333333,502.6166586666667,479.3666586666667,474.58332333333334,467.7416586666667,0.23440911827957545,409696084.0,+1
2017-02-14,490.0,494.5,486.174988,492.174988,445.914215,9338818.0,471.499997,475.6877236727272,17.5,73.09826385901937,-0.5878664981036701,-7.76446304137977,100.41947542989307,-1261209.7054205486,286527.49376978003,16.0,52.0,-36.0,10.625,490.949992,495.72499600000003,499.2750040000001,504.05000800000005,487.399984,482.62498,479.074972,0.7207196818455023,419034902.0,+1
2017-02-15,494.60000599999995,499.39999400000005,484.39999400000005,493.85000599999995,443.25051900000005,7259486.0,474.4549988,479.7513616727272,29.550017999999966,74.30885790443236,-1.3861109098818063,-6.582823125383811,103.39757055802197,5960905.164244319,544453.751518623,12.0,48.0,-36.0,5.824982000000034,492.549998,500.700002,507.549998,515.700002,485.700002,477.549998,470.700002,0.6300007999999935,426294388.0,+1
2017-02-16,495.5,506.950012,495.02499400000005,490.89999400000005,456.92999299999997,12815858.0,477.70749820000003,482.74136080000005,32.52499400000005,68.08286976404806,-3.9343099712912784,-5.9492071688121655,122.9999168952047,-11834289.294777626,-18216.386949388834,8.0,44.0,-36.0,6.725005999999951,497.62500000000006,500.22500600000006,509.55001799999997,512.150024,488.2999880000001,485.6999820000001,476.37497000000013,-0.34591142755507887,413478530.0,-1
2017-02-17,506.875,506.875,496.35000599999995,506.049988,451.51239000000004,4851208.0,481.5174958,487.8945407636363,38.09997599999997,78.67190435956283,-0.2206211480636089,-3.379931332180547,143.1435307489308,-4067096.2322064913,-202256.37991562093,4.0,40.0,-36.0,17.75,503.09166466666665,509.83332333333334,513.6166586666668,520.3583173333334,499.3083293333333,492.5666706666666,488.78333533333324,0.9216140170721226,418329738.0,+1
2017-02-20,498.25,515.5,496.75,500.049988,456.094788,4650662.0,484.7174958,491.2640847999999,32.0,68.31488952875117,-3.7094866746698716,0.09081228058965962,131.2251111838281,-3157746.6217314424,-336596.8454527038,0.0,36.0,-36.00000000000001,20.049987999999985,504.099996,511.44999199999995,522.8499959999999,530.199992,492.69999199999995,485.349996,473.94999199999995,0.1759993599999992,413679076.0,-1
2017-02-21,511.049988,512.25,500.02499400000005,505.125,457.607208,7613996.0,488.46749580000005,494.97454010909087,37.5,71.92240770928204,-2.4909963985594237,3.6317136285799734,125.03578680553785,-3116788.595314629,-462969.1977191551,96.0,32.0,-36.0,10.35000599999995,505.799998,511.575002,518.0250039999999,523.8000079999999,499.34999600000003,493.57499200000007,487.1249900000001,0.4171782001579362,421293072.0,+1
2017-02-22,507.5,507.5,493.200012,506.799988,447.02029400000004,6607838.0,492.0349946,498.30772050909087,35.674987999999985,73.08922290139668,-2.08883841536615,6.730562016489898,100.34685033176932,1487080.8632960154,-374330.55858210183,92.0,28.000000000000004,-36.0,15.0,502.5,511.799988,516.799988,526.099976,497.5,488.200012,483.200012,0.9510480708095688,427900910.0,+1
2017-02-23,499.450012,510.0,496.674988,495.075012,455.462738,9542656.0,494.71749580000005,498.86045094545455,26.825012000000015,54.721719897059,-4.903958703481389,9.245715526362233,83.04991672181411,1896124.4465563954,-271128.05834853364,88.0,24.0,-36.0,13.100006000000064,500.5833333333333,504.49167866666664,513.9083453333333,517.8166906666667,491.16666666666663,487.2583213333333,477.8416546666666,-0.12007313764520196,418358254.0,-1
2017-02-27,503.64999400000005,511.5,503.47500599999995,504.424988,457.06546,5328696.0,497.8599946,500.62544952727274,31.424987999999985,63.225149671235975,-2.659066506602645,11.751846539157555,95.5759687238469,2195872.004256023,-158991.69186650828,84.0,20.0,-36.0,15.97500599999995,506.46666466666665,509.45832333333334,514.4916586666668,517.4833173333334,501.4333293333333,498.4416706666666,493.40833533333324,0.11837790782149224,423686950.0,+1
2017-02-28,505.924988,511.35000599999995,504.625,506.200012,457.06546,5940132.0,500.06499640000004,502.1418163272727,22.050017999999966,64.67822576615882,-2.2328902761104406,14.841316060121528,85.80699195762071,11422907.553277003,367458.27382183354,80.0,16.0,-36.0,18.75,507.39167266666664,510.1583453333333,514.1166786666665,516.8833513333332,503.4333393333333,500.6666666666667,496.70833333333337,0.23420231892730306,429627082.0,+1
2017-03-01,506.0,513.5,505.049988,506.200012,462.82165499999996,4282448.0,501.4674988,503.25727370909095,14.02502400000003,64.67822576615882,-2.2328902761104406,17.817997940990836,75.86482125335382,9057789.76353119,762473.3415358955,76.0,12.0,64.0,12.22500599999995,508.25,511.450012,516.700012,519.900024,503.0,499.799988,494.549988,0.13609732151860002,429627082.0,-1
2017-03-02,512.200012,514.0,508.25,512.575012,461.98645,2948498.0,503.3399994,505.2768215636364,18.725006000000064,70.29121390168396,-0.7022780312124813,19.3808323369999,73.86317287361395,895013.1760629062,768497.8794689415,72.0,8.0,64.0,14.299987999999985,511.60833733333334,514.9666746666667,517.3583373333333,520.7166746666667,509.2166746666667,505.85833733333334,503.4666746666667,0.7521760000000026,432575580.0,+1
2017-03-03,505.125,517.150024,500.200012,511.64999400000005,465.552979,5401612.0,505.4149994,506.78772967272727,20.75,68.46955516228377,-1.3153245687724702,20.102661933724846,55.29614570509249,-5731834.626198412,473028.2201204251,68.0,4.0,64.0,13.325012000000015,509.6666766666667,519.1333413333334,526.6166886666667,536.0833533333334,502.1833293333334,492.7166646666667,485.2333173333334,0.675514684001405,427173968.0,-1
2017-03-06,510.02499400000005,517.974976,509.85000599999995,515.599976,466.77197300000006,5286386.0,506.36999820000005,508.63954359999997,9.549987999999985,72.03980795647645,-0.5668596302992568,20.58184489744258,60.267395984421704,-8662119.207720974,57794.24612763385,96.0,0.0,64.0,16.424987999999985,514.474986,519.099966,522.599956,527.224936,510.9749959999999,506.3500159999999,502.8500259999999,0.7076912283983825,432460354.0,+1
2017-03-07,511.0,512.900024,507.35000599999995,516.950012,460.406311,4644496.0,508.0600006000001,510.56318247272725,16.90002400000003,73.23499094799683,-0.2446360901515881,21.35332566472823,46.34877810493348,6327463.819973894,342779.2267570095,96.0,4.0,64.0,6.925017999999966,512.4000139999999,517.450022,517.950032,523.00004,511.90000399999985,506.84999599999986,506.3499859999998,1.7297252008912272,437104850.0,+1
2017-03-08,508.450012,508.450012,502.22500599999995,509.89999400000005,454.98867800000005,6179176.0,508.5375,510.8977267272728,4.774994000000049,58.235545987541116,-1.927318446818151,20.111625008188355,24.221786115042214,-7686526.373187404,-22189.20960410051,92.0,0.0,64.0,8.450012000000015,506.85833733333334,511.4916686666667,513.0833433333335,517.7166746666668,505.26666266666666,500.6333313333333,499.0416566666666,1.232928610831864,430925674.0,-1
2017-03-09,503.89999400000005,506.5,499.5,503.89999400000005,456.681702,3480630.0,508.2475006,510.05454381818186,-2.8999939999999356,48.484178391288076,-3.3593848812583786,19.760970765786908,8.644623926959008,-1789029.865885667,-102500.14852598995,88.0,0.0,64.0,7.799987999999985,503.299998,507.09999600000003,510.29999799999996,514.099996,500.09999600000003,496.299998,493.09999600000003,0.6285705714285784,427445044.0,-1
2017-03-10,507.5,513.825012,506.700012,505.77499400000005,461.331787,4550324.0,509.31749880000007,509.60499716363637,10.699982000000034,51.417471228334605,-2.9118641204958076,18.10381986687588,21.360643892261784,15060785.763786903,586740.1202155057,84.0,0.0,64.0,16.950012000000015,508.7666726666667,510.83333333333337,515.8916726666666,517.9583333333334,503.70833333333337,501.6416726666667,496.58333333333337,-0.12982708771929347,431995368.0,+1
2017-03-14,511.39999400000005,520.950012,511.39999400000005,510.924988,467.17834500000004,7878396.0,509.96749880000004,509.8972679272727,6.5,58.844223661899775,-2.375879539019904,15.908909834151359,37.07509174533185,-3241353.096821807,412735.88307744585,80.0,0.0,96.0,8.124970000000019,514.4249980000001,517.450002,523.9750160000001,527.0000200000001,507.89998400000013,504.8749800000001,498.34996600000017,-0.04973875441910854,439873764.0,+1
2017-03-15,517.450012,517.450012,503.75,517.400024,456.862305,6373978.0,511.0875000000001,511.24863614545455,11.200012000000015,66.31462012576215,-0.8413290434981631,16.08868757989984,28.356488611212313,1092124.862022611,443617.20030222606,96.0,4.0,92.0,8.249970000000019,512.8666786666666,521.9833573333333,526.5666906666665,535.6833693333333,508.2833453333333,499.16666666666663,494.58333333333326,0.9963512440719041,446247742.0,+1
2017-03-16,506.64999400000005,515.849976,506.64999400000005,505.97500599999995,464.492065,6702956.0,511.06499940000003,510.3190917818182,-0.22500600000006443,48.42066888780784,-3.549000017566077,14.768904039117729,12.435937184791394,-3897794.5714996695,246280.3015839579,92.0,0.0,92.0,14.725006000000064,509.49165866666664,512.3333233333333,518.6916406666664,521.5333053333331,503.1333413333333,500.2916766666667,493.9333593333334,-0.07336840441645477,439544786.0,-1
2017-03-17,517.700012,521.450012,509.625,514.424988,469.66137699999996,9507846.0,511.24999700000006,510.9299988,1.8499759999999696,58.074903197511865,-1.6629243225113295,13.362974406048863,35.279506531102456,2756532.2981252284,360382.6650631067,88.0,0.0,88.0,10.39999400000005,515.1666666666666,520.7083333333333,526.9916786666668,532.5333453333333,508.88332133333324,503.3416546666666,497.0583093333332,0.40591823500897745,449052632.0,+1
2017-03-20,513.275024,513.275024,507.549988,520.150024,461.17379800000003,4427388.0,512.1,512.5481855272727,8.500029999999981,63.42645282831448,-0.30772587597890394,12.310330892193974,25.863704007127268,-1572369.4310972732,272530.29705581657,96.0,0.0,84.0,9.925017999999966,513.6583453333334,519.7667026666668,519.3833813333333,525.4917386666668,514.0416666666667,507.93330933333334,508.3166306666667,2.200865811149475,453480020.0,+1
2017-03-21,510.450012,517.474976,509.39999400000005,510.75,466.297943,4869584.0,511.61500240000004,512.3027309818182,-4.84997599999997,51.07512683273513,-2.53284689219041,9.937714269883998,19.746029740337548,-6083171.741302853,-16365.250142305043,92.0,0.0,80.0,15.175017999999966,512.5416566666667,515.6833193333332,520.6166386666666,523.7583013333332,507.60833733333334,504.46667466666673,499.5333553333334,0.16718377824247335,448610436.0,-1
2017-03-22,511.22500599999995,519.974976,510.200012,516.424988,463.97287,3990852.0,511.56250000000006,513.1772738181818,-0.5250240000000304,56.91914273688383,-1.1894955278164439,8.039600685222183,37.48088154615993,1315972.508757341,44195.557080406186,88.0,0.0,92.0,13.700012000000015,515.5333253333333,520.8666386666666,525.3082893333333,530.6416026666666,511.0916746666667,505.75836133333337,501.3167106666667,0.6368285346114828,452601288.0,+1
2017-03-23,514.125,521.5,513.299988,513.849976,469.72906500000005,4501662.0,511.95749820000003,513.5931785454545,3.9499819999999204,53.569042649341064,-1.8106565680473443,6.148949220206305,42.818051293501526,5864900.506417032,308773.0547775258,84.0,4.0,92.0,10.750029999999981,516.2166546666666,519.1333213333332,524.4166666666667,527.3333333333333,510.9333093333332,508.0166426666666,502.7332973333332,0.0670716091634968,448099626.0,-1
2017-03-24,519.0,522.0,513.849976,520.224976,465.643341,4883896.0,513.5899964,515.0963563272727,16.32498199999992,60.25193231453781,-0.4196274231678559,4.6363625089039715,61.673359747797655,9103600.16160558,708537.9232697103,96.0,0.0,88.0,15.475006000000064,518.6916506666666,523.5333253333333,526.8416746666667,531.6833493333334,515.3833013333333,510.5416266666666,507.23327733333326,0.7822062855274998,452983522.0,+1
2017-03-27,513.599976,520.924988,512.25,515.700012,464.492065,7684824.0,514.5824982,515.4799955272726,9.925017999999966,53.89839831701515,-1.4893588652482235,4.042743434781983,39.60384032242994,974503.0023253312,720627.2450449658,96.0,16.0,96.0,6.875,516.2916666666666,520.3333333333333,524.9666546666667,529.0083213333332,511.6583453333333,507.61667866666664,502.9833573333333,0.3976964579086474,445298698.0,-1
2017-03-28,515.75,519.5,515.025024,514.424988,467.33633399999997,4796796.0,514.9324982,515.4513573090908,3.5,52.11178142315109,-1.790782978723408,4.088442059100544,41.34052151424367,10891954.796726514,1182960.3155759457,92.0,12.0,92.0,10.750029999999981,516.3166706666667,517.6083173333334,520.7916466666666,522.0832933333334,513.1333413333334,511.84169466666674,508.65836533333345,-0.13408697610893322,440501902.0,-1
2017-03-29,517.150024,520.75,512.924988,517.575012,465.846466,6981186.0,514.949997,515.9318143636365,0.17498799999998482,56.246202786945744,-1.0460964539007056,4.973361085528836,50.27059116211388,-2299708.7791462834,1024657.1749067534,88.0,8.0,88.0,9.774963999999954,517.0833333333334,521.2416786666668,524.9083453333335,529.0666906666668,513.4166666666667,509.25832133333336,505.5916546666667,0.5942513570586245,447483088.0,+1
2017-03-30,517.0,517.950012,510.125,515.924988,462.979645,12157180.0,515.9449952000001,516.1090854545455,9.949982000000034,53.45678726129548,-1.4361730496453937,4.8035712901407805,19.883251424414496,5644128.210792064,1234633.1310833585,84.0,4.0,80.0,8.200012000000015,514.6666666666666,519.2083333333333,522.4916786666668,527.0333453333333,511.38332133333324,506.8416546666666,503.5583093333332,0.7412113872796583,435325908.0,-1
2017-03-31,511.625,514.650024,504.0,512.75,461.512421,14153854.0,515.7774964,515.5281772363637,-1.6749879999999848,48.154572978124285,-2.186761229314421,3.96790981937761,-29.99045548580153,5683222.223417985,1436841.7261894783,80.0,0.0,96.0,8.15002400000003,510.4666746666667,516.9333493333334,521.1166986666667,527.5833733333334,506.2833253333333,499.81665066666665,495.6333013333333,0.8215943926511315,421172054.0,-1
2017-04-03,516.075012,516.224976,503.049988,511.125,455.440155,4315600.0,514.874994,514.6822688,-9.02502400000003,45.48998885772132,-2.5709219858156027,4.774014774765249,-36.09433927452367,-11586665.760872556,844864.1131412034,76.0,0.0,80.0,8.674987999999985,510.1333213333333,517.2166546666666,523.3083093333332,530.3916426666666,504.04166666666663,496.9583333333333,490.86667866666664,0.612904694865758,416856454.0,-1
2017-04-05,502.5,502.700012,495.5,504.39999400000005,449.638794,7398338.0,514.2399934,512.7777233454545,-6.350005999999951,35.98241989568628,-4.160757919621737,3.545441094403884,-161.3867673571592,-1193657.9855178378,752204.0177476106,72.0,32.0,80.0,4.47497599999997,500.8666686666667,506.23333733333345,508.0666806666668,513.4333493333335,499.03332533333344,493.6666566666667,491.8333133333334,1.2361082175974194,409458116.0,-1
2017-04-06,499.075012,502.89999400000005,496.0,497.97500599999995,451.28662099999997,5379008.0,512.3949952,509.8204529090908,-18.449982000000034,29.244505520244104,-5.679667612293156,1.8497033871014992,-168.07334566515814,10291769.918436298,1185820.6495970967,68.0,96.0,80.0,7.825012000000015,498.9583333333333,501.91666666666663,505.85832733333336,508.8166606666667,495.0166726666666,492.05833933333327,488.11667866666653,0.2862330025214423,404079108.0,-1
2017-04-07,500.450012,500.450012,489.5,499.799988,443.137695,6404508.0,510.9899964,507.5304516,-14.049987999999985,33.33581085984076,-5.248229787234046,1.5068322850192999,-169.2488165002006,6039231.291720912,1406430.2242390886,64.0,92.0,80.0,7.825012000000015,496.5833333333333,503.66666666666663,507.5333453333333,514.6166786666666,492.7166546666666,485.6333213333333,481.7666426666666,0.9406371426807542,410483616.0,+1
2017-04-10,492.450012,494.75,475.049988,490.77499400000005,430.428864,9528472.0,508.04499820000007,503.85499661818176,-29.44998199999992,25.065607333677036,-7.381798108747033,0.08937548922312999,-250.81727966510292,-1029291.951389041,1295715.5798923553,60.0,96.0,80.0,11.924987999999985,486.85832733333336,498.66666666666674,506.5583393333334,518.3666786666668,478.9666546666667,467.15831533333335,459.2666426666667,0.7982231685950268,400955144.0,-1
2017-04-11,478.02499400000005,485.85000599999995,478.02499400000005,476.700012,436.636566,8655466.0,504.1449982000001,498.1559082181818,-39.0,17.329283829155486,-10.709217021276592,-1.0614409276463448,-253.63634467935452,1538345.1839269607,1306744.1982575648,56.00000000000001,96.0,76.0,13.174987999999985,480.19167066666665,482.35834733333326,488.01668266666655,490.18335933333316,474.53333533333335,472.36665866666675,466.70832333333345,-0.16932651349289315,392299678.0,-1
2017-04-12,485.0,488.450012,480.174988,483.575012,437.404022,6696752.0,501.0600006,494.4159107272727,-30.84997599999997,29.579127654955002,-9.08392151300236,-3.161738223986106,-166.27997243864652,-4018604.876904452,1064682.8766592913,52.0,92.0,40.0,15.625,484.06667066666665,487.9583533333333,492.3416946666666,496.23337733333335,479.6833293333333,475.7916466666666,471.40830533333326,0.41087784156275775,398996430.0,+1
2017-04-13,485.0,495.0,463.325012,484.424988,420.49661299999997,30973188.0,497.74499820000005,491.39136298181813,-33.15002400000003,31.036859856775948,-8.88298156028369,-4.578070175689277,-156.60550317982222,-339464.14575458004,1000858.0120041153,48.0,88.0,-28.0,8.39999400000005,480.9166666666667,498.50832133333336,512.5916546666667,530.1833093333333,466.83333333333337,449.2416786666667,435.1583453333334,0.6661399840151472,429969618.0,+1
2017-04-17,465.0,466.049988,461.75,465.700012,417.562103,7213434.0,492.7225006000001,485.5650018545454,-50.22497599999997,20.336230586529155,-13.309689834515362,-6.394774416210737,-218.3773145858662,2115126.6296763164,1051506.58553467,44.0,96.0,-28.0,10.950012000000015,464.5,467.25,468.799988,471.549988,462.950012,460.200012,458.65002400000003,0.9186100054232778,422756184.0,-1
2017-04-18,462.375,467.0,459.549988,462.450012,416.54629500000004,4647518.0,487.6925018,480.06091301818185,-50.299987999999985,19.022774944010735,-13.859092886909075,-9.444007072031582,-178.69559037226782,-171223.43695086802,995927.9481489636,40.0,96.0,-36.0,24.75,463.0,466.450012,470.450012,473.90002400000003,459.0,455.549988,451.549988,0.38926433943999345,418108666.0,-1
2017-04-19,461.5,465.0,456.325012,461.325012,414.988678,10071702.0,482.7125030000001,475.2668239636364,-49.799987999999985,18.544393145694244,-14.090097925311198,-13.0170032984214,-150.8495356132892,4640784.951598792,1161603.2664875924,36.0,96.0,-39.99999999999999,12.75,460.88334133333336,465.4416706666667,469.5583293333334,474.1166586666667,456.7666826666667,452.2083533333334,448.09169466666674,0.5763696733643907,408036964.0,-1
2017-04-20,460.75,464.85000599999995,459.27499400000005,459.60000599999995,418.64556899999997,4549000.0,478.23250420000005,471.0645517818182,-44.7999880000001,17.75445320487681,-14.499109425014831,-16.44680402120821,-121.56407145312643,-9896456.307692308,658964.1949339601,32.0,96.0,-40.0,11.75,461.2416686666666,463.2083433333332,466.8166806666665,468.7833553333331,457.6333313333333,455.6666566666667,452.0583193333334,0.05829799110744645,403487964.0,-1
2017-04-21,467.39999400000005,467.39999400000005,460.549988,463.64999400000005,417.020294,3577466.0,474.800003,468.41318629090904,-34.3250119999999,26.263396147678478,-12.960977788443163,-19.596412403115835,-92.6511879028375,3196831.4874651195,774321.7991399219,28.000000000000004,92.0,-40.0,31.674987999999985,463.86665866666675,467.1833293333335,470.7166646666668,474.0333353333336,460.33332333333345,457.0166526666667,453.4833173333334,0.452555224039225,407065430.0,+1
2017-04-24,458.75,464.25,456.5,461.85000599999995,418.30697599999996,5556666.0,471.00500480000005,466.0586413818182,-37.949982000000034,24.940192178429072,-13.032529960526626,-21.790788571813778,-85.39436370854276,-1029374.039205548,692335.6246696733,24.0,88.0,-52.0,22.674987999999985,460.8666686666666,465.2333373333332,468.61666866666656,472.9833373333332,457.4833373333332,453.1166686666666,449.7333373333332,0.6903233548387033,401508764.0,-1
2017-04-25,462.950012,466.5,460.27499400000005,463.27499400000005,419.571075,4737060.0,468.2550048000001,464.6531848727272,-27.5,28.242610212248408,-12.690990483752804,-24.055894796373536,-64.74735208241445,-2508949.5796309677,546822.6608378259,20.0,84.0,-56.0,7.450012000000015,463.3499960000001,466.42499800000013,469.5750020000001,472.6500040000001,460.1999920000002,457.12499000000014,453.97498600000023,0.4819272463351881,406245824.0,+1
2017-04-26,464.97500599999995,467.77499400000005,455.10000599999995,464.674988,412.753937,9084496.0,467.0525024,464.0022727272727,-12.02502400000003,31.65152617186807,-9.463977857845688,-26.289942853480284,-56.3338573459556,24521.874787787874,523081.71601736953,16.0,80.0,-60.0,8.674987999999985,462.51666266666666,469.9333193333334,475.1916506666668,482.60830733333347,457.2583313333333,449.84167466666656,444.5833433333332,0.7554233581917363,415330320.0,+1
2017-04-27,458.0,464.5,458.0,457.125,417.720062,7797208.0,464.40750120000007,462.1972722909091,-26.450012000000015,24.42984427785329,-11.33324948749567,-27.36805096788089,-54.2770541846483,4586108.001575134,707764.728997268,12.0,96.0,-64.0,5.5750119999999015,459.875,461.75,466.375,468.25,455.25,453.375,448.75,-0.1346153846153846,407533112.0,-1
2017-04-28,463.424988,463.700012,457.799988,462.625,414.875824,5029702.0,462.2275024,461.8731811636364,-21.799987999999985,36.59062614257036,-9.42209761348818,-27.10667911798174,-42.71920675982441,-4991515.00380689,448706.5593243516,8.0,92.0,-64.0,7.7999880000000985,461.375,464.950012,467.27502400000003,470.85003600000005,459.049988,455.47497599999997,453.14996399999995,0.8177953174427749,412562814.0,+1
2017-05-02,462.0,463.200012,457.549988,459.47500599999995,416.523651,3231126.0,461.6050018,461.3727272727272,-6.225006000000064,33.07351217420427,-8.970958080808094,-27.618640097153445,-38.96869043409963,-1749284.6531256728,348797.8678493504,4.0,88.0,-64.0,7.75,460.075002,462.600016,465.72502600000007,468.25004,456.94999199999995,454.42497799999995,451.2999679999999,0.34070970318001403,409331688.0,-1
2017-05-03,463.25,469.549988,458.825012,461.299988,421.80584699999997,4659448.0,461.4899994,461.3172702181819,-1.1500240000000304,37.11429316474518,-8.510104040404045,-28.533308989852003,-26.38098742146852,1610161.6098931353,406132.5833967952,0.0,84.0,-64.0,6.225005999999951,463.224996,467.62497999999994,473.9499719999999,478.3499559999999,456.90000399999997,452.50002,446.175028,0.23076750940980909,413991136.0,+1
2017-05-04,468.5,469.825012,464.450012,467.14999400000005,423.318268,5279806.0,462.0724976,462.3463601454546,5.824982000000034,48.59391195424251,-7.032829797979785,-26.40858021146022,-12.319789860074266,-26233.921814560097,386479.5604326427,0.0,80.0,-64.0,12.674988000000099,467.1416726666667,469.83333333333337,472.51667266666664,475.20833333333337,464.45833333333337,461.7666726666667,459.08333333333337,0.5023222325581459,419270942.0,+1
2017-05-05,468.0,468.674988,460.0,468.825012,420.541779,4432788.0,462.99499820000005,463.5740900363636,9.225006000000064,51.51785189177294,-6.60984545454545,-23.98802882200414,-11.786453927389962,-22073251.318128742,-634417.2976837847,4.0,76.0,-84.0,6.674987999999985,465.8333333333333,471.66666666666663,474.50832133333324,480.3416546666666,462.99167866666664,457.15834533333333,454.31669066666666,1.0172938567753673,423703730.0,+1
2017-05-08,469.0,474.27499400000005,466.0,465.75,426.862305,4707098.0,463.20499880000006,464.0749994545455,2.1000059999999507,45.978215651878,-2.271665881366998,-21.453315396365838,-0.21759465543148693,8057283.983133359,-239339.96673755063,0.0,72.0,-84.0,6.575012000000015,468.674998,471.34999600000003,476.94999200000007,479.6249900000001,463.075002,460.40000399999997,454.80000799999993,-0.030211502268158566,418996632.0,-1
2017-05-09,475.299988,475.97500599999995,471.049988,472.75,427.38147000000004,5649372.0,464.2949982000001,465.81045421818186,10.89999400000005,57.875704021990465,-0.8554959741813629,-18.17220466077646,18.147716523955314,-1857652.8422912143,-312899.6428990809,0.0,68.0,-84.0,5.65002400000003,473.2583313333333,475.46667466666656,478.18334933333324,480.39169266666653,470.5416566666666,468.3333133333333,465.61663866666663,0.34517883995551424,424646004.0,+1
2017-05-10,473.575012,475.0,468.575012,473.325012,426.02706900000004,3364302.0,465.30000000000007,467.4522749090909,10.050017999999966,58.737041806201134,-0.7029627847528798,-15.37748283116889,19.571026359780262,1537629.536399532,-228784.68020368932,4.0,64.0,-84.0,10.72497599999997,472.300008,476.02500399999997,478.7249959999999,482.44999199999995,469.600016,465.87502,463.175028,0.7393009916905698,428010306.0,+1
2017-05-11,473.424988,474.924988,468.77499400000005,471.825012,426.230225,3229482.0,466.0150024,468.6386407272728,7.15002400000003,55.33157882734516,-1.1008671487360984,-12.425844927541732,22.14748436162513,-2893560.6987902317,-349910.8628667141,0.0,60.0,-80.0,8.52502400000003,471.8416646666667,474.90833533333335,477.99165866666664,481.0583293333333,468.7583413333334,465.69167066666677,462.6083473333335,0.49593837002117364,424780824.0,-1
2017-05-12,476.5,483.0,475.72500599999995,472.049988,435.327301,10979996.0,467.50750120000004,469.7359108363637,14.924987999999985,55.77531181031445,-2.8515656250000037,-9.618275712385241,50.954296518241584,3712673.1065670685,-165247.95516517837,4.0,56.00000000000001,-72.0,8.674987999999985,476.92499799999996,478.12498999999997,484.199992,485.399984,470.8499959999999,469.6500039999999,463.57500199999987,-0.5051575300268207,435760820.0,+1
2017-05-15,481.75,481.75,474.549988,482.125,429.593628,7297164.0,469.4575012,472.3936378909091,19.5,70.77615685824199,-0.22786458333333334,-7.031625557253562,69.7322755965035,-4014283.28977581,-340204.10673838906,0.0,52.0,-72.0,8.27499400000005,479.474996,484.40000399999997,486.67500799999993,491.600016,477.19999199999995,472.27498399999996,469.99997999999994,1.0520832465279224,443057984.0,+1
2017-05-16,476.549988,480.075012,473.47500599999995,475.77499400000005,431.15121500000004,6130168.0,471.08750000000003,473.54227294545456,16.2999880000001,56.77187989918932,-1.881511979166654,-3.779340646991045,55.88923802184716,563732.402291291,-299116.08360067627,0.0,48.0,-68.0,10.22500599999995,476.44167066666665,479.40833533333335,483.04167666666666,486.0083413333334,472.8083293333333,469.8416646666666,466.2083233333332,0.348482713500575,436927816.0,-1
2017-05-17,475.799988,479.22500599999995,471.924988,477.5,430.15799000000004,2915508.0,472.7075012000001,474.70818203636367,16.200012000000015,59.29635667371528,-1.4322916666666665,-0.9283803449836796,55.732148961701064,-177241.4305788918,-293576.3266451406,12.0,44.0,-60.0,6.424987999999985,476.21666466666665,480.5083413333333,483.5166826666666,487.80835933333327,473.20832333333334,468.9166466666667,465.9083053333334,0.7636983908806857,439843324.0,+1
2017-05-18,471.5,486.950012,471.424988,476.39999400000005,434.19866900000005,8057848.0,473.6325012000001,475.37954436363634,9.25,56.85341047384284,-2.719427161662252,1.957314847171574,69.23027589295775,-15494683.745015938,-984535.7547529046,8.0,40.0,-60.0,6.149993999999936,478.2583313333334,485.0916746666668,493.7833553333335,500.6166986666668,469.56665066666676,462.73330733333336,454.04162666666673,0.32045077675886713,431785476.0,-1
2017-05-19,480.75,481.35000599999995,473.924988,480.875,432.483063,4257396.0,474.8375000000001,476.6963623272727,12.049987999999985,63.845334697726,-1.5659264884879072,4.01928916274295,72.8193521582844,-3599586.0623676935,-1103401.6778263042,4.0,36.0,-52.00000000000001,11.174987999999985,478.71666466666665,483.5083413333333,486.1416826666666,490.93335933333327,476.08332333333334,471.2916466666667,468.6583053333334,0.936026283033933,436042872.0,+1
2017-05-22,479.200012,483.450012,478.27499400000005,478.97500599999995,434.063171,5503052.0,476.16000060000005,477.44863614545454,13.22500599999995,59.149549771432916,-2.0556787610049265,5.811175373744788,83.55315840326574,5707630.761904762,-793809.2942021646,0.0,32.0,-52.0,9.700012000000015,480.23333733333334,482.1916806666666,485.4083553333333,487.3666986666666,477.01666266666666,475.0583193333334,471.8416446666667,0.13526754882783135,430539820.0,-1
2017-05-23,482.325012,483.5,477.049988,480.72500599999995,432.189575,4039982.0,476.9575012000001,478.2786371272727,7.975005999999951,62.11113573205529,-1.6045897170896501,7.593127114776564,81.48127128362319,-1453683.56827005,-823803.5793870685,88.0,28.000000000000004,-48.0,8.64999400000005,480.42499799999996,483.80000799999993,486.87501,490.25001999999995,477.3499959999999,473.97498599999994,470.8999839999999,0.5697691725224631,434579802.0,+1
2017-05-24,480.0,482.75,474.799988,478.64999400000005,431.06091299999997,5636286.0,477.48999940000004,478.5863630909091,5.324982000000034,56.5063945370778,-2.1394555337711822,8.708130768642548,61.370082536161874,9964382.153016621,-333431.5006414459,84.0,24.0,-32.0,7.300017999999966,478.73332733333336,482.66666666666674,486.6833393333334,490.61667866666676,474.7166546666667,470.78331533333335,466.7666426666667,0.48427675329295816,428943516.0,-1
2017-05-25,480.5,493.299988,480.5,477.39999400000005,443.927734,10438514.0,478.0474976,478.56999847272726,5.574982000000034,53.17135398186491,-4.032461192973695,8.70702172785326,93.1988949416711,4128187.887326175,-130630.61937019025,80.0,20.0,-32.0,15.52502400000003,483.73332733333336,486.9666546666667,496.53331533333335,499.7666426666667,474.16666666666674,470.9333393333334,461.36667866666676,-0.24218819580143,418505002.0,-1
2017-05-26,493.5,500.0,490.299988,491.64999400000005,449.52594000000005,4988004.0,480.00749820000004,481.04317963636373,19.600006000000064,73.63768051895919,-2.0822957605984915,8.949190130116335,155.63917614984607,1097038.8383275564,-74827.46220211081,96.0,16.0,-32.0,7.425017999999966,493.98332733333336,497.66666666666674,503.6833393333334,507.36667866666676,487.9666546666667,484.28331533333335,478.2666426666667,0.1391757041125374,423493006.0,+1
2017-05-29,495.450012,498.35000599999995,487.85000599999995,497.85000599999995,444.76297,6308434.0,481.5799988,484.2872719636364,15.72500599999995,78.38106354761678,-0.5361581047381668,9.531679401266445,126.90892852649411,3599179.1817375626,92172.8397951472,96.0,12.0,-32.0,5.175017999999966,494.6833393333333,501.5166726666667,505.1833393333333,512.0166726666666,491.0166726666667,484.1833393333333,480.5166726666667,0.9523809523809523,429801440.0,+1
2017-05-30,491.0,500.0,489.325012,492.575012,449.751678,3716910.0,483.2600006,486.28636527272727,16.800017999999966,66.6144757989496,-1.8516179551122156,10.323341350114902,100.96415718967502,-10437195.54550466,-386434.8140821171,92.0,8.0,60.0,6.450012000000015,493.9666746666667,498.60833733333334,504.64166266666666,509.2833253333333,487.93334933333335,483.2916866666667,477.25836133333337,0.30444999095080993,426084530.0,-1
2017-05-31,496.77499400000005,496.77499400000005,487.424988,498.10000599999995,441.10604900000004,7763900.0,485.3200012,488.9845480727273,20.60000599999995,71.74130885745731,-0.4738139650872941,9.824602292413601,86.01680626245134,7036083.716871924,-49047.608129660424,88.0,4.0,60.0,7.950012000000015,494.099996,500.77500399999997,503.45000200000004,510.12501000000003,491.4249979999999,484.7499899999999,482.07499199999984,1.1417124224305195,433848430.0,+1
2017-06-01,484.64999400000005,489.85000599999995,479.27499400000005,488.52499400000005,452.208801,5508606.0,486.5325012,489.56727403636364,12.125,54.88685317614186,-2.8615975062344017,10.094929926411226,31.176826564114307,4813934.732844531,171997.043732803,84.0,0.0,60.0,14.649993999999936,485.8833313333334,492.4916686666667,496.4583433333333,503.0666806666666,481.9166566666668,475.3083193333335,471.3416446666669,0.8747034991544299,428339824.0,-1
2017-06-02,486.700012,487.72500599999995,482.10000599999995,485.700012,451.301025,3917966.0,487.01500240000007,489.4159123636364,4.825012000000015,50.82220288693985,-3.5660817955112183,10.209169560416797,22.695719108872513,20565683.90711047,1098982.8102499705,80.0,8.0,80.0,22.60000599999995,485.175008,488.25001000000003,490.800008,493.87501000000003,482.62501000000003,479.550008,477.00001000000003,0.6400010666666781,424421858.0,-1
2017-06-05,485.0,486.0,478.52499400000005,484.72500599999995,446.31991600000003,5462698.0,487.5900024,488.99954938181816,5.75,49.36632430836425,-3.8092254364089895,10.033971608132106,7.247798146577374,-2772620.919760259,923000.8225222325,76.0,4.0,84.0,10.5,483.0833333333333,487.6416726666666,490.5583393333332,495.11667866666653,480.16666666666663,475.60832733333336,472.6916606666667,0.8294323777131339,418959160.0,-1
2017-06-06,482.5,493.75,482.200012,479.375,455.90966799999995,7008686.0,487.4550018,487.50591258181817,-1.3500059999999507,41.78733591155873,-5.143391521197008,9.480088864439722,16.741642662191033,5720846.465986251,1141084.7154069608,72.0,0.0,84.0,10.674987999999985,485.10833733333334,488.01666266666666,496.6583253333333,499.56665066666665,476.4666746666667,473.55834933333335,464.9166866666667,-0.24459003766930484,411950474.0,-1
2017-06-07,492.5,494.450012,472.5,489.674988,447.506989,12455046.0,488.5575012,487.9095464363636,11.024993999999936,56.59154309362969,-2.5748159600997544,9.260795722788998,15.976441543418696,1737832.5102253857,1168209.6151714346,68.0,0.0,84.0,9.350006000000064,485.5416666666667,498.58333333333337,507.49167866666676,520.5333453333334,476.63332133333336,463.59165466666667,454.68330933333334,0.7824591622091128,424405520.0,+1
2017-06-08,481.47500599999995,481.47500599999995,474.075012,480.64999400000005,445.249207,6195352.0,488.8825012,486.4718178545455,3.25,45.0170321721884,-4.825437905236896,8.72500726701304,-33.1453794250118,-105450.5130252404,1110315.9729806767,64.0,4.0,84.0,18.8250119999999,478.73333733333334,483.39166266666666,486.1333313333332,490.7916566666666,475.9916686666667,471.3333433333334,468.5916746666668,0.8885118014960676,418210168.0,-1
2017-06-09,469.27499400000005,475.47500599999995,461.5,478.22500599999995,441.594849,14757662.0,487.54000240000005,484.5340914545455,-13.424988000000099,42.33269183911677,-5.430173067331683,8.801065183364244,-83.40992010971154,8801692.211642185,1459923.9838289274,60.0,0.0,72.0,6.4249880000000985,471.7333373333333,481.96667466666656,485.70834333333323,495.9416806666665,467.9916686666666,457.75833133333333,454.01666266666666,1.196779879736725,403452506.0,-1
2017-06-12,471.674988,482.60000599999995,470.049988,474.299988,448.694092,8591676.0,485.18500059999997,482.12681610909084,-23.550017999999966,38.090789577055034,-6.408980548628433,9.106081707057342,-53.113403273175784,6855860.0,1705193.8027457946,56.00000000000001,96.0,72.0,7.475005999999951,475.64999399999994,481.2499999999999,488.2000119999999,493.80001799999985,468.6999819999999,463.09997599999997,456.14996399999995,0.3386449326208147,394860830.0,-1
2017-06-13,476.75,481.47500599999995,475.799988,481.924988,445.87768600000004,4937794.0,484.1199982,481.53408654545456,-10.65002400000003,49.44581237481299,-4.507484289276812,7.430110885346437,-25.31132426256056,-8573417.698110852,1237984.189070492,52.0,92.0,72.0,11.549987999999985,479.7333273333333,483.66666666666663,485.4083453333333,489.3416846666666,477.99164866666666,474.05830933333334,472.3166306666667,1.07929173088086,399798624.0,+1
2017-06-14,480.0,480.950012,475.60000599999995,478.89999400000005,446.250092,7438110.0,482.19999700000005,480.5849948727273,-19.2000119999999,45.6159591312244,-5.261846882793005,5.120122961247375,-36.36866995998551,591387.5886472095,1208593.4345057975,48.0,88.0,68.0,21.950012000000015,478.48333733333334,481.3666686666667,483.8333433333334,486.7166746666668,476.01666266666666,473.1333313333333,470.6666566666666,0.6168194951557173,392360514.0,-1
2017-06-15,479.825012,483.97500599999995,474.799988,479.299988,443.22421299999996,5528062.0,481.2774964000001,480.0577205090909,-9.225006000000064,46.2511419231252,-5.162097755610976,3.417515047119423,-31.79060234631878,-4817137.069398131,934696.5934192551,44.0,84.0,60.0,15.59997599999997,479.3583273333333,483.91666666666663,488.5333453333333,493.0916846666666,474.74164866666666,470.18330933333334,465.5666306666667,0.49046225304408303,397888576.0,+1
2017-06-16,474.549988,476.924988,468.0,476.049988,437.70776399999994,10948450.0,480.312494,479.10726443636355,-9.65002400000003,41.68655911453884,-5.972571571072323,0.6066309625409758,-86.70820117616218,-3933670.423271527,713407.1835696739,40.0,80.0,60.0,19.14999400000005,473.6583253333333,479.31665066666665,482.5833133333333,488.24163866666663,470.39166266666666,464.73333733333334,461.4666746666667,0.9019606524961152,386940126.0,-1
2017-06-19,469.97500599999995,470.125,464.0,470.125,432.86630199999996,6855860.0,478.8524934,477.2549928,-14.60000599999995,34.52012638661451,-7.450124688279301,-1.2120641394954532,-145.55036621662364,4199741.649484536,871876.9320203497,36.0,76.0,-39.99999999999999,12.550017999999966,468.0833333333333,472.16666666666663,474.20833333333326,478.29166666666663,466.04166666666663,461.9583333333333,459.91666666666663,1.0,380084266.0,-1
2017-06-20,467.5,473.450012,467.02499400000005,464.924988,439.243988,5184396.0,477.40749220000004,474.7227190909091,-14.450012000000015,29.401622333160176,-8.007040784469236,-2.2778894645957166,-138.41618662827267,49198.38955209696,834482.4528172474,32.0,72.0,-40.0,7.175017999999966,468.4666646666667,469.90833533333335,474.89168266666667,476.3333533333333,463.4833173333334,462.04164666666674,457.0582993333334,-0.3268482671955278,374899870.0,-1
2017-06-21,472.5,474.5,468.02499400000005,471.77499400000005,439.15084800000005,3735864.0,475.6174928000001,473.6986285090909,-17.899993999999936,42.38629465640676,-5.73397833150147,-3.54992955101892,-105.7372005745291,-18746457.059583522,-55560.25229187924,28.000000000000004,68.0,-40.0,6.324982000000034,471.4333293333334,474.84166466666676,477.90833533333335,481.3166706666667,468.3666586666668,464.95832333333345,461.89165266666686,0.5791500424864515,378635734.0,+1
2017-06-22,473.85000599999995,484.35000599999995,467.549988,471.674988,437.661224,9465242.0,474.7199922,472.98180945454544,-8.975006000000064,42.2553760853769,-5.75926749497735,-4.06138353941742,-65.31398736121197,-3092235.4221334257,-193590.94183013146,24.0,64.0,-40.0,9.175017999999966,474.52499399999994,481.4999999999999,491.3250119999999,498.30001799999985,464.6999819999999,457.72497599999997,447.89996399999995,0.24553545121201706,369170492.0,-1
2017-06-23,472.5,474.575012,469.0,470.075012,439.10434000000004,6403018.0,473.90499279999995,472.13726760000003,-8.149993999999936,39.976027455679215,-6.163863765415691,-6.205387666257934,-84.6889850122176,-4614950.158882103,-394561.815332494,20.0,60.0,-40.0,11.299987999999985,471.2166746666667,473.43334933333335,476.7916866666667,479.00836133333337,467.85833733333334,465.64166266666666,462.2833253333333,0.19282684952068485,362767474.0,-1
2017-06-27,472.5,474.0,461.875,471.625,431.56283600000006,6904660.0,473.63749400000006,471.7227234545455,-2.674987999999985,43.389441705546766,-5.7719082835683455,-6.932666575442113,-85.53103015938777,-3913422.1114906133,-554510.0106124086,16.0,56.00000000000001,-40.0,12.049987999999985,469.1666666666667,476.45833333333337,481.29166666666674,488.58333333333337,464.33333333333337,457.0416666666667,452.20833333333337,0.8041237113402062,369672134.0,+1
2017-06-28,466.39999400000005,466.5,460.5,463.52499400000005,430.468872,5905224.0,471.7974946,469.88408709090913,-18.399993999999936,32.31022311758356,-7.820209144411397,-7.719142248681521,-115.1944508976438,6183984.341551214,-248214.81278678915,12.0,52.0,-40.0,6.425017999999966,463.5083313333334,466.5166626666668,469.50833133333344,472.5166626666668,460.5166626666668,457.5083313333334,454.5166626666668,0.5041656666666748,363766910.0,-1
2017-06-29,465.10000599999995,473.97500599999995,463.299988,462.35000599999995,433.029266,15914040.0,470.1424958,468.166361890909,-16.5499880000001,30.985925673032753,-5.7090955384596525,-7.949873459762671,-70.71505332953116,179529.06439604412,-228771.90927847853,8.0,96.0,-40.0,9.575012000000015,466.5416666666666,469.78334533333316,477.21668466666654,480.4583633333331,459.1083273333332,455.8666486666666,448.4333093333332,-0.0889911380008949,347852870.0,-1
2017-06-30,465.39999400000005,469.0,464.5,465.10000599999995,435.519775,4216700.0,468.72249760000005,467.2495455636363,-14.199982000000034,37.863560562452314,-4.995458596152195,-9.375166846613297,-63.448093969776714,7221093.523690069,109858.33767463754,4.0,92.0,-40.0,16.800017999999966,466.200002,467.90000399999997,470.70000200000004,472.40000399999997,463.40000399999997,461.700002,458.90000399999997,0.13333466666665572,352069570.0,+1
2017-07-03,470.549988,477.5,467.299988,467.77499400000005,443.131104,5088924.0,467.89499820000003,467.07727218181816,-8.274993999999936,44.114400972138355,-4.301287593596119,-10.52269617891136,-24.219083314245868,-2144789.9936828166,7374.322612935006,0.0,88.0,-40.0,5.575012000000015,470.85832733333336,474.41666666666674,481.0583393333334,484.61667866666676,464.2166546666667,460.65831533333335,454.0166426666667,0.04656916089903264,357158494.0,+1
2017-07-04,476.924988,485.0,474.700012,475.950012,447.90270999999996,5167726.0,468.47749940000006,468.54182014545455,5.825012000000015,58.748017210311865,-2.344556476683934,-10.729306133659748,37.0442058245118,-11258705.190712541,-504720.20072004164,4.0,84.0,-40.00000000000001,12.125,478.550008,482.40000399999997,488.8499959999999,492.69999199999995,472.100016,468.25002,461.800028,0.12135936469052215,362326220.0,+1
2017-07-05,479.5,479.5,472.700012,481.075012,442.66555800000003,4226228.0,470.09250180000004,470.8322769818182,16.15002400000003,65.31729684578235,-1.016836269430048,-10.00838761959534,33.360533535165466,221481.40809032304,-471711.03668320685,0.0,80.0,-40.0,11.125,477.75834133333336,482.8166706666667,484.5583293333334,489.6166586666667,476.0166826666667,470.9583533333334,469.21669466666674,1.2316198205055684,366552448.0,+1
2017-07-06,472.5,478.5,472.10000599999995,475.450012,440.850037,3829720.0,470.46000360000005,471.8063697454546,3.675017999999966,54.35526409975311,-2.4740901554404107,-8.90707540428241,18.704123389837207,-761538.8071687153,-484885.02625073,0.0,76.0,-88.0,10.675017999999966,475.35000599999995,478.60000599999995,481.74999999999994,485.0,472.2000119999999,468.9500119999999,465.80001799999985,0.5234389282240013,362722728.0,-1
2017-07-11,478.325012,494.75,478.325012,478.52499400000005,454.04757699999993,11539708.0,471.09500420000006,473.30045934545456,6.899994000000049,57.965017043728515,-4.099812002526836,-5.386850230193204,105.54411742479626,-6203840.946487205,-1539074.6752259652,8.0,64.0,-80.0,17.22500599999995,483.8666686666667,489.40832533333344,500.29165666666677,505.8333133333334,472.98333733333345,467.44168066666674,456.55834933333347,0.01217547312667956,367021174.0,+1
2017-07-12,487.47500599999995,490.75,484.375,487.674988,452.65103099999993,6275976.0,473.51000360000006,476.31500185454547,24.149993999999936,66.89586492117326,-1.7877478205938129,-4.222824483209365,141.8142733152718,4052366.3351954636,-1284918.2656613546,96.0,60.0,-80.0,6.799987999999985,487.599996,490.82499199999995,493.9749959999999,497.19999199999995,484.44999199999995,481.224996,478.07499199999995,0.5176451764705858,373297150.0,+1
2017-07-14,499.72500599999995,503.424988,483.02499400000005,488.52499400000005,452.511383,22478180.0,478.23500060000003,480.91454305454545,23.4249880000001,66.64113444896066,-3.6842416868662764,-0.9704509239415984,154.9006143725279,-8072696.551392757,-1242239.1307588802,88.0,52.0,-56.0,8.925017999999966,491.6583253333334,500.2916566666667,512.0583193333332,520.6916506666666,479.8916626666668,471.25833133333344,459.49166866666684,0.2696079224337035,390604938.0,+1
2017-07-18,493.02499400000005,502.39999400000005,490.549988,492.02499400000005,458.819183,8260180.0,481.66749880000003,484.5063588363637,16.074982000000034,68.22511905648791,-2.8188154387730204,3.5339348352695197,146.55051546346576,-2288851.7272126866,-1618487.0013582907,92.0,44.0,-56.0,27.049987999999985,494.99165866666675,499.4333293333335,506.8416646666668,511.2833353333336,487.58332333333345,483.1416526666667,475.7333173333334,0.12447301714446865,391166868.0,+1
2018-01-10,523.400024,528.0,516.525024,520.674988,503.71841399999994,9468634.0,514.9450042,514.3559125818182,2.875,64.41461502291469,-1.7074620046620081,9.622337420834299,71.61970552014986,-26356342.43525806,-4111824.547344768,68.0,0.0,76.0,7.4750360000000455,521.7333373333333,526.9416506666666,533.2083133333333,538.4166266666666,515.4666746666667,510.25836133333337,503.9916986666667,0.36165339256482676,595102702.0,+1
2018-01-11,527.625,541.700012,527.625,526.125,514.992004,16775298.0,515.8450042000001,516.3886390909091,9.0,70.33680231344049,-3.5181864869703268,8.287058918263938,132.71290993974964,2898628.3849779433,-3793167.5958755543,96.0,0.0,76.0,10.049987999999985,531.8166706666667,536.0083413333334,545.8916826666668,550.0833533333334,521.9333293333334,517.7416586666667,507.8583173333334,-0.10657184519629528,611878000.0,+1
2018-01-12,542.900024,542.950012,535.275024,537.900024,516.2604980000001,18016528.0,517.9725066000001,520.3986426909091,21.27502400000003,79.03483454623428,-1.1375127522240014,7.437326081393735,157.09135762695573,10819075.525111442,-3128974.7267397814,96.0,0.0,76.0,10.200012000000015,538.7083533333333,542.1416826666666,546.3833413333332,549.8166706666666,534.4666946666666,531.0333653333333,526.7917066666666,0.3420200787284625,629894528.0,+1
2018-01-15,540.0,546.474976,532.549988,539.224976,517.55304,10649250.0,519.7925018,524.2627280363636,18.19995199999994,79.80371835561064,-1.6202023328339148,6.915723560825427,141.70699543130002,-792923.4457153518,-3022790.5776023073,96.0,4.0,76.0,11.799987999999985,539.4166466666667,546.2833053333334,553.3416346666666,560.2082933333334,532.3583173333334,525.4916586666667,518.4333293333334,0.47935323175861927,640543778.0,+1
2018-01-16,540.625,567.400024,540.625,540.575012,537.5150150000001,22646966.0,522.1725006,528.0413662545454,23.799987999999985,80.63853988172774,-5.726945052419556,6.8361725346233015,185.3136149458394,-20071612.96969697,-3797737.0499702473,96.0,0.0,72.0,16.450012000000015,549.5333453333334,558.4416906666668,576.3083693333333,585.2167146666668,531.6666666666667,522.7583213333334,504.8916426666667,-0.001866963779378303,663190744.0,+1
2018-01-17,562.424988,580.900024,561.5,561.424988,551.517212,26154088.0,526.8300018,535.1781821454546,46.575012000000015,88.85092354909644,-4.04130214361642,6.795874090640837,252.42031841443148,-13217057.08560578,-4225887.960680954,96.0,4.0,68.0,11.47497599999997,567.9416706666667,574.3833413333334,587.3416946666666,593.7833653333334,554.9833173333334,548.5416466666667,535.5832933333334,-0.003866593154730894,689344832.0,+1
2018-01-18,572.5,582.450012,566.049988,576.049988,551.804443,13204970.0,533.3700012,544.1272705454545,65.39999399999994,91.70021165044633,-1.3238233201243628,7.946384834295145,227.26375927622374,16623872.096873682,-3278171.5944284694,96.0,0.0,96.0,21.02502400000003,574.849996,583.6500040000001,591.2500200000002,600.0500280000001,567.24998,558.449972,550.849956,0.6097552052362839,702549802.0,+1
2018-01-19,572.5,573.950012,568.0,576.349976,547.376404,5988278.0,540.2349976,551.9418114181818,68.64996399999995,91.75011175448772,-1.2617718168553993,9.768945584686662,172.66803846695103,-3712198.1998806074,-3297900.076494476,96.0,20.0,96.0,16.825012000000015,572.7666626666667,577.5333253333333,578.7166746666667,583.4833373333333,571.5833133333333,566.8166506666666,565.6333013333333,1.4033544806296103,708538080.0,+1
2018-01-22,566.075012,578.474976,566.0,571.724976,550.511902,9650214.0,546.8074952000001,557.6672620363636,65.72497599999997,82.88533336405831,-2.2184374255429837,12.145306119928705,140.3858016816066,8459170.21457627,-2763487.7905367143,92.0,16.0,92.0,13.924987999999985,572.0666506666666,578.1333013333333,584.5416266666666,590.6082773333333,565.6583253333333,559.5916746666667,553.1833493333334,0.45891679470966384,698887866.0,-1
2018-01-23,577.5,594.0,577.5,575.0,563.484863,15403796.0,552.5049928000001,562.7931719999999,56.97497599999997,84.13755730864919,-3.8383838383838382,15.671704750910635,146.9921300019857,12266130.917455597,-2080323.3038097904,88.0,12.0,96.0,28.17504800000006,582.1666666666666,586.8333333333333,598.6666666666665,603.3333333333333,570.3333333333333,565.6666666666666,553.8333333333333,-0.15151515151515152,714291662.0,+1
2018-01-24,587.400024,610.525024,583.75,588.549988,567.649597,20604718.0,559.2924928,569.346807490909,67.875,88.24385775542318,-4.29598454991716,20.550935712710725,151.27552364912918,7948676.571170235,-1624459.6731288799,96.0,8.0,92.0,40.325012000000015,594.275004,604.8000079999999,621.0500280000001,631.575032,578.0249839999999,567.4999799999999,551.2499599999999,0.179271099813019,734896380.0,+1
2018-01-25,591.0,591.700012,581.125,592.900024,562.6710820000001,13548914.0,565.9699952000001,575.4572677090908,66.77502400000003,89.27253603073557,-3.445579233284978,24.203373855877658,108.4787569632247,-1186874.4379681563,-1604569.4351670288,96.0,4.0,96.0,21.02502400000003,588.575012,596.025024,599.150024,606.600036,585.450012,578.0,574.875,1.1134761832894386,748445294.0,+1
2018-01-29,583.275024,598.125,582.599976,587.700012,566.261353,10823002.0,570.9499940000001,579.4081798545454,49.799987999999985,79.65848980460342,-4.462149636691091,27.429645361439157,92.0051640332123,-2179602.668917863,-1630707.3094284304,92.0,0.0,76.0,8.049987999999985,589.474996,596.3500160000001,605.00002,611.8750400000001,580.8249920000001,573.949972,565.299968,0.3285042264668986,737622292.0,-1
2018-01-30,589.450012,591.549988,581.349976,591.450012,560.397217,8628312.0,576.1724976,583.1354558545455,52.225036000000046,81.33140807743332,-3.7290476721623724,30.81498801223529,74.74979087994951,16813395.18805665,-792339.0140881987,88.0,36.0,76.0,12.47497599999997,588.1166586666667,594.8833413333334,598.3166706666666,605.0833533333334,584.6833293333334,577.9166466666667,574.4833173333334,0.9901984429037957,746250604.0,+1
2018-01-31,579.575012,583.299988,571.075012,585.325012,550.631592,9213698.0,580.6474976,584.7995493818182,44.75,70.4171828722123,-4.926447547559279,33.02385339288105,49.514979833780345,-5044528.020582448,-985620.3325652102,84.0,32.0,76.0,22.27502400000003,579.900004,588.7249959999999,592.1249799999998,600.9499719999999,576.50002,567.675028,564.275044,1.1656464601648326,737036906.0,-1
2018-02-01,571.099976,578.950012,559.275024,575.125,547.92688,13005454.0,582.0174988000001,583.7954589090909,13.700012000000015,55.981914495576135,-6.920487237003684,35.675040818779166,27.41876124448044,-13232998.312164275,-1542319.3316378954,80.0,28.000000000000004,88.0,35.52502400000003,571.1166786666666,582.9583333333333,590.7916666666665,602.6333213333332,563.2833453333333,551.4416906666667,543.6083573333333,0.8055901228503917,724031452.0,-1
2018-02-02,567.625,581.450012,565.049988,572.299988,547.280701,10244486.0,581.6424988000001,582.0286387636363,-3.75,52.53997227013799,-7.4727597295416075,38.29682393069493,25.094342624681463,12933474.603083776,-884328.6982414554,76.0,24.0,92.0,10.575012000000015,572.9333293333333,580.8166706666666,589.3333533333332,597.2166946666666,564.4166466666666,556.5333053333333,548.0166226666665,0.4420725237963058,713786966.0,-1
2018-02-05,570.0,577.424988,567.924988,571.625,544.863159,9860220.0,581.1700012000001,580.2072753454545,-4.72497599999997,51.664243602623344,-7.604715737230487,38.23039355931269,18.68130638144009,-27589.8324184099,-845386.022522226,72.0,20.0,92.0,15.52502400000003,572.324992,576.7249959999999,581.8249920000001,586.2249959999999,567.2249959999999,562.824992,557.7249959999999,0.38947494736842264,703926746.0,-1
2018-02-06,549.974976,564.174988,547.575012,569.099976,530.286621,10552078.0,580.9075012000001,578.0127253090909,-2.625,48.196756121188955,-8.098342418532404,36.081264858732084,-7.39258171221406,-585092.0827604048,-833554.4798057795,68.0,16.0,52.0,10.200012000000015,560.2833253333333,572.9916386666666,576.8833013333333,589.5916146666666,556.3916626666667,543.6833493333334,539.7916866666667,1.2966864530406546,693374668.0,-1
2018-02-07,558.0,562.400024,551.775024,553.875,530.908936,8342056.0,578.7950012000001,573.0977250909091,-21.125,32.855235119715275,-11.074731702666423,33.68879773137087,-19.703333868839547,-11127592.882439345,-1301465.3162891238,64.0,12.0,52.0,20.375,556.0166826666667,560.2583413333334,566.6416826666668,570.8833413333334,549.6333413333334,545.3916826666667,539.0083413333334,0.19764479999999715,685032612.0,-1
2018-02-08,561.400024,573.200012,558.275024,554.525024,542.97229,8807244.0,575.3925048000001,568.6850019636363,-34.024963999999954,33.89187081423054,-10.947656003628865,31.570971549367187,-12.985951445778097,-12954684.766048564,-1831157.1094600079,60.0,8.0,52.0,26.049987999999985,562.0000200000001,565.7250160000001,576.9250080000002,580.6500040000001,550.8000280000001,547.0750320000001,535.8750400000001,-0.2512564834222985,693839856.0,+1
2018-02-09,559.0,560.150024,553.0,567.125,530.956787,4382690.0,572.8150024,567.1818192727272,-25.77502400000003,50.8600994520461,-8.48443809466495,29.096270931688537,-22.057955494161526,-82296.92878549009,-1751663.464883893,56.00000000000001,4.0,52.0,16.40002400000003,560.0916746666667,567.1833493333334,567.2416986666667,574.3333733333334,560.0333253333333,552.9416506666666,552.8833013333333,1.9755178444156187,698222546.0,+1
2018-02-12,557.400024,560.299988,548.900024,554.575012,527.917053,6291972.0,569.5025024,563.8654573818181,-33.125,39.2745969241424,-10.937883656694773,23.991446512529365,-40.0335113095331,1610559.31147541,-1598835.156867561,52.0,0.0,52.0,9.5,554.5916746666667,560.2833253333333,565.9916386666666,571.6832893333333,548.8833613333334,543.1917106666667,537.4833973333334,0.4978075369360822,691930574.0,-1
2018-02-14,553.0,558.650024,545.099976,551.400024,525.499573,8345712.0,565.4975036,560.5740976727272,-40.049987999999985,36.82588578146788,-11.558574307402798,17.650422060668802,-52.338138599988405,-20830722.405514598,-2473011.8499878813,48.0,0.0,52.0,24.049987999999985,551.7166746666667,558.3333733333334,565.2667226666667,571.8834213333334,544.7833253333333,538.1666266666666,531.2332773333333,0.46494654483881037,683584862.0,-1
2018-02-15,551.5,564.849976,551.5,548.875,533.493896,7986736.0,561.8525024,557.551824290909,-36.450012000000015,34.832975602222646,-12.052200988704714,11.43187217482864,-47.867125068295266,-7318330.49947471,-2693253.606782737,44.0,0.0,52.0,17.32495199999994,555.074992,558.6499839999999,568.4249679999998,571.9999599999999,545.3000079999999,541.725016,531.950032,-0.19662956697450287,675598126.0,-1
2018-02-16,562.5,570.825012,559.049988,557.224976,540.004333,9889222.0,560.0625,556.7104558545454,-17.90002400000003,45.98633706286862,-8.194344903581273,5.221092505275237,-29.1652553809797,4299921.818181818,-2375381.996557075,40.0,0.0,52.0,19.325012000000015,562.3666586666667,565.6833293333334,574.1416826666666,577.4583533333334,553.9083053333334,550.5916346666667,542.1332813333333,-0.15499008749366544,685487348.0,+1
2018-02-19,564.200012,568.0,560.150024,564.025024,541.775574,6461840.0,559.2350036,557.4309147636363,-8.274963999999954,53.469575133084895,-6.831951114450282,-0.22231660170700707,-25.041932351923993,5378297.099961376,-2022942.037624418,36.0,0.0,52.00000000000001,7.15002400000003,564.0583493333334,567.9666746666667,571.9083253333333,575.8166506666666,560.1166986666667,556.2083733333334,552.2667226666667,0.4936320824420374,691949188.0,+1
2018-02-20,551.875,574.75,551.875,565.875,544.2648320000001,7188594.0,558.6600036,558.6381868363636,-5.75,55.40883826904876,-5.21266645528778,-4.187674048076133,-27.14189759997056,-496224.63351774303,-1953545.7919832054,32.0,4.0,52.0,18.22497599999997,564.1666666666666,576.4583333333333,587.0416666666665,599.3333333333333,553.5833333333333,541.2916666666666,530.7083333333333,0.6120218579234973,699137782.0,+1
2018-02-21,573.75,575.950012,570.0,568.474976,549.267273,13771358.0,558.5975036,560.4227272727273,-0.625,58.231749126474774,-3.061121694679872,-7.183237249977083,7.897319390163601,-11641073.734258723,-2393887.9711775472,28.000000000000004,0.0,48.0,13.55004800000006,571.474996,572.9499920000001,577.4250080000002,578.9000040000001,566.99998,565.524984,561.049968,-0.2563060377021133,712909140.0,+1
2018-02-22,572.775024,582.0,570.224976,573.700012,555.65802,17859974.0,560.5800048000001,563.1686378909092,19.825012000000015,63.57832942393654,-1.718424016563144,-10.048514210940539,36.35666831706372,9493455.083352197,-1853554.1959716496,24.0,0.0,44.0,13.44995199999994,575.3083293333333,580.3916826666666,587.0833533333334,592.1667066666666,568.6166586666666,563.5333053333333,556.8416346666666,0.29511922863172396,730769114.0,+1
2018-02-23,581.75,583.0,573.375,580.375,553.216675,9459828.0,563.1650023999999,566.7677279272727,25.84997599999997,69.3597125348045,-0.5423553719008265,-12.46107318927045,69.53610946070293,2190756.921008318,-1669721.8724725598,20.0,72.0,40.0,21.950012000000015,578.9166666666666,584.4583333333333,588.5416666666665,594.0833333333333,574.8333333333333,569.2916666666666,565.2083333333333,0.7272727272727273,740228942.0,+1
2018-02-26,575.5,577.525024,567.174988,577.825012,545.0546879999999,5083608.0,564.2350036,569.4331842181819,10.700012000000015,64.8240220055918,-1.0692123966942118,-11.557439374517571,42.9118360654272,859244.7276828177,-1554768.8451927695,16.0,68.0,36.0,10.77502400000003,574.175008,581.1750280000001,584.5250440000002,591.5250640000002,570.8249920000001,563.824972,560.474956,1.028984247011313,735145334.0,-1
2018-02-27,572.474976,576.825012,562.825012,569.299988,550.607666,6616026.0,565.7075012,570.3540904727273,14.72497599999997,51.76579056386236,-2.8305809917355407,-9.914276670683307,18.132932170891472,1349516.5201301263,-1422755.8740417287,12.0,64.0,28.0,22.875,569.650004,576.4749959999999,583.6500039999999,590.4749959999999,562.4749959999999,555.650004,548.4749959999999,0.46249828571428353,728529308.0,-1
2018-02-28,573.799988,594.75,571.275024,575.099976,561.330688,17268416.0,568.0774964000001,572.0618131636364,23.69995199999994,58.35182183488362,-3.963696217851746,-9.766689502488816,102.15448661951977,-9647279.420234047,-1796597.8534141069,8.0,60.0,28.000000000000004,10.075012000000015,580.375,589.474976,603.849976,612.9499519999999,566.0,556.900024,542.525024,0.16293741897755057,745797724.0,+1
2018-03-01,584.799988,584.799988,578.025024,586.299988,555.65802,6579852.0,571.8199952,575.3749934545453,37.424987999999985,68.0669463989074,-1.704490569843674,-7.818819558938685,117.8740848529834,-3332355.306512432,-1866405.0103731218,4.0,56.00000000000001,24.0,13.52502400000003,583.0416666666666,588.0583093333332,589.8166306666667,594.8332733333332,581.2833453333333,576.2667026666667,574.5083813333333,1.221403390482962,752377576.0,+1
2018-03-05,580.375,585.400024,571.625,580.375,553.336304,8101456.0,574.1349976000001,576.9304488727273,23.15002400000003,59.58310758136531,-2.8996469994957135,-5.1574401812941915,80.04466270478912,-14055337.342599798,-2420447.3891106984,0.0,52.0,-52.0,9.625,579.1333413333333,586.6416826666666,592.9083653333332,600.4167066666666,572.8666586666666,565.3583173333333,559.0916346666666,0.6352076047199613,744276120.0,-1
2018-03-06,581.275024,582.700012,571.799988,577.950012,551.1582030000001,6689734.0,575.5274964,577.6240878545455,13.924987999999985,56.270954156759245,-3.388802420574884,-1.0864538279963654,66.18396006329095,-255281.27560635618,-2322030.747587774,4.0,48.0,-52.0,13.200012000000015,577.4833373333333,583.1666866666667,588.3833613333334,594.0667106666667,572.2666626666667,566.5833133333333,561.3666386666666,0.5642211429993194,737586386.0,-1
2018-03-07,577.5,580.0,569.025024,575.674988,547.6875610000001,6370416.0,576.5074952000001,577.650904509091,9.799987999999985,53.07707435956783,-3.8477079172970274,2.3436144884733494,50.14635773265699,1627690.5524763167,-2142497.961221224,0.0,44.0,-52.0,15.0,574.900004,580.7749839999999,585.87498,591.7499599999999,569.8000079999999,563.925028,558.825032,0.6059205960905949,731215970.0,-1
2018-03-08,574.5,582.900024,574.5,572.049988,553.6953129999999,6093014.0,576.8649964,576.8404486545454,3.575012000000015,48.06170004191805,-4.578923247604642,4.636582040323219,61.144528803886956,446477.3532039064,-2024817.2651109907,80.0,40.0,-52.0,25.450012000000015,576.4833373333333,578.4666746666667,584.8833613333334,586.8666986666667,570.0666506666666,568.0833133333333,561.6666266666666,-0.29166726190306197,725122956.0,-1
2018-03-09,581.174988,583.0,577.775024,578.325012,556.926636,4220964.0,577.3274964,577.1059060363636,4.625,56.30791149831256,-3.3131594553706476,7.224959298128056,82.47036473064169,18227837.164721135,-1104242.0637549844,76.0,36.0,-52.00000000000001,9.700012000000015,579.700012,581.625,584.924988,586.849976,576.400024,574.475036,571.1750480000001,0.10526134474110274,729343920.0,+1
2018-03-12,588.0,595.924988,585.875,581.700012,567.625671,7676970.0,577.4599976000001,577.9009088727273,1.3250120000000152,60.226805391889386,-2.862600260303265,9.323592152906485,137.51409845957906,4106340.3485085526,-867397.4086520962,72.0,32.0,-52.0,14.674987999999985,587.8333333333334,589.7916666666667,597.8833213333332,599.8416546666667,579.7416786666668,577.7833453333334,569.6916906666668,-0.4154221875687803,737020890.0,+1
2018-03-13,590.099976,598.5,587.575012,592.875,566.6922,8581052.0,578.9649964000001,580.7036365818182,15.049987999999985,70.3776365031353,-1.1261261261261262,10.476415442253142,152.34805167561126,-10032667.314280368,-1284000.5861806544,96.0,28.000000000000004,-44.0,10.90002400000003,592.9833373333333,598.3916626666667,603.9083253333333,609.3166506666666,587.4666746666667,582.0583493333334,576.5416866666667,0.485125292586133,745601942.0,+1
2018-03-14,590.0,595.299988,584.549988,591.900024,565.256104,4429710.0,581.225,583.0554597818182,22.600036000000046,68.6147538547425,-1.3213165165165104,10.58418915573634,108.30481012422796,-4974315.9279472,-1451742.1926245885,96.0,24.0,-44.0,10.97497599999997,590.5833333333334,596.6166786666668,601.3333333333333,607.3666786666668,585.8666786666668,579.8333333333334,575.1166786666668,0.6837242790697716,741172232.0,-1
2018-03-15,590.0,594.200012,586.0,590.400024,566.069824,6101500.0,582.7550048000002,584.7236459636364,15.30004800000006,65.69358328089046,-1.6216168168168108,11.000351318946855,83.92487259857846,692085.5277747517,-1354295.478060982,92.0,20.0,40.0,8.40002400000003,590.200012,594.400024,598.400024,602.600036,586.200012,582.0,578.0,0.5365875074329186,735070732.0,-1
2018-03-16,591.0,591.200012,584.625,591.25,560.995605,17954826.0,583.2500060000001,586.2681905454546,4.950012000000015,66.62266595963101,-1.4514514514514516,12.555512396721383,63.09565560989741,2462729.064087639,-1180794.3625087717,88.0,16.0,40.0,10.950012000000015,589.025004,593.4250079999999,595.6000159999999,600.00002,586.8499959999999,582.449992,580.2749839999999,1.0076027237668896,753025558.0,+1
2018-03-19,582.0,590.25,571.325012,585.950012,548.9561769999999,7526620.0,583.8075072,586.7591007272728,5.575012000000015,55.75829428941633,-2.512510110110107,12.35500885576755,19.557784622123688,9476666.993362755,-696364.3008782475,84.0,12.0,40.0,17.59997599999997,582.5083413333333,593.6916706666666,601.4333293333332,612.6166586666666,574.7666826666666,563.5833533333333,555.8416946666666,0.7727878083727193,745498938.0,-1
2018-03-20,574.299988,585.0,574.299988,573.375,557.477112,8553766.0,583.350006,584.8622812363636,-4.575012000000015,38.548613969540305,-5.03003003003003,10.31888582744773,-12.923258116002065,-305531.1117742892,-678599.1559189766,80.0,8.0,68.0,16.799987999999985,577.5583293333333,580.8166706666666,588.2583413333334,591.5166826666666,570.1166586666666,566.8583173333333,559.4166466666666,-0.08644737968518013,736945172.0,-1
2018-03-21,585.0,587.75,581.099976,582.275024,558.889282,7692994.0,584.0100096000001,584.6668299636364,6.6000360000000455,50.919549420411634,-3.2482434434434375,10.021031176662518,17.2586142305457,15890121.714285715,74524.51999941906,76.0,4.0,72.0,10.75,583.7083333333334,586.3166906666668,590.3583573333335,592.9667146666668,579.6666666666667,577.0583093333333,573.0166426666667,0.17669830966024413,744638166.0,+1
2018-03-22,582.25,588.724976,577.650024,583.75,555.921326,6813168.0,585.1800108000001,584.6195554909092,11.700012000000015,52.738899890748506,-2.952952952952953,9.315938935469148,12.678985185140084,-2071755.3805309734,-23033.65729741704,72.0,0.0,72.0,8.200012000000015,583.375,589.099976,594.4499519999999,600.1749279999999,578.025024,572.3000480000001,566.9500720000001,0.5507902878495549,751451334.0,+1
2018-03-23,573.5,586.900024,571.174988,580.650024,558.937134,12008084.0,585.412512,583.7959215272728,2.325012000000015,48.38903220308639,-3.5735687687687623,8.662939457911875,-13.70086530272122,699323.1521530813,9800.743132151089,68.0,0.0,72.0,6.575012000000015,579.575012,587.975036,595.3000480000001,603.7000720000001,572.25,563.849976,556.524964,0.6025446301045045,739443250.0,-1
2018-03-26,583.450012,583.450012,572.0,583.799988,553.025146,8930722.0,585.6225096,583.5027353454545,2.0999759999999696,52.939888271587094,-2.9429453453453482,8.473044837735415,-13.775194175851855,3205565.8133340892,155062.79177769384,64.0,8.0,72.0,19.924987999999985,579.75,587.5,591.200012,598.950012,576.049988,568.299988,564.599976,1.0305655574858759,748373972.0,+1
2018-03-27,580.0,580.650024,575.049988,577.625,552.4267580000001,3802088.0,584.0975096000001,582.0486426909091,-15.25,44.136879128477965,-4.1791791791791795,7.83307291428946,-31.837776261441224,-11190699.724995494,-360653.6862574515,60.0,4.0,72.0,11.65002400000003,577.775004,580.50002,583.3750400000001,586.100056,574.8999839999999,572.1749679999999,569.2999479999999,0.45982061543889974,744571884.0,-1
2018-03-28,575.375,575.375,563.125,577.0,541.7995,12558322.0,582.6075072000001,580.7581864,-14.90002400000003,43.296087096656485,-4.3043043043043046,7.129229849640524,-82.11713238895194,6707932.449316397,-39354.31645863993,56.00000000000001,0.0,72.0,14.375,571.8333333333334,580.5416666666667,584.0833333333335,592.7916666666667,568.2916666666667,559.5833333333334,556.0416666666667,1.1326530612244898,732013562.0,-1
2018-04-02,570.5,574.775024,560.650024,565.900024,544.360596,8072702.0,580.1575072,577.7204621818182,-24.5,31.139965773113403,-6.526521721721716,4.633297790194092,-113.17354610537357,8100867.731081928,330655.77661138616,52.0,16.0,72.0,11.07495199999994,567.1083573333334,573.5666906666668,581.2333573333335,587.6916906666668,559.4416906666668,552.9833573333334,545.3166906666668,0.37168141592920356,723940860.0,-1
2018-04-03,567.349976,571.775024,564.049988,568.575012,545.940247,4077168.0,577.8900084,575.6145539636364,-22.674987999999985,36.1266703290752,-5.990988588588586,2.3011192476692486,-95.5728544429909,-3458278.870370956,158431.474475825,48.0,96.0,68.0,15.725036000000046,568.1333413333333,572.2166946666666,575.8583773333332,579.9417306666667,564.4916586666666,560.4083053333333,556.7666226666665,0.5857608948359598,728018028.0,+1
2018-04-04,572.0,572.275024,560.0,570.224976,538.161316,4813302.0,576.3175047999999,574.2209117090908,-15.725036000000046,39.257364007295955,-5.660665465465472,0.3582220468234709,-99.65587585258834,-12756115.704829829,-428593.39731079614,44.0,92.0,56.0,11.450012000000015,567.5,575.0,579.775024,587.275024,562.724976,555.224976,550.4499519999999,0.8329903061696616,732831330.0,+1
2018-04-05,569.775024,575.650024,564.549988,562.099976,549.339111,7763544.0,575.1900023999999,571.6359064727272,-11.27502400000003,30.705912521860952,-6.6895048967843245,-1.67101892745859,-103.181573592143,-17579791.109947644,-1208193.2933397444,40.0,96.0,56.0,8.75,567.4333293333333,570.3166706666666,578.5333653333334,581.4167066666666,559.2166346666666,556.3332933333332,548.1165986666665,-0.2207210859496316,725067786.0,-1
2018-04-06,571.5,573.0,561.049988,573.775024,539.501709,5937742.0,574.3400024,571.3786376727273,-8.5,49.091957281085705,-4.12459359956558,-3.0167651819947423,-88.25602334879623,-6519984.234701714,-1449638.3361289252,36.0,92.0,56.00000000000001,14.5,569.275004,577.50002,581.2250160000001,589.450032,565.5500079999999,557.324992,553.5999959999999,1.0648554997266972,731005528.0,+1
2018-04-09,562.5,562.900024,553.275024,563.5,531.962097,7202882.0,572.3150024,569.4077281454546,-20.25,38.67209630484047,-5.627795880671376,-3.4935335304641058,-171.4878476584754,65704647.370314024,1602829.1959821202,32.0,88.0,36.0,16.34997599999997,559.8916826666667,566.5083413333334,569.5166826666668,576.1333413333334,556.8833413333334,550.2666826666667,547.2583413333334,1.0623351688311657,723802646.0,-1
2018-04-10,556.0,562.25,552.700012,555.625,532.991272,8926058.0,569.8125,566.3731822545454,-25.02502400000003,32.560457264094254,-7.0483460559796445,-5.113245741891774,-175.99815040580367,20124905.584634177,2444741.759102669,28.000000000000004,96.0,-48.0,7.7250360000000455,556.8583373333333,561.0166626666667,566.4083253333333,570.5666506666666,551.4666746666667,547.3083493333334,541.9166866666667,0.3062818508253612,714876588.0,-1
2018-04-11,559.0,565.75,558.25,556.700012,538.185242,9025574.0,567.1025024,563.9890935272728,-27.09997599999997,34.19843082996181,-6.539377317770281,-6.377416601490154,-116.47335939432298,898273.2753148524,2374447.7371123135,24.0,96.0,-48.0,12.27502400000003,560.2333373333333,562.2166746666667,567.7333373333333,569.7166746666667,554.7166746666667,552.7333373333333,547.2166746666667,-0.20666506666666465,723902162.0,+1
2018-04-12,564.724976,586.375,562.5,562.125,556.54364,17044366.0,565.5525024000001,563.084093090909,-15.5,42.351377188488904,-5.431615152093033,-7.602863730739159,-29.126128637345648,-5615663.517201649,2011260.861916224,20.0,92.0,-56.0,11.100036000000046,570.3333333333334,578.1666666666667,594.2083333333335,602.0416666666667,554.2916666666667,546.4583333333334,530.4166666666667,-0.015706806282722512,740946528.0,+1
2018-04-13,587.0,592.950012,575.125,581.299988,560.7801509999999,21227038.0,565.9825012,565.9472722909092,4.299987999999985,61.703293781396404,-2.3585431150875302,-9.080692502757188,59.47309953832225,-27779915.07155564,657116.5013038655,16.0,88.0,-56.0,11.950012000000015,583.125,591.125,600.950012,608.950012,573.299988,565.299988,555.474976,0.3464226559847466,762173566.0,+1
2018-04-16,551.0,570.0,551.0,585.724976,542.469666,24745084.0,567.9649964,569.5368131636365,19.82495199999994,64.84554112209597,-1.4627059063620482,-9.8395881085587,-27.4138351715249,-4705716.673531073,413351.3569931862,12.0,84.0,-56.0,20.5,568.9083253333333,586.8166506666666,587.9083253333333,605.8166506666666,567.8166506666666,549.9083253333333,548.8166506666666,1.827630315789472,786918650.0,+1
2018-04-17,563.5,563.700012,557.5,566.599976,538.639954,10397940.0,567.7674928000001,569.2886276363637,-1.9750360000000455,46.016451488418696,-5.3345551897668635,-11.286623351550588,-58.38305155965458,5321956.12158464,636469.7553837069,8.0,96.0,-68.0,10.799987999999985,562.599996,567.6999920000001,568.8000080000002,573.9000040000001,561.49998,556.399984,555.299968,1.4677352237382681,776520710.0,-1
2018-04-18,561.424988,567.375,556.924988,562.599976,538.9990230000001,10430380.0,567.0049928,568.3490791272727,-7.625,43.00306349332632,-6.144353732701204,-10.980632438695352,-51.34068614671399,-3235556.9679349083,460468.540687406,4.0,92.0,-72.0,10.125,562.299988,567.674988,572.75,578.125,557.224976,551.849976,546.774964,0.5430604290215146,766090330.0,-1
2018-04-19,562.0,569.900024,561.549988,562.974976,542.302124,8525542.0,567.0924928000001,567.6163488,0.875,43.40397364336346,-6.0684351193011095,-10.824987483553059,-31.557374686308478,-10936684.114070667,-57583.85271068862,0.0,88.0,-72.0,29.674987999999985,564.8083293333333,568.0666706666666,573.1583653333334,576.4167066666666,559.7166346666666,556.4582933333332,551.3665986666665,0.17065650974438637,774615872.0,+1
2018-04-20,569.5,596.849976,568.474976,566.424988,564.131104,24272692.0,566.3574892,567.494984290909,-7.3500360000000455,47.336254474328626,-6.111276381782931,-10.12722909477202,44.06751215242713,-5681466.69917697,-313214.8911864289,0.0,84.0,-72.0,30.825012000000015,577.2499799999999,586.0249839999999,605.62498,614.3999839999999,557.6499839999999,548.8749799999999,529.2749839999999,-0.07224627312775277,798888564.0,+1
2018-04-23,584.0,607.200012,577.625,589.224976,568.559082,21830638.0,568.9299868,571.6527091636364,25.72497599999997,65.5749860145514,-3.53700031002755,-7.737489635525776,131.99764840678736,-3674476.227219971,-465999.4973697719,96.0,80.0,-72.0,30.299987999999985,591.349996,605.0749920000001,620.9250080000002,634.6500040000001,575.49998,561.774984,545.924968,0.3922221908143254,820719202.0,+1
2018-04-24,592.5,598.200012,575.049988,593.849976,552.6661379999999,8526216.0,572.7524844000001,576.1836162909091,38.22497599999997,68.15624833084068,-2.6269255578057806,-6.8065269024394865,108.1803003039473,8196074.39741719,-72268.86578854603,96.0,76.0,-88.0,28.22497599999997,589.0333253333333,603.0166626666667,612.1833493333334,626.1666866666667,579.8666386666666,565.8833013333333,556.7166146666666,0.8120936721275088,829245418.0,+1
2018-04-25,576.0,585.5,572.599976,577.25,555.466492,11594178.0,574.8074832,577.0013464,20.549987999999985,52.00668404390141,-5.893351297284112,-4.7182057175295995,44.21521718031387,2479706.794671478,43730.02786872789,92.0,72.0,-88.0,10.450012000000015,578.449992,584.3000079999999,591.3500159999999,597.200032,571.3999839999999,565.5499679999999,558.4999599999999,0.36046630610919944,817651240.0,-1
2018-04-26,587.0,590.825012,580.0,580.174988,563.173645,11302084.0,576.612482,577.9772563636363,18.049987999999985,54.212487042967844,-5.317792869316191,-1.6144383286612083,74.2531510021932,4682701.517526733,254592.36830772826,88.0,68.0,-88.0,8.350036000000046,583.6666666666666,587.3333333333333,594.4916786666668,598.1583453333333,576.5083213333332,572.8416546666666,565.6833093333332,0.016165155290357607,828953324.0,+1
2018-04-27,590.0,595.799988,587.099976,588.224976,567.3623660000001,7663370.0,577.3049808,580.088618909091,6.924987999999985,60.04406768208543,-3.733773229426851,1.01154074182341,106.27254919483197,-6174631.080695192,-37645.06119240472,84.0,64.0,-84.0,33.875,590.3749799999999,593.6499839999999,599.0749919999998,602.3499959999999,584.9499719999999,581.6749679999999,576.2499599999999,0.1293101664687357,836616694.0,+1
2018-04-30,590.849976,603.974976,590.325012,592.599976,574.207825,5511678.0,577.9924808000001,582.8695271272727,6.875,62.999226116317466,-2.8728917070549076,3.8030382529725557,128.31589754805935,9180222.456338678,381348.9168771903,80.0,60.0,16.0,40.77502400000003,595.6333213333334,600.9416306666667,609.2832853333332,614.5915946666667,587.2916666666667,581.9833573333334,573.6417026666668,0.16666446885866967,842128372.0,+1
2018-05-02,599.450012,600.799988,590.5,599.75,573.0350950000001,10295042.0,581.3074832000001,586.8254397090909,33.15002400000003,67.52804805160139,-1.465960610799831,4.3838273863865425,126.4142021542455,-2395288.1511363997,255138.14105839067,76.0,56.00000000000001,20.0,23.15002400000003,597.0166626666667,603.5333253333333,607.3166506666666,613.8333133333333,593.2333373333333,586.7166746666667,582.9333493333334,0.8980592987098639,852423414.0,+1
2018-05-03,598.625,602.349976,588.049988,598.525024,566.0938110000001,5332230.0,584.8999880000001,589.9559016727274,35.92504800000006,65.93274361460186,-1.7070027145139037,4.155580935982698,109.71629543515671,-702925.4687768248,211589.79515678994,72.0,52.0,20.0,21.25,596.3083293333333,604.5666706666666,610.6083173333334,618.8666586666666,590.2666826666666,582.0083413333333,575.9666946666666,0.7325206147026176,847091184.0,-1
2018-05-04,592.5,593.0,577.5,591.275024,561.570007,6023368.0,587.7299928000001,591.1149991272728,28.30004800000006,56.77343156545969,-3.133606380158839,6.664133655667229,50.17797781258783,-2558620.9986948213,85671.12270898934,68.0,48.0,20.0,13.575012000000015,587.2583413333333,597.0166826666666,602.7583413333332,612.5166826666666,581.5166826666666,571.7583413333333,566.0166826666666,0.8887112258064536,841067816.0,-1
2018-05-07,590.625,595.0,587.75,586.549988,566.309265,4638960.0,589.7424928,590.9004527999999,20.125,51.403492515236096,-4.063365508145645,9.459671691639187,57.24878307830567,0.0,81776.98076767163,64.0,44.0,20.0,15.625,589.7666626666667,591.7833253333333,597.0166626666667,599.0333253333333,584.5333253333333,582.5166626666667,577.2833253333333,-0.16551889655172622,836428856.0,-1
2018-05-08,588.950012,588.950012,580.525024,591.5,557.955811,5718556.0,589.9699952,591.2199995636363,2.2750240000000304,56.389617327940215,-3.0893371958440676,12.557665705310683,35.34365375017914,-4935113.222130737,-146263.48300043805,60.0,40.0,20.0,15.75,586.9916786666666,593.4583333333333,595.4166666666665,601.8833213333332,585.0333453333333,578.5666906666667,576.6083573333333,1.3026696299151985,842147412.0,+1
2018-05-09,583.75,588.450012,581.5,582.775024,560.4210820000001,3783504.0,588.8625,589.9118229818182,-11.07495199999994,46.6541970970231,-4.806176195052901,14.540048962527862,15.765482924957844,3033601.635584056,-1724.1594284154828,56.00000000000001,36.0,19.999999999999993,10.299987999999985,584.2416786666666,586.9833573333333,591.1916906666665,593.9333693333333,580.0333453333333,577.2916666666666,573.0833333333333,0.18345637388827926,838363908.0,-1
2018-05-10,588.0,591.5,581.424988,585.349976,559.128662,3182862.0,589.6724976,589.2731822545454,8.09997599999997,49.6162888836524,-4.299495372699843,13.716900976355646,18.981983144216617,3544930.9051028523,159487.434413915,52.0,32.0,20.0,14.299987999999985,586.0916546666666,590.7583213333332,596.1666666666667,600.8333333333333,580.6833093333332,576.0166426666666,570.6082973333332,0.38957650869299004,841546770.0,+1
2018-05-11,586.150024,591.599976,583.025024,584.0,565.232178,3311706.0,590.0549988,588.2418190545454,3.825012000000015,48.003864799368706,-4.565134091338828,12.255261953056333,15.748659208487258,3293189.44110012,301928.4347178336,48.0,28.000000000000004,20.0,21.02502400000003,586.2083333333334,589.3916426666667,594.7832853333334,597.9665946666667,580.8166906666668,577.6333813333334,572.2417386666668,0.11370046153027755,838235064.0,-1
2018-05-14,592.174988,595.75,585.0,590.375,569.3251339999999,4432094.0,590.2700012,588.3000010909091,2.1500240000000304,55.825976371458474,-3.3107067301682815,12.712659279340073,35.639499275608664,3684861.6589629776,455698.1267289766,44.0,24.0,20.0,7.25,590.375,595.75,601.125,606.5,585.0,579.625,574.25,0.5,842667158.0,+1
2018-05-15,594.049988,604.0,594.049988,594.650024,571.838318,5611974.0,590.475006,589.0963688727273,2.0500480000000607,60.431782972582106,-1.8514803960395978,13.705933060405982,70.68129339777413,-3017219.0579482843,297838.25469819194,40.0,20.0,20.0,8.424987999999985,597.5666706666667,601.0833533333334,607.5166826666666,611.0333653333334,591.1333413333334,587.6166586666667,581.1833293333334,0.06030505289843315,848279132.0,+1
2018-05-16,593.625,599.0,592.25,597.275024,569.63623,6205004.0,590.2275084,590.3327357818182,-2.4749759999999696,63.15367897419778,-1.3316784158415782,13.09123713352983,55.43211770852707,-528926.0028145616,260258.0611748849,36.0,16.0,20.000000000000007,10.0,596.175008,600.1000160000001,602.9250080000002,606.8500160000001,593.3500160000001,589.425008,586.6000160000001,0.7444480000000046,854484136.0,+1
2018-05-17,598.0,598.724976,586.775024,594.974976,566.261353,9519598.0,589.8725036000001,591.195911709091,-3.5500480000000607,59.04710938355276,-1.7871334653465405,11.306226136537134,30.655654058270503,-18376849.25249525,-586883.1803555766,32.0,12.0,20.0,10.075012000000015,593.4916586666667,600.2082933333334,605.4416106666667,612.1582453333333,588.2583413333334,581.5417066666668,576.3083893333335,0.6861912081320478,844964538.0,-1
2018-05-18,591.5,593.275024,586.5,591.450012,566.4049679999999,7139660.0,589.8900024000001,591.4827314181819,0.17498799999998482,52.95769788898618,-2.4851461386138585,8.402291870535919,6.104111908534465,-8773620.271828495,-959007.593604346,28.000000000000004,8.0,19.999999999999996,8.57495199999994,590.4083453333334,594.3166906666668,597.1833693333333,601.0917146666668,587.5416666666667,583.6333213333334,580.7666426666667,0.7306264892936162,837824878.0,-1
2018-05-21,589.775024,594.200012,585.0,591.599976,564.633789,8475320.0,590.3950012,591.793635709091,5.049987999999985,53.19464556625546,-2.4554502970297087,5.838715514173941,1.5597474110801386,3884100.5260787075,-738866.3154369342,24.0,4.0,20.0,11.75,590.2666626666667,595.5333253333333,599.4666746666667,604.7333373333333,586.3333133333333,581.0666506666666,577.1333013333333,0.7173877599290043,846300198.0,+1
2018-05-22,587.5,599.0,586.950012,589.75,571.5031740000001,5636804.0,590.2200012000001,591.6763627636363,-1.75,49.63597771335302,-2.821782178217822,5.313026492851122,14.626816410440163,-657791.817353968,-735181.1109786176,20.0,0.0,20.0,13.625,591.900004,596.8499959999999,603.9499920000001,608.8999839999999,584.8000079999999,579.850016,572.75002,0.2323643807778056,840663394.0,-1
2018-05-23,597.5,603.825012,590.75,596.924988,567.21875,9538442.0,591.6349976,592.8954512727273,14.149963999999954,61.23995355404245,-1.4009924752475278,5.89462253022316,64.48547564442858,-259497.26707637834,-713559.1180739703,16.0,4.0,20.0,6.75,597.1666666666666,603.5833333333333,610.2416786666668,616.6583453333333,590.5083213333332,584.0916546666666,577.4333093333332,0.47227398338142845,850201836.0,+1
2018-05-24,599.0,613.775024,599.0,592.450012,584.5000610000001,9740570.0,592.3450012000001,593.043635709091,7.1000360000000455,52.530078990237904,-4.142588704925205,4.5091178737889095,112.87841400974028,-17919171.721343067,-1495632.4182225661,12.0,0.0,20.0,11.94995199999994,601.7416786666666,604.4833573333333,616.5167026666668,619.2583813333333,589.7083333333333,586.9666546666666,574.9333093333332,-0.44331488057142726,840461266.0,-1
2018-05-25,615.049988,624.325012,610.400024,610.5,587.99469,8901438.0,594.9950012,596.3445445818182,26.5,71.43684732798468,-2.631706407308856,4.5261247635568225,243.97546954306074,25833.801144318553,-1426474.8627967986,96.0,0.0,20.000000000000004,8.47497599999997,615.075012,619.75,629.0,633.674988,605.825012,601.150024,591.900024,0.007179611214025445,849362704.0,+1
2018-05-28,615.5,616.299988,603.0,614.150024,581.340637,5739794.0,597.3725036000001,599.8272760000001,23.77502400000003,73.86557311426023,-1.9368938785652157,4.402459412433473,167.82004705297237,-1845796.1440330155,-1445534.9210348085,96.0,0.0,20.0,9.200012000000015,611.150004,619.3000079999999,624.4499919999998,632.5999959999999,606.00002,597.850016,592.700032,0.8383484255775301,855102498.0,+1
2018-05-29,607.025024,613.275024,603.099976,607.200012,582.441589,3388934.0,598.6275024,601.614095709091,12.549987999999985,62.23852712516793,-3.259886662316395,4.615105709565114,117.20449500022612,3731011.7488550516,-1210237.3451307237,92.0,8.0,20.0,12.049987999999985,607.8583373333333,612.6166986666667,618.0333853333334,622.7917466666668,602.4416506666666,597.6832893333333,592.2666026666666,0.4029500401374049,851713564.0,-1
2018-05-30,608.5,614.375,602.799988,608.349976,580.0480349999999,6323066.0,599.7349975999999,603.3818181818183,11.07495199999994,63.34022795292759,-3.0409814181853663,5.5041036281195375,107.74453570449359,-3737695.0278370576,-1325121.785253739,88.0,4.0,12.0,14.075012000000015,608.5083213333334,614.2166546666667,620.0833333333333,625.7916666666667,602.6416426666667,596.9333093333333,591.0666306666667,0.47948010766640914,858036630.0,+1
2018-05-31,605.849976,621.0,605.125,605.849976,589.670105,19720340.0,600.8224975999999,604.4936324363636,10.875,59.020825224108776,-3.516877281297249,6.120542873885256,110.5084899343762,-7043450.475884841,-1585045.816646062,84.0,0.0,12.0,16.850036000000046,610.6583253333333,616.1916506666666,626.5333253333333,632.0666506666666,600.3166506666666,594.7833253333333,584.4416506666666,0.04566777952755714,838316290.0,-1
2018-06-01,615.200012,623.125,608.599976,615.900024,584.404358,4998356.0,603.2674988,607.2350008727273,24.450012000000015,68.86826675526133,-1.603766774386898,5.641591128599316,127.50361584224507,-1275837.4396633452,-1570990.890419575,80.0,20.0,96.0,31.875,615.875,623.150024,630.400024,637.6750480000001,608.625,601.349976,594.099976,0.5025842298091932,843314646.0,+1
2018-06-04,610.549988,621.5,606.0,610.400024,593.308228,4270156.0,605.1475036000002,608.5318236363637,18.80004800000006,59.79493009949541,-2.6507376732330394,5.569179242551172,89.37344847579303,-1712222.0377750904,-1577410.4880266439,76.0,16.0,96.0,13.299987999999985,612.6333413333333,619.2666826666666,628.1333413333332,634.7666826666666,603.7666826666666,597.1333413333333,588.2666826666666,0.2838725161290342,839044490.0,-1
2018-06-05,621.0,621.0,608.5,619.700012,584.428223,4710862.0,608.1425048,611.1777342545455,29.950012000000015,68.01629988170396,-0.8804073467569826,6.809848805706224,103.26132997346109,1168468.198858045,-1452597.8204409762,72.0,12.0,84.0,11.05004800000006,616.400004,624.3000079999999,628.9000040000001,636.8000079999999,611.8000079999999,603.900004,599.3000079999999,0.8960009600000012,843755352.0,+1
2018-06-06,612.599976,620.775024,610.025024,610.424988,592.3747559999999,4038184.0,609.4925048,611.5927312,13.5,55.0600208385099,-2.645985567502358,8.236557652572287,73.6259720836897,-11332731.81300419,-1901694.8201029408,68.0,8.0,84.0,11.575012000000015,613.7416786666666,617.4583333333333,624.4916786666668,628.2083333333333,606.7083333333333,602.9916786666666,595.9583333333333,0.03720595348836786,839717168.0,-1
2018-06-07,619.0,629.0,619.0,618.724976,599.555359,6676226.0,612.1200012,613.2713623272728,26.274963999999954,62.44636586896974,-1.9386837735849114,10.758612059572215,109.63590458061154,25128481.945936173,-673050.4216466165,64.0,4.0,84.0,15.875,622.2416586666667,625.4833173333334,632.2416586666668,635.4833173333334,615.4833173333334,612.2416586666667,605.4833173333334,-0.027502400000003036,846393394.0,+1
2018-06-08,624.0,631.0,623.025024,626.224976,603.193542,6459878.0,613.6924988,615.8359032,15.72497599999997,67.94034790065066,-0.8975609022556449,12.624306915452053,111.72256999478468,-16637387.822034732,-1398702.1216642587,96.0,0.0,60.0,17.27502400000003,626.75,630.474976,634.724976,638.4499519999999,622.5,618.775024,614.525024,0.4012491072073385,852853272.0,+1
2018-06-11,632.775024,635.0,627.525024,630.025024,604.3184809999999,5171290.0,615.2799988,618.8054532363636,15.875,70.46632002876156,-0.9281671641790988,14.978772070114019,109.65592456008817,2529836.1882434483,-1220132.1984866355,96.0,4.0,60.0,15.5,630.850016,634.1750079999999,638.3249919999998,641.6499839999999,626.700032,623.37504,619.225056,0.33444923435205814,858024562.0,+1
2018-06-12,632.875,635.625,625.224976,631.200012,602.451538,7839820.0,617.6799988,621.700001090909,24.0,71.2738152372741,-0.8245959468902837,14.762772570847574,91.2164998702451,9926988.250529313,-713444.9053495465,96.0,0.0,60.0,12.5,630.6833293333333,636.1416826666666,641.0833533333334,646.5417066666666,625.7416586666666,620.2833053333333,615.3416346666666,0.574521366489157,865864382.0,+1
2018-06-13,633.400024,642.0,633.400024,629.25,610.254456,5766928.0,619.7700012,623.8036376727273,20.90002400000003,67.7277959642546,-2.3480662983425415,14.345389811367568,94.4658606488177,-2676555.92059863,-802677.2242245049,96.0,4.0,60.0,10.75,634.8833413333333,636.3666586666666,643.4833173333332,644.9666346666666,627.7666826666666,626.2833653333333,619.1667066666666,-0.4825622769179873,860097454.0,-1
2018-06-14,626.5,626.5,617.049988,637.400024,613.1726070000001,7598848.0,622.925006,627.0090963636364,31.55004800000006,73.97251380421193,-0.8471410681399576,14.608137150904554,53.31254402447378,-1753766.812589251,-845908.5691501752,96.0,0.0,60.0,18.575012000000015,626.9833373333333,636.9166866666667,636.4333493333334,646.3666986666667,627.4666746666667,617.5333253333333,618.0166626666667,2.15344022843569,867696302.0,+1
2018-06-15,618.5,645.75,617.5,619.849976,633.7238769999999,19957760.0,623.3200012000001,626.45,3.9499519999999393,49.954909042414165,-4.737087151348885,14.546862200769851,50.56327503357961,-1093324.9588397986,-857154.7686815218,92.0,0.0,96.0,12.27502400000003,627.699992,637.8999839999999,655.9499919999998,666.1499839999999,609.6499839999999,599.449992,581.3999839999999,0.08318499115044141,847738542.0,-1
2018-06-18,642.0,645.625,631.174988,640.625,626.873474,8214846.0,626.3424988,629.5963634181819,30.22497599999997,65.33016178377665,-0.9373571101966164,15.37015099593475,86.82767951783569,-11565600.43726884,-1343902.299071855,96.0,0.0,92.0,8.77502400000003,639.1416626666667,647.1083373333333,653.5916746666667,661.5583493333334,632.6583253333333,624.6916506666666,618.2083133333333,0.6539795261069683,855953388.0,+1
2018-06-19,631.5,631.700012,619.025024,633.700012,614.1124269999999,7545700.0,627.7424988000001,630.9340930909091,14.0,58.426264820096605,-2.203930132601735,15.168950585846233,35.028212277492095,-1333648.8392582717,-1343436.232716692,92.0,16.0,96.0,10.40002400000003,628.1416826666667,637.2583413333334,640.8166706666666,649.9333293333334,624.5833533333334,615.4666946666667,611.9083653333334,1.1577910764096977,848407688.0,-1
2018-06-20,624.25,626.174988,619.0,620.799988,614.879089,5371802.0,628.7799988,629.6718184,10.375,47.61160649730273,-4.563330955647007,15.761708085414057,7.096690738350886,-836248.7942033348,-1320382.258238812,88.0,12.0,92.0,10.799987999999985,621.9916586666667,624.9833173333334,629.1666466666666,632.1583053333334,617.8083293333334,614.8166706666667,610.6333413333334,0.25086982723873386,843035886.0,-1
2018-06-21,622.974976,628.25,618.0,621.575012,616.560791,5798790.0,629.0650023999999,628.3618208,2.8500360000000455,48.27531151919981,-4.421579881115681,15.325363593414409,5.7533120175314805,-17316828.344827585,-2047493.4439928478,84.0,8.0,96.0,12.200012000000015,622.6083373333333,627.2166746666667,632.8583373333333,637.4666746666667,616.9666746666667,612.3583373333333,606.7166746666667,0.3487816585365868,848834676.0,+1
2018-06-22,621.5,627.75,620.599976,623.275024,617.2037349999999,4343118.0,628.7700072,627.3090974545454,-2.9499519999999393,49.88231123469948,-4.110649474165518,16.131390673837814,9.839419868156956,-5979975.067615767,-2226242.608702981,80.0,4.0,92.0,28.25,623.875,627.150024,631.025024,634.3000480000001,620.0,616.724976,612.849976,0.3741313315871456,853177794.0,+1
2018-06-25,628.575012,639.400024,627.0,623.924988,629.371216,7731178.0,628.1600036,626.4281848727273,-6.1000360000000455,50.559925061127956,-3.9917717421124856,15.687179944571767,34.96289898855316,-7356698.69591633,-2459445.15812177,76.0,0.0,96.0,25.77502400000003,630.1083373333333,633.2166746666667,642.5083613333334,645.6166986666667,620.8166506666666,617.7083133333333,608.4166266666666,-0.24798435873995145,860908972.0,+1
2018-06-26,634.5,641.950012,633.125,636.224976,632.042175,4483504.0,628.6625,627.8945434909091,5.0249639999999545,61.82899572723204,-1.742116872427989,14.536925686170548,63.38848453743205,-6293756.299965195,-2633732.028205562,72.0,0.0,76.0,21.59997599999997,637.099996,641.0749920000001,645.9250080000002,649.9000040000001,632.24998,628.274984,623.424968,0.3512715903389099,865392476.0,+1
2018-06-27,641.974976,646.724976,632.799988,638.924988,628.1594240000001,6952142.0,629.6299988000001,629.7604504000001,9.674987999999985,63.91241063596998,-1.4240701705740701,12.787304047204543,67.09859784404101,5826903.790479544,-2249157.672810784,68.0,0.0,76.0,14.700012000000015,639.4833173333333,646.1666466666666,653.4083053333331,660.0916346666666,632.2416586666666,625.5583293333333,618.3166706666666,0.43985675247978717,872344618.0,+1
2018-06-28,638.150024,649.0,638.125,635.0,637.853882,10996818.0,629.3899964,630.7368142545455,-2.4000240000000304,58.551927620680836,-2.5454545454545454,11.16979443035666,67.46162212181588,16138244.249516007,-1413366.676341384,96.0,0.0,76.0,10.25,640.7083333333334,643.2916666666667,651.5833333333335,654.1666666666667,632.4166666666667,629.8333333333334,621.5416666666667,-0.28735632183908044,861347800.0,-1
2018-06-29,649.025024,657.5,641.625,644.799988,646.559082,9966600.0,631.8849976,633.5386309090909,24.950012000000015,66.618061048539,-2.27395022381379,9.739274600977637,99.55542641209156,-973014.2704352567,-1393350.6578911054,96.0,12.0,76.0,7.15002400000003,647.974996,654.3249920000001,663.8499959999999,670.1999920000001,638.4499920000001,632.099996,622.5749920000001,0.19999924409448724,871314400.0,+1
2018-07-02,657.0,670.0,657.0,653.599976,660.16095,4830144.0,633.1824952000001,637.4868088,12.97497599999997,72.21956394813094,-2.8721583187390594,8.493044389993315,153.86373172452318,-3759508.238676413,-1500903.2751995286,96.0,8.0,76.0,16.125,660.199992,663.3999839999999,673.1999919999998,676.3999839999999,650.3999839999999,647.199992,637.3999839999999,-0.26154030769231,876144544.0,+1
2018-07-05,673.549988,673.625,634.049988,672.599976,635.0840450000001,17019902.0,647.2574892,656.5668037818182,51.024963999999954,75.86010786822257,-1.0949281608084604,9.068168098580372,90.45117219288989,9133404.601747453,-1343042.9206039067,92.0,0.0,96.0,10.875,660.0916546666666,686.1333213333332,699.6666666666667,725.7083333333333,646.5583093333332,620.5166426666666,606.9832973333332,0.9740992118966375,872277816.0,-1
2018-07-06,645.125,650.924988,634.5,642.0,635.207703,11215356.0,649.1299868,655.6108966545454,18.72497599999997,46.84249732700985,-6.371240837218918,9.9408548510213,12.140879526313938,-24186962.93233083,-2381402.921136949,88.0,4.0,84.0,22.5,642.474996,650.4499920000001,658.8999840000001,666.87498,634.0250040000001,626.050008,617.6000160000001,0.4566213381708411,861062460.0,-1
2018-07-13,657.5,665.799988,649.174988,647.174988,651.604126,19496158.0,656.2074892,653.4077183272727,2.375,48.878500506936305,-5.47892462152411,15.598012715689492,36.004301127539335,-14054595.000529269,-2974204.449620375,68.0,16.0,84.0,38.09997599999997,654.049988,658.924988,670.674988,675.549988,642.299988,637.424988,625.674988,-0.12030075187969924,879357860.0,-1
2018-07-18,669.900024,671.700012,657.0,663.950012,654.151428,6919016.0,655.3324952,656.9577248727273,-12.924987999999985,59.77514084207872,-4.762306039872433,18.056687330397494,52.95140207740781,-1211192.7567279995,-2991262.1569355307,92.0,4.0,76.0,25.375,664.2166746666667,671.4333493333334,678.9166866666667,686.1333613333334,656.7333373333333,649.5166626666667,642.0333253333333,0.47278954602213985,918945214.0,-1
2018-07-19,661.5,665.950012,654.549988,661.275024,651.257874,5118864.0,654.2000000000002,658.0381846545454,-11.32495199999994,56.89265368583162,-5.213248040190529,15.778332083674627,31.924729219272148,2743467.045453052,-2730592.6477360497,88.0,0.0,52.0,21.325012000000015,660.5916746666667,666.6333613333334,671.9916986666667,678.0333853333334,655.2333373333333,649.1916506666666,643.8333133333333,0.5899141966718691,913826350.0,-1
2019-01-25,728.0,737.900024,724.25,732.0,730.349976,5543112.0,726.7099976000002,733.6254528000001,52.299987999999985,66.32707752398278,-2.9141104294478524,32.95021240097094,64.23937904895531,-2754731.7854466774,-2858371.3068329347,84.0,12.0,64.0,10.5,731.3833413333333,738.5166826666666,745.0333653333332,752.1667066666666,724.8666586666666,717.7333173333333,711.2166346666666,0.5677645694981915,1058985743.0,+1
2019-01-28,731.0,732.599976,719.0,730.349976,727.950012,7944693.0,731.3949952000002,734.2872670545455,46.84997599999997,64.13035126086754,-3.1671815950920292,36.9188823179129,46.54731760474234,711940.2187373275,-2696084.4193070135,80.0,8.0,64.0,17.65002400000003,727.3166506666666,735.6333013333333,740.9166266666666,749.2332773333333,722.0333253333333,713.7166746666667,708.4333493333334,0.8345585315738788,1051041050.0,-1
2019-01-29,725.5,732.849976,716.5,727.950012,727.900024,6760819.0,733.9999940000001,733.6609064727272,26.049987999999985,60.75344973433707,-3.535274233128832,40.936392438660505,36.00048096032873,1758133.0501605857,-2493619.988876668,76.0,4.0,72.0,18.049987999999985,725.7666626666665,735.0333253333331,742.1166386666664,751.3833013333331,718.6833493333331,709.4166866666666,702.3333733333332,0.700307572316928,1044280231.0,-1
2019-01-30,727.900024,734.799988,721.099976,727.900024,725.900024,5763026.0,734.1299988000001,732.5518210181818,1.3000480000000607,60.676663139743994,-3.542941104294474,43.578524214308345,33.499981424755056,-5413778.412803901,-2626354.462691542,72.0,0.0,72.0,15.799987999999985,727.9333293333333,734.7666826666666,741.6333413333332,748.4666946666666,721.0666706666666,714.2333173333333,707.3666586666666,0.4963534338510107,1038517205.0,-1
2019-01-31,726.0,751.299988,726.0,725.900024,749.549988,13825233.0,733.0400024,731.0554619636364,-10.899963999999954,57.33148102335834,-3.8939083960246763,44.14026137522774,38.29533875838291,-1805093.4217243895,-2589024.4153748536,68.0,0.0,72.0,24.34997599999997,734.4000040000001,742.8000080000002,759.6999920000001,768.0999960000001,717.5000200000002,709.1000160000001,692.2000320000002,-0.0039516224276458034,1024691972.0,-1
2019-02-01,751.349976,762.5,744.5,749.549988,757.049988,6276585.0,734.6600036000001,734.0572775272726,16.200012000000015,75.64891870915568,-1.9517727204220066,41.68939825339805,59.785413711424404,289784.35969847045,-2458169.4710533386,96.0,20.0,72.0,13.65002400000003,752.1833293333333,759.8666586666666,770.1833293333334,777.8666586666666,741.8666586666666,734.1833293333333,723.8666586666666,0.280554888888888,1030968557.0,+1
2019-02-04,757.0,762.5,749.200012,757.049988,755.900024,3945391.0,737.2700012,738.1281837818183,26.09997599999997,78.95481080784356,-0.8214034664657144,38.77012879026347,58.17821052593949,-3356514.993808376,-2499003.358451295,96.0,16.0,72.0,13.59997599999997,756.25,763.299988,769.549988,776.599976,750.0,742.950012,736.700012,0.5902242919316903,1034913948.0,+1
2019-02-05,747.0,759.950012,747.0,755.900024,754.849976,4694366.0,738.3600036,741.5154606545454,10.90002400000003,77.10293348370739,-0.99472132629992,36.24995171090325,48.989964608821325,9161987.203498354,-1968958.3329081286,92.0,12.0,72.0,16.34997599999997,754.2833453333333,761.5666906666665,767.2333573333333,774.5167026666666,748.6166786666665,741.3333333333333,735.6666666666665,0.6872599036973881,1030219582.0,-1
2019-02-06,755.549988,766.950012,754.349976,754.849976,763.299988,5880482.0,739.3100036,744.5136374545455,9.5,75.24352184275185,-1.8115181948675594,34.14208573882365,52.19708427026918,3117606.882720009,-1737750.8231068493,88.0,8.0,72.0,13.700012000000015,758.7166546666667,763.0833333333335,771.3166906666668,775.6833693333335,750.4832973333334,746.1166186666667,737.8832613333334,0.03968242630417867,1024339100.0,-1
2019-02-07,763.049988,769.450012,761.0,763.299988,764.0,3961797.0,742.475,748.8754528,31.649963999999954,79.7728639080242,-0.9172979178050982,30.632920164084112,58.19547408155984,401897.79528438137,-1640494.0677254295,96.0,4.0,68.0,25.299987999999985,764.5833333333334,768.1666666666667,773.0333453333333,776.6166786666668,759.7166546666667,756.1333213333334,751.2666426666667,0.2721875424555587,1028300897.0,+1
2019-02-08,760.0,772.25,754.900024,764.0,760.900024,5915169.0,745.675,752.7890891636363,32.0,80.12051803368726,-1.2253991830672113,27.217563852775015,51.02031365468743,114738.49753442539,-1560710.769304527,96.0,0.0,76.0,36.59997599999997,763.7166746666667,772.5333253333333,781.0666506666666,789.8833013333333,755.1833493333334,746.3666986666667,737.8333733333334,0.5244950194743777,1034216066.0,+1
2019-02-11,766.900024,768.75,759.0,760.900024,762.799988,5500216.0,748.7300048,755.5572753454545,30.55004800000006,73.65208905630809,-1.6858486446342322,25.569684153158732,45.83437323168218,9889714.987012988,-1040236.871290094,96.0,0.0,80.0,13.299987999999985,762.8833413333333,766.7666826666666,772.6333413333332,776.5166826666666,757.0166826666666,753.1333413333333,747.2666826666666,0.19487425641025952,1028715850.0,-1
2019-02-12,760.349976,760.349976,741.0,762.799988,750.450012,7310690.0,752.2150024,758.1154541090909,34.84997599999997,75.07514710669682,-1.403640846639438,23.459740743587417,26.377660992656605,-6286624.828236109,-1278709.0511512766,92.0,4.0,80.0,12.950012000000015,754.7166546666667,768.4333093333335,774.0666306666667,787.7832853333334,749.0833333333335,735.3666786666668,729.7333573333335,1.1266157642779515,1036026540.0,+1
2019-02-14,751.0,753.0,737.25,750.450012,740.049988,4610535.0,754.4700012000001,757.7945467636363,22.549987999999985,53.43107436946756,-3.2380227255848473,21.984402131882007,7.479856535426793,10771146.699652048,-730988.3352056704,88.0,0.0,80.0,12.600036000000046,746.9000040000001,756.5500080000002,762.6500040000001,772.3000080000002,740.8000080000002,731.1500040000001,725.0500080000002,0.838096000000001,1031416005.0,-1
2019-02-15,742.299988,746.5,732.599976,740.049988,741.950012,5586389.0,755.8849976,755.1727261818182,14.149963999999954,41.738802345323826,-4.782771927218717,20.544011442170813,-11.996401470276087,257414.21774759213,-686060.9464350676,84.0,4.0,92.0,14.600036000000046,739.7166546666667,746.8333333333335,753.6166786666668,760.7333573333335,732.9333093333335,725.8166306666667,719.0332853333334,0.5359711609131034,1025829616.0,-1
2019-02-18,742.349976,747.650024,736.0,741.950012,741.049988,5346825.0,755.125,752.6390924363637,-7.59997599999997,44.30784705828721,-4.500555217229853,19.610229463412793,-8.171306877466254,-6897518.321510368,-968399.9180293997,80.0,0.0,96.0,17.34997599999997,741.8666786666666,747.7333573333333,753.5167026666668,759.3833813333333,736.0833333333333,730.2166546666666,724.4333093333332,0.5107295916300258,1031176441.0,+1
2019-02-19,739.099976,740.549988,721.299988,741.049988,724.299988,9401334.0,753.525,750.0799993454546,-16.0,43.265114292029175,-4.634238692907541,19.27369312842154,-32.18714028626281,11393598.131244296,-406490.91578968585,76.0,0.0,96.0,9.75,734.2999880000001,747.2999880000002,753.549988,766.5499880000002,728.0499880000002,715.0499880000001,708.7999880000002,1.025974025974026,1021775107.0,-1
2019-02-20,727.0,743.0,726.049988,724.299988,740.700012,5210675.0,750.3649964,744.7663607999999,-31.600036000000046,28.740706358282765,-7.1221703676197565,15.513168331136967,-41.920418024780396,2544136.8035326344,-272371.4740023076,72.0,0.0,88.0,19.90002400000003,731.1166586666667,736.1833293333334,748.0666706666668,753.1333413333334,719.2333173333334,714.1666466666667,702.2833053333334,-0.1032447646644733,1016564432.0,-1
2019-02-21,738.0,738.0,727.099976,740.700012,733.450012,7202786.0,748.95,743.0090909090909,-14.149963999999954,48.335163011419446,-4.6862217601188245,12.069404379054504,-28.272605324015043,-3559568.591542839,-421789.52479960455,68.0,36.0,88.0,25.549987999999985,735.2666626666665,743.4333493333331,746.1666866666665,754.3333733333332,732.5333253333331,724.3666386666665,721.6333013333331,1.2477069775259217,1023767218.0,+1
2019-02-22,732.5,738.200012,728.0,733.450012,734.950012,3750833.0,745.9650024,740.1909112727274,-29.84997599999997,42.38960631398711,-5.763087708874858,9.962444597475269,-37.73378156933162,-5213667.672863789,-639602.1678934314,64.0,32.0,80.0,17.850036000000046,733.2166746666667,738.4333493333334,743.4166866666667,748.6333613333334,728.2333373333333,723.0166626666667,718.0333253333333,0.5343142733557575,1020016385.0,-1
2019-02-25,735.549988,758.0,735.549988,734.950012,754.900024,6547552.0,743.0600036,738.1881857454546,-29.049987999999985,44.033076871229234,-5.540287857408093,8.527613084116183,-6.160695585993831,4353723.422223697,-412632.8228881071,60.0,28.000000000000004,80.0,11.65002400000003,742.8333333333334,750.1166786666668,765.2833453333335,772.5666906666668,727.6666666666667,720.3833213333334,705.2166546666667,-0.026724974579076806,1026563937.0,+1
2019-02-26,748.599976,752.599976,740.150024,754.900024,742.5,8319610.0,742.4600035999999,740.3409167272728,-6.0,61.07420618236235,-2.577048050501295,6.050800734712652,17.101400050690685,1268774.2297377733,-336205.2295869306,56.00000000000001,24.0,76.0,20.65002400000003,749.2166746666667,758.2833253333333,761.6666266666666,770.7332773333333,745.8333733333334,736.7667226666667,733.3834213333334,1.1847435235091728,1034883547.0,+1
2019-02-27,745.0,746.400024,732.75,742.5,735.25,5936354.0,740.4300048,740.3481888000001,-20.299987999999985,50.1277731637149,-4.418863720757519,2.8105754967551775,-29.874718443488867,4245014.546841395,-127967.96702200655,52.0,20.0,72.0,16.950012000000015,740.550008,748.3500160000001,754.2000320000002,762.0000400000001,734.6999920000001,726.899984,721.049968,0.7142844584009507,1028947193.0,-1
2019-02-28,738.700012,742.400024,732.299988,735.25,734.299988,8559921.0,738.9100036,739.4063697454546,-15.200012000000015,44.72042756151518,-5.495729669513554,0.4452196206161716,-60.881535420939215,7193994.0,204848.48602444856,48.0,16.0,32.0,13.700012000000015,736.6500040000001,741.0000200000002,746.7500400000001,751.1000560000002,730.8999840000001,726.549968,720.7999480000001,0.2920793549646756,1020387272.0,-1
2019-03-01,735.5,743.400024,735.5,734.299988,741.900024,3998826.0,738.3350036,738.5681850909091,-5.75,44.002757873523194,-5.636838024507986,-2.435976417428037,-64.1159656153464,-3492728.850961476,36776.78888872457,44.0,12.0,32.0,12.700012000000015,737.7333373333335,739.9666746666669,745.6333613333336,747.8666986666669,732.0666506666669,729.8333133333334,724.1666266666668,-0.15189979169683668,1016388446.0,-1
2019-03-05,740.5,742.5,730.25,741.900024,732.5,4826505.0,738.3300048,739.2163706181818,-0.04998799999998482,51.22758387165715,-4.008954983202683,-4.5089932280134235,-63.958410846128274,2502134.6034008926,148838.50773018686,40.0,8.0,31.999999999999996,24.549987999999985,738.2166746666667,746.1833493333334,750.4666746666667,758.4333493333334,733.9333493333334,725.9666746666667,721.6833493333334,0.9510223673469412,1021214951.0,+1
2019-03-06,736.099976,736.099976,727.0,732.5,732.5,6076668.0,737.475006,738.1563697454546,-8.549987999999985,43.261830365493466,-4.211079913912323,-5.473145768057293,-119.85916310846447,-10149347.793508358,-319260.86959883827,36.0,4.0,32.00000000000001,17.649963999999954,731.8666586666667,736.7333173333334,740.9666346666668,745.8332933333334,727.6333413333334,722.7666826666667,718.5333653333334,0.6043971984101957,1015138283.0,-1
2019-03-07,734.0,734.5,720.549988,732.5,722.950012,5951551.0,738.2950072,737.2518232,8.200012000000015,43.261830365493466,-3.8694992412746583,-6.880172223307568,-131.12856832851,-3096991.404407724,-445521.3484537878,32.0,0.0,32.0,22.15002400000003,729.1833293333333,737.8166706666666,743.1333413333334,751.7666826666666,723.8666586666666,715.2333173333333,709.9166466666666,0.856630947700977,1015138283.0,-1
2019-03-08,722.950012,722.950012,710.650024,722.950012,712.349976,7193994.0,736.5200072,734.4618240727272,-17.75,35.74395284825492,-5.3186628224582675,-8.658252745719778,-185.954853821029,-17224996.00904818,-1208224.7421171698,28.000000000000004,96.0,32.0,10.200012000000015,718.850016,727.0500079999999,731.1500040000001,739.3499959999999,714.75002,706.550028,702.450032,1.0,1007944289.0,-1
2019-03-11,713.299988,718.5,709.400024,712.349976,711.25,9932198.0,734.4100036000001,730.0672729454546,-21.100036000000046,29.23702543076385,-6.927166009104709,-8.452095803204656,-180.39701157578745,3538278.2035671053,-992474.6082224299,24.0,96.0,32.0,8.15002400000003,713.4166666666666,717.4333093333332,722.5166426666665,726.5332853333332,708.3333333333333,704.3166906666667,699.2333573333333,0.32417140440809394,998012091.0,-1
2019-03-12,709.0,714.950012,705.599976,711.25,706.950012,11997387.0,732.0400024000002,725.8563632,-23.700012000000015,28.613339836656323,-7.094081942336874,-10.712712051579729,-154.81873792637694,-6302837.736550045,-1233854.7504191399,20.0,96.0,32.0,12.25,710.5999959999999,715.6000159999999,719.950032,724.9500519999999,706.2499799999998,701.2499599999999,696.8999439999998,0.6042783150781454,986014704.0,-1
2019-03-13,710.0,718.599976,706.299988,706.950012,708.450012,11348867.0,727.2450012,721.2945467636364,-47.950012000000015,26.10182714354326,-7.746583915022759,-10.74292713391435,-126.3117518989731,-22185262.486701436,-2186191.4657046995,16.0,96.0,32.0,14.90002400000003,710.6166586666667,714.9333293333334,722.9166466666668,727.2333173333334,702.6333413333334,698.3166706666667,690.3333533333334,0.052847531233366336,974665837.0,-1
2019-03-14,714.0,714.900024,706.200012,708.450012,708.349976,6415187.0,723.8400023999999,717.877276,-34.049987999999985,28.623529450056736,-7.518966312594838,-10.539375144347787,-111.45584746874296,-474157.8430102099,-2108371.7555822227,12.0,92.0,32.0,13.950012000000015,709.850016,713.50002,718.5500279999999,722.200032,704.8000079999999,701.150004,696.0999959999999,0.2586203329374714,981081024.0,+1
2019-03-15,712.0,723.75,709.599976,708.349976,718.549988,14638664.0,721.15,715.0609075636364,-26.90002400000003,28.54856465488662,-7.534146282245832,-13.33755649844511,-76.6194385602958,7126670.46558164,-1688597.1091656832,8.0,88.0,-68.0,21.84997599999997,713.899984,718.1999920000001,728.0500080000002,732.3500160000001,704.049968,699.74996,689.899944,-0.08833907278178449,966442360.0,-1
2019-03-18,721.549988,723.700012,705.349976,718.549988,710.200012,8065544.0,719.5749999999999,714.5881781090909,-15.75,45.3787257789421,-5.986344764795146,-14.514500995941262,-59.87083584900564,-9657982.37997601,-2050841.8942025164,4.0,84.0,-72.0,13.549987999999985,715.8666586666667,726.3833413333334,734.2166946666666,744.7333773333335,708.0333053333334,697.5166226666666,689.6832693333333,0.7193452917476556,974507904.0,+1
2019-03-19,712.799988,726.5,707.400024,710.200012,722.25,8917337.0,716.4049988,712.8836348363635,-31.700012000000015,37.11992706127887,-6.487142833065214,-14.520979378771699,-55.83373212800428,-6633279.268200785,-2259134.502111529,0.0,96.0,-76.0,9.350036000000046,714.7000119999999,721.9999999999998,733.7999879999998,741.0999759999997,702.9000239999998,695.6000359999999,683.8000479999998,0.14659641457141043,965590567.0,-1
2019-03-20,727.25,742.299988,727.150024,722.25,738.950012,13471173.0,715.3799988000001,713.9463623272727,-10.25,51.74391870584975,-3.7303094075881638,-14.152882051219308,14.157779132598723,7958250.669112168,-1794707.9034195424,0.0,92.0,-80.0,12.299987999999985,730.5666706666667,733.9833173333334,745.7166346666668,749.1332813333333,718.8333533333334,715.4167066666668,703.6833893333335,-0.3234346959504356,979061740.0,+1
2019-03-22,745.0,746.349976,732.299988,738.950012,743.099976,8883260.0,716.0250000000001,718.2318192727273,6.450012000000015,64.825470519639,-1.1431164400012204,-14.71214835692274,49.3948578640049,6804787.713200857,-1403821.7390277057,0.0,88.0,-80.0,8.700012000000015,739.199992,746.0999959999999,753.2499799999998,760.1499839999999,732.0500079999999,725.150004,718.00002,0.473311720977985,987945000.0,+1
2019-03-25,742.400024,742.400024,730.549988,743.099976,734.799988,6373712.0,718.0399964000001,723.1545421818182,20.149963999999954,67.36235928049416,-0.5020468248229301,-13.832884428231864,46.13341344789885,-6372943.906350018,-1629690.9284514473,28.000000000000004,84.0,-80.0,15.299987999999985,738.6833293333333,746.8166706666666,750.5333653333334,758.6667066666666,734.9666346666666,726.8332933333332,723.1165986666665,1.05906749987932,994318712.0,+1
2019-04-02,759.0,765.799988,754.599976,755.099976,759.400024,7283600.0,724.9699952000001,733.0227185454546,43.84997599999997,71.28194770318585,-1.6046808927057172,-12.814347125784252,117.4711646381661,-4341662.676468245,-1268639.5929162635,96.0,76.0,-96.0,19.09997599999997,758.4999799999999,762.3999839999999,769.6999919999998,773.5999959999999,751.1999719999999,747.2999679999999,739.9999599999999,0.04464280931127568,995017330.0,+1
2019-04-03,756.0,758.5,746.799988,759.400024,753.299988,6897127.0,730.2149964000001,739.2827237818182,52.450012000000015,73.31533196485367,-0.959802656745092,-9.904624223018232,95.2376142572625,86809739.21282911,2734923.080072166,96.0,72.0,-92.0,32.09997599999997,754.9000040000001,763.0000200000002,766.6000160000001,774.7000320000002,751.3000080000002,743.1999920000001,739.5999960000001,1.0769250493076443,1001914457.0,+1
2019-04-08,763.049988,770.0,755.400024,759.299988,767.25,4919911.0,742.7299988000001,749.6336348363636,40.75,67.08849647638752,-1.5946366616989591,0.3308472063656609,108.94404358094987,-3993370.960951088,3481136.387137907,84.0,60.0,19.999999999999993,0.0,761.5666706666667,767.7333173333334,776.1666466666666,782.3332933333334,753.1333413333334,746.9666946666667,738.5333653333334,0.26712126102124845,992869803.0,+1
2019-04-09,770.0,773.0,758.200012,767.25,760.599976,6730692.0,748.4349976000002,754.0918168727272,57.049987999999985,71.4406306374704,-0.8531157270029673,4.771283383828177,118.94700764338954,-2996150.44031681,3186714.2586172377,96.0,56.00000000000001,20.0,0.0,766.1500040000001,774.0999960000001,780.9499920000001,788.8999840000001,759.3000080000002,751.3500160000001,744.5000200000002,0.6114861714752737,999600495.0,+1
2019-04-15,724.700012,731.349976,712.599976,747.75,727.5,31574803.0,754.6000000000001,753.3272738181819,9.950012000000015,50.574151037861775,-3.746290801186944,19.12814813185298,-26.22277228438421,-9920046.0,1997496.180017247,84.0,40.0,24.0,11.700012000000015,730.5666506666666,748.5333253333333,749.3166506666666,767.2833253333333,729.7833253333333,711.8166506666666,711.0333253333333,1.8746679466666683,1008900003.0,+1
2019-04-23,723.900024,730.0,718.400024,721.049988,728.200012,5516668.0,741.999994,733.3754473454545,-26.850036000000046,35.07012114021356,-7.70771691394659,16.71910623728013,-55.01775251615986,-6122253.300405241,2472663.5664974507,68.0,24.0,39.99999999999999,14.799987999999985,723.1500040000001,727.8999840000001,734.74998,739.4999600000001,716.3000080000002,711.5500280000001,704.7000320000002,0.22844564505995196,981635729.0,+1
